shoe_index,player_win,player_loss,player_count,push,total_hands,win_pct,win_push,win_push_pct,doubles_won,doubles_lost,doubles_won_pct,player_bj,dealer_bj,dealer_high_card,dealer_low_card,dealer_bust,dealer_draw,dealer_stand,dealer_bust_pct,dealer_draw_pct,dealer_stand_pct,dealer_avg_hand,num_of_shuffles,shuffle_method,shoe_outcome
2,25,16,9,3,44,0.568,28,0.636,2,0,1.0,0,2,31,13,11,14,19,0.25,0.318,0.43200000000000005,17.759,3,python,win
31,20,19,1,3,42,0.47600000000000003,23,0.5479999999999999,1,2,0.33299999999999996,2,1,25,17,10,16,16,0.23800000000000002,0.381,0.381,17.798,32,python,win
34,21,20,1,3,44,0.47700000000000004,24,0.545,4,1,0.8,0,1,26,18,12,13,19,0.273,0.295,0.43200000000000005,17.803,35,python,win
43,23,22,1,1,46,0.5,24,0.522,3,3,0.5,1,4,30,16,12,13,21,0.261,0.28300000000000003,0.457,17.759,44,python,win
44,25,17,8,3,45,0.556,28,0.622,2,2,0.5,3,2,29,16,15,10,20,0.33299999999999996,0.222,0.444,17.75,45,python,win
55,23,21,2,3,47,0.489,26,0.5529999999999999,3,1,0.75,1,2,26,21,12,14,21,0.255,0.298,0.447,17.764,56,python,win
57,23,20,3,3,46,0.5,26,0.565,4,0,1.0,0,1,22,24,14,14,18,0.304,0.304,0.391,17.775,58,python,win
61,26,21,5,1,48,0.542,27,0.562,2,2,0.5,7,1,25,23,10,17,21,0.20800000000000002,0.354,0.43799999999999994,17.766,62,python,win
62,27,14,13,3,44,0.614,30,0.682,9,1,0.9,3,2,27,17,15,6,23,0.341,0.136,0.523,17.743,63,python,win
70,24,20,4,2,46,0.522,26,0.565,1,1,0.5,4,1,24,22,13,18,15,0.28300000000000003,0.391,0.326,17.743,71,python,win
83,24,19,5,2,45,0.5329999999999999,26,0.578,9,1,0.9,3,2,25,20,14,9,22,0.311,0.2,0.489,17.738,84,python,win
91,23,19,4,3,45,0.511,26,0.578,3,2,0.6,4,2,27,18,11,13,21,0.244,0.289,0.467,17.69,92,python,win
95,23,21,2,1,45,0.511,24,0.5329999999999999,3,3,0.5,3,1,23,22,12,13,20,0.267,0.289,0.444,17.695999999999998,96,python,win
112,23,18,5,3,44,0.523,26,0.591,4,1,0.8,2,0,28,16,9,17,18,0.205,0.386,0.409,17.862000000000002,17,python,win
116,25,18,7,1,44,0.568,26,0.591,4,2,0.667,2,1,29,15,15,15,14,0.341,0.341,0.318,17.823,21,python,win
120,25,17,8,3,45,0.556,28,0.622,3,1,0.75,1,0,27,18,12,10,23,0.267,0.222,0.511,17.831,25,python,win
121,26,16,10,2,44,0.591,28,0.636,5,0,1.0,4,2,21,23,18,8,18,0.409,0.182,0.409,17.824,26,python,win
131,23,20,3,0,43,0.535,23,0.535,2,2,0.5,1,2,22,21,15,15,13,0.349,0.349,0.302,17.811,36,python,win
137,26,16,10,1,43,0.605,27,0.628,3,4,0.429,3,2,27,16,13,16,14,0.302,0.37200000000000005,0.326,17.835,42,python,win
139,25,18,7,3,46,0.5429999999999999,28,0.609,3,4,0.429,2,3,26,20,16,10,20,0.348,0.217,0.435,17.826,44,python,win
146,26,17,9,2,45,0.578,28,0.622,6,1,0.857,2,2,25,20,12,12,21,0.267,0.267,0.467,17.804000000000002,51,python,win
154,23,21,2,1,45,0.511,24,0.5329999999999999,3,1,0.75,3,2,28,17,11,13,21,0.244,0.289,0.467,17.776,59,python,win
161,27,17,10,3,47,0.574,30,0.638,1,1,0.5,4,0,28,19,15,12,20,0.319,0.255,0.426,17.775,66,python,win
174,22,21,1,3,46,0.478,25,0.5429999999999999,2,3,0.4,7,2,26,20,8,15,23,0.174,0.326,0.5,17.766,79,python,win
184,24,20,4,2,46,0.522,26,0.565,3,0,1.0,1,1,28,18,11,18,17,0.239,0.391,0.37,17.746,89,python,win
192,24,20,4,2,46,0.522,26,0.565,5,2,0.7140000000000001,3,4,23,23,14,13,19,0.304,0.28300000000000003,0.413,17.741,1,python,win
193,23,20,3,3,46,0.5,26,0.565,1,0,1.0,5,3,29,17,11,10,25,0.239,0.217,0.5429999999999999,16.732,2,python,win
195,21,20,1,3,44,0.47700000000000004,24,0.545,4,3,0.5710000000000001,3,0,17,27,9,21,14,0.205,0.47700000000000004,0.318,17.509,4,python,win
199,25,21,4,1,47,0.532,26,0.5529999999999999,1,1,0.5,2,2,34,13,9,12,26,0.191,0.255,0.5529999999999999,17.502,8,python,win
205,25,17,8,3,45,0.556,28,0.622,4,1,0.8,5,1,25,20,14,13,18,0.311,0.289,0.4,17.56,14,python,win
207,24,23,1,1,48,0.5,25,0.521,2,1,0.667,4,0,27,21,10,13,25,0.20800000000000002,0.271,0.521,17.574,16,python,win
209,22,19,3,1,42,0.524,23,0.5479999999999999,2,1,0.667,4,1,28,14,10,18,14,0.23800000000000002,0.429,0.33299999999999996,17.578,18,python,win
211,25,19,6,1,45,0.556,26,0.578,9,1,0.9,2,1,27,18,12,14,19,0.267,0.311,0.42200000000000004,17.631,20,python,win
212,21,20,1,3,44,0.47700000000000004,24,0.545,2,1,0.667,0,2,31,13,11,11,22,0.25,0.25,0.5,17.631,21,python,win
214,24,21,3,2,47,0.511,26,0.5529999999999999,3,1,0.75,2,2,30,17,13,13,21,0.27699999999999997,0.27699999999999997,0.447,17.637999999999998,23,python,win
217,24,21,3,2,47,0.511,26,0.5529999999999999,1,2,0.33299999999999996,5,1,20,27,10,19,18,0.213,0.40399999999999997,0.38299999999999995,17.625,26,python,win
218,23,20,3,3,46,0.5,26,0.565,4,1,0.8,2,4,29,17,12,16,18,0.261,0.348,0.391,17.646,27,python,win
219,25,18,7,3,46,0.5429999999999999,28,0.609,3,3,0.5,3,3,27,19,18,11,17,0.391,0.239,0.37,17.634,28,python,win
221,25,22,3,2,49,0.51,27,0.551,2,1,0.667,5,1,24,25,12,17,20,0.245,0.34700000000000003,0.408,17.625999999999998,30,python,win
227,23,19,4,2,44,0.523,25,0.568,1,2,0.33299999999999996,4,1,23,21,10,14,20,0.22699999999999998,0.318,0.455,17.590999999999998,36,python,win
229,25,21,4,2,48,0.521,27,0.562,5,3,0.625,1,1,27,21,14,13,21,0.292,0.271,0.43799999999999994,17.611,38,python,win
234,24,18,6,2,44,0.545,26,0.591,2,4,0.33299999999999996,2,2,24,20,14,12,18,0.318,0.273,0.409,17.602,43,python,win
235,24,20,4,3,47,0.511,27,0.574,7,7,0.5,0,3,29,18,10,11,26,0.213,0.23399999999999999,0.5529999999999999,17.609,44,python,win
238,23,20,3,2,45,0.511,25,0.556,5,3,0.625,2,3,23,22,18,11,16,0.4,0.244,0.35600000000000004,17.61,47,python,win
245,24,22,2,2,48,0.5,26,0.542,6,2,0.75,4,1,31,17,13,12,23,0.271,0.25,0.479,17.61,54,python,win
251,24,19,5,3,46,0.522,27,0.5870000000000001,1,3,0.25,2,2,29,17,15,12,19,0.326,0.261,0.413,17.61,60,python,win
256,25,21,4,2,48,0.521,27,0.562,4,0,1.0,4,0,29,19,16,11,21,0.33299999999999996,0.22899999999999998,0.43799999999999994,17.585,65,python,win
264,25,21,4,2,48,0.521,27,0.562,3,2,0.6,2,2,25,23,12,15,21,0.25,0.312,0.43799999999999994,17.589000000000002,73,python,win
280,20,19,1,3,42,0.47600000000000003,23,0.5479999999999999,3,2,0.6,1,0,24,18,13,13,16,0.31,0.31,0.381,17.621,89,python,win
282,25,17,8,3,45,0.556,28,0.622,2,1,0.667,1,0,25,20,13,17,15,0.289,0.37799999999999995,0.33299999999999996,17.625999999999998,91,python,win
283,23,20,3,3,46,0.5,26,0.565,1,2,0.33299999999999996,2,1,26,20,13,16,17,0.28300000000000003,0.348,0.37,17.627,92,python,win
288,23,20,3,2,45,0.511,25,0.556,3,1,0.75,1,1,24,21,13,15,17,0.289,0.33299999999999996,0.37799999999999995,17.730999999999998,1,python,win
309,23,21,2,1,45,0.511,24,0.5329999999999999,4,3,0.5710000000000001,2,1,28,17,11,10,24,0.244,0.222,0.5329999999999999,17.753,22,python,win
342,31,12,19,1,44,0.705,32,0.727,4,0,1.0,2,0,25,19,18,12,14,0.409,0.273,0.318,17.680999999999997,55,python,win
344,27,16,11,2,45,0.6,29,0.644,4,2,0.667,2,2,26,19,13,16,16,0.289,0.35600000000000004,0.35600000000000004,17.695999999999998,57,python,win
351,25,17,8,3,45,0.556,28,0.622,1,2,0.33299999999999996,5,1,20,25,12,15,18,0.267,0.33299999999999996,0.4,17.707,64,python,win
365,23,22,1,3,48,0.479,26,0.542,4,4,0.5,3,0,27,21,12,16,20,0.25,0.33299999999999996,0.41700000000000004,17.711,78,python,win
383,24,19,5,3,46,0.522,27,0.5870000000000001,8,0,1.0,4,2,23,23,18,12,16,0.391,0.261,0.348,17.680999999999997,96,python,win
387,28,19,9,2,49,0.5710000000000001,30,0.612,0,1,0.0,1,1,34,15,12,14,23,0.245,0.28600000000000003,0.469,17.417,4,python,win
388,23,21,2,3,47,0.489,26,0.5529999999999999,7,1,0.875,2,6,29,18,13,9,25,0.27699999999999997,0.191,0.532,17.315,5,python,win
390,25,20,5,3,48,0.521,28,0.583,1,5,0.16699999999999998,3,3,29,19,10,17,21,0.20800000000000002,0.354,0.43799999999999994,17.437,7,python,win
392,24,19,5,3,46,0.522,27,0.5870000000000001,3,4,0.429,4,1,25,21,12,17,17,0.261,0.37,0.37,17.527,9,python,win
393,31,13,18,2,46,0.674,33,0.7170000000000001,3,2,0.6,3,1,23,23,15,12,19,0.326,0.261,0.413,17.471,10,python,win
394,26,19,7,2,47,0.5529999999999999,28,0.596,3,3,0.5,3,0,30,17,16,10,21,0.34,0.213,0.447,17.43,11,python,win
407,26,20,6,2,48,0.542,28,0.583,2,1,0.667,2,2,26,22,12,13,23,0.25,0.271,0.479,17.413,24,python,win
411,22,21,1,3,46,0.478,25,0.5429999999999999,3,2,0.6,2,3,32,14,13,11,22,0.28300000000000003,0.239,0.478,17.442,28,python,win
415,24,17,7,3,44,0.545,27,0.614,5,0,1.0,4,2,25,19,14,8,22,0.318,0.182,0.5,17.493,32,python,win
420,25,16,9,3,44,0.568,28,0.636,3,3,0.5,1,1,27,17,17,10,17,0.386,0.22699999999999998,0.386,17.535,37,python,win
423,23,19,4,1,43,0.535,24,0.5579999999999999,6,3,0.667,1,1,29,14,14,13,16,0.326,0.302,0.37200000000000005,17.583,40,python,win
426,24,22,2,2,48,0.5,26,0.542,6,1,0.857,3,1,30,18,8,15,25,0.16699999999999998,0.312,0.521,17.586,43,python,win
428,32,11,21,2,45,0.711,34,0.7559999999999999,3,1,0.75,2,1,22,23,17,9,19,0.37799999999999995,0.2,0.42200000000000004,17.574,45,python,win
435,23,22,1,1,46,0.5,24,0.522,3,1,0.75,2,1,29,17,10,13,23,0.217,0.28300000000000003,0.5,17.545,52,python,win
448,25,17,8,2,44,0.568,27,0.614,1,3,0.25,3,2,34,10,12,9,23,0.273,0.205,0.523,17.543,65,python,win
449,25,19,6,1,45,0.556,26,0.578,4,0,1.0,4,2,33,12,11,11,23,0.244,0.244,0.511,17.543,66,python,win
450,21,19,2,2,42,0.5,23,0.5479999999999999,3,0,1.0,1,1,27,15,13,11,18,0.31,0.262,0.429,17.55,67,python,win
452,27,15,12,3,45,0.6,30,0.667,7,1,0.875,4,2,26,19,13,13,19,0.289,0.289,0.42200000000000004,17.553,69,python,win
456,24,20,4,3,47,0.511,27,0.574,3,3,0.5,1,3,29,18,12,15,20,0.255,0.319,0.426,17.534000000000002,73,python,win
469,22,21,1,3,46,0.478,25,0.5429999999999999,5,0,1.0,2,1,24,22,9,14,23,0.196,0.304,0.5,17.528,86,python,win
493,27,17,10,3,47,0.574,30,0.638,0,2,0.0,3,1,29,18,12,15,20,0.255,0.319,0.426,17.877,14,python,win
506,26,18,8,1,45,0.578,27,0.6,3,2,0.6,2,2,29,16,17,10,18,0.37799999999999995,0.222,0.4,17.78,27,python,win
508,26,16,10,3,45,0.578,29,0.644,3,0,1.0,4,1,27,18,15,12,18,0.33299999999999996,0.267,0.4,17.756,29,python,win
510,23,20,3,2,45,0.511,25,0.556,5,4,0.556,5,1,26,19,8,18,19,0.17800000000000002,0.4,0.42200000000000004,17.756,31,python,win
511,25,19,6,2,46,0.5429999999999999,27,0.5870000000000001,2,2,0.5,3,2,28,18,11,12,23,0.239,0.261,0.5,17.762,32,python,win
523,24,22,2,2,48,0.5,26,0.542,5,2,0.7140000000000001,4,4,30,18,7,17,24,0.146,0.354,0.5,17.737000000000002,44,python,win
526,23,20,3,2,45,0.511,25,0.556,4,0,1.0,3,2,27,18,11,15,19,0.244,0.33299999999999996,0.42200000000000004,17.742,47,python,win
539,22,20,2,2,44,0.5,24,0.545,2,3,0.4,4,1,30,14,8,13,23,0.182,0.295,0.523,17.680999999999997,60,python,win
542,24,18,6,3,45,0.5329999999999999,27,0.6,2,3,0.4,2,2,22,23,8,21,16,0.17800000000000002,0.467,0.35600000000000004,17.67,63,python,win
547,25,18,7,3,46,0.5429999999999999,28,0.609,2,1,0.667,6,1,27,19,10,12,24,0.217,0.261,0.522,17.665,68,python,win
555,22,21,1,1,44,0.5,23,0.523,5,2,0.7140000000000001,1,1,23,21,18,13,13,0.409,0.295,0.295,17.659000000000002,76,python,win
557,26,20,6,2,48,0.542,28,0.583,4,3,0.5710000000000001,1,2,28,20,13,23,12,0.271,0.479,0.25,17.676,78,python,win
588,25,15,10,3,43,0.581,28,0.6509999999999999,3,0,1.0,3,1,27,16,13,12,18,0.302,0.27899999999999997,0.419,17.682000000000002,13,python,win
606,25,20,5,2,47,0.532,27,0.574,5,1,0.833,4,7,30,17,15,9,23,0.319,0.191,0.489,17.764,31,python,win
622,22,21,1,3,46,0.478,25,0.5429999999999999,4,1,0.8,4,0,25,21,9,14,23,0.196,0.304,0.5,17.78,47,python,win
623,24,20,4,1,45,0.5329999999999999,25,0.556,2,4,0.33299999999999996,5,2,27,18,11,15,19,0.244,0.33299999999999996,0.42200000000000004,17.766,48,python,win
641,27,16,11,2,45,0.6,29,0.644,2,1,0.667,3,2,34,11,9,12,24,0.2,0.267,0.5329999999999999,17.76,66,python,win
642,24,23,1,1,48,0.5,25,0.521,0,2,0.0,3,1,27,21,16,12,20,0.33299999999999996,0.25,0.41700000000000004,17.742,67,python,win
644,27,17,10,2,46,0.5870000000000001,29,0.63,2,5,0.28600000000000003,2,3,27,19,15,12,19,0.326,0.261,0.413,17.743,69,python,win
645,24,22,2,1,47,0.511,25,0.532,5,2,0.7140000000000001,2,2,26,21,14,14,19,0.298,0.298,0.40399999999999997,17.738,70,python,win
647,23,17,6,3,43,0.535,26,0.605,3,2,0.6,2,1,21,22,17,15,11,0.395,0.349,0.256,17.742,72,python,win
648,25,21,4,0,46,0.5429999999999999,25,0.5429999999999999,2,1,0.667,3,2,31,15,14,9,23,0.304,0.196,0.5,17.743,73,python,win
660,21,20,1,3,44,0.47700000000000004,24,0.545,1,3,0.25,2,1,25,19,11,13,20,0.25,0.295,0.455,17.717,85,python,win
666,23,20,3,2,45,0.511,25,0.556,1,0,1.0,2,2,31,14,10,15,20,0.222,0.33299999999999996,0.444,17.708,91,python,win
671,24,18,6,1,43,0.5579999999999999,25,0.581,4,1,0.8,1,3,28,15,13,8,22,0.302,0.18600000000000003,0.512,17.7,96,python,win
683,24,19,5,1,44,0.545,25,0.568,4,2,0.667,1,2,21,23,12,19,13,0.273,0.43200000000000005,0.295,17.957,12,python,win
715,24,19,5,2,45,0.5329999999999999,26,0.578,5,3,0.625,2,3,28,17,13,10,22,0.289,0.222,0.489,17.607,44,python,win
734,23,21,2,2,46,0.5,25,0.5429999999999999,5,0,1.0,1,3,23,23,15,12,19,0.326,0.261,0.413,17.668,63,python,win
736,24,20,4,1,45,0.5329999999999999,25,0.556,3,0,1.0,1,3,25,20,15,12,18,0.33299999999999996,0.267,0.4,17.648,65,python,win
747,22,20,2,3,45,0.489,25,0.556,1,1,0.5,2,2,21,24,11,13,21,0.244,0.289,0.467,17.662,76,python,win
748,24,17,7,3,44,0.545,27,0.614,3,2,0.6,1,1,25,19,14,14,16,0.318,0.318,0.364,17.669,77,python,win
753,23,22,1,1,46,0.5,24,0.522,3,2,0.6,2,0,25,21,18,9,19,0.391,0.196,0.413,17.656,82,python,win
759,23,22,1,2,47,0.489,25,0.532,4,1,0.8,3,5,28,19,14,11,22,0.298,0.23399999999999999,0.46799999999999997,17.648,88,python,win
764,23,18,5,3,44,0.523,26,0.591,4,2,0.667,2,2,28,16,11,15,18,0.25,0.341,0.409,17.637999999999998,93,python,win
765,22,20,2,2,44,0.5,24,0.545,1,4,0.2,0,2,33,11,9,14,21,0.205,0.318,0.47700000000000004,17.643,94,python,win
776,23,21,2,3,47,0.489,26,0.5529999999999999,4,3,0.5710000000000001,5,3,27,20,12,14,21,0.255,0.298,0.447,17.891,9,python,win
780,24,20,4,0,44,0.545,24,0.545,3,3,0.5,1,2,28,16,10,15,19,0.22699999999999998,0.341,0.43200000000000005,17.882,13,python,win
783,25,22,3,0,47,0.532,25,0.532,2,0,1.0,2,2,30,17,12,17,18,0.255,0.36200000000000004,0.38299999999999995,17.881,16,python,win
790,29,16,13,3,48,0.604,32,0.667,3,0,1.0,1,4,30,18,19,12,17,0.396,0.25,0.354,17.76,23,python,win
799,25,17,8,3,45,0.556,28,0.622,4,3,0.5710000000000001,4,0,31,14,10,12,23,0.222,0.267,0.511,17.725,32,python,win
802,21,20,1,2,43,0.488,23,0.535,7,0,1.0,1,2,25,18,15,12,16,0.349,0.27899999999999997,0.37200000000000005,17.738,35,python,win
809,26,18,8,2,46,0.565,28,0.609,3,4,0.429,2,2,28,18,7,18,21,0.152,0.391,0.457,17.717,42,python,win
842,22,19,3,2,43,0.512,24,0.5579999999999999,3,2,0.6,2,1,23,20,14,13,16,0.326,0.302,0.37200000000000005,17.67,75,python,win
848,28,15,13,3,46,0.609,31,0.674,2,1,0.667,2,2,25,21,18,10,18,0.391,0.217,0.391,17.657,81,python,win
850,24,20,4,2,46,0.522,26,0.565,2,1,0.667,5,1,29,17,13,12,21,0.28300000000000003,0.261,0.457,17.66,83,python,win
857,23,18,5,3,44,0.523,26,0.591,6,2,0.75,2,3,28,16,12,10,22,0.273,0.22699999999999998,0.5,17.675,90,python,win
868,25,17,8,3,45,0.556,28,0.622,4,2,0.667,2,1,22,23,14,12,19,0.311,0.267,0.42200000000000004,17.312,5,python,win
874,26,14,12,3,43,0.605,29,0.674,1,3,0.25,2,1,25,18,14,14,15,0.326,0.326,0.349,17.666,11,python,win
882,23,20,3,2,45,0.511,25,0.556,5,3,0.625,1,0,23,22,12,17,16,0.267,0.37799999999999995,0.35600000000000004,17.782,19,python,win
891,21,20,1,2,43,0.488,23,0.535,4,2,0.667,1,1,27,16,11,17,15,0.256,0.395,0.349,17.724,28,python,win
901,24,18,6,3,45,0.5329999999999999,27,0.6,2,3,0.4,1,2,30,15,14,7,24,0.311,0.156,0.5329999999999999,17.703,38,python,win
910,29,16,13,3,48,0.604,32,0.667,2,1,0.667,5,2,29,19,15,8,25,0.312,0.16699999999999998,0.521,17.672,47,python,win
918,24,21,3,2,47,0.511,26,0.5529999999999999,2,3,0.4,3,2,23,24,11,15,21,0.23399999999999999,0.319,0.447,17.68,55,python,win
928,21,20,1,2,43,0.488,23,0.535,1,2,0.33299999999999996,0,2,29,14,11,16,16,0.256,0.37200000000000005,0.37200000000000005,17.692999999999998,65,python,win
933,22,18,4,1,41,0.537,23,0.561,4,3,0.5710000000000001,1,0,31,10,17,9,15,0.415,0.22,0.366,17.698,70,python,win
934,25,20,5,1,46,0.5429999999999999,26,0.565,2,2,0.5,4,0,28,18,12,16,18,0.261,0.348,0.391,17.699,71,python,win
967,21,19,2,3,43,0.488,24,0.5579999999999999,2,2,0.5,3,0,30,13,11,13,19,0.256,0.302,0.442,17.658,8,riffle_perfect,win
968,24,22,2,1,47,0.511,25,0.532,2,2,0.5,1,5,32,15,17,9,21,0.36200000000000004,0.191,0.447,17.730999999999998,9,riffle_perfect,win
978,22,20,2,2,44,0.5,24,0.545,4,2,0.667,3,1,30,14,11,8,25,0.25,0.182,0.568,17.535,19,riffle_perfect,win
987,25,17,8,3,45,0.556,28,0.622,4,0,1.0,2,2,23,22,17,12,16,0.37799999999999995,0.267,0.35600000000000004,17.589000000000002,28,riffle_perfect,win
1002,24,21,3,2,47,0.511,26,0.5529999999999999,2,2,0.5,2,4,32,15,11,14,22,0.23399999999999999,0.298,0.46799999999999997,17.654,43,riffle_perfect,win
1006,22,20,2,3,45,0.489,25,0.556,1,0,1.0,0,3,27,18,14,14,17,0.311,0.311,0.37799999999999995,17.658,47,riffle_perfect,win
1008,26,15,11,2,43,0.605,28,0.6509999999999999,1,0,1.0,4,2,28,15,17,9,17,0.395,0.209,0.395,17.624000000000002,49,riffle_perfect,win
1014,23,22,1,1,46,0.5,24,0.522,5,2,0.7140000000000001,2,3,30,16,10,15,21,0.217,0.326,0.457,17.636,55,riffle_perfect,win
1021,21,20,1,3,44,0.47700000000000004,24,0.545,4,1,0.8,0,1,31,13,10,10,24,0.22699999999999998,0.22699999999999998,0.545,17.634,62,riffle_perfect,win
1024,22,20,2,3,45,0.489,25,0.556,1,1,0.5,1,3,26,19,12,16,17,0.267,0.35600000000000004,0.37799999999999995,17.635,65,riffle_perfect,win
1046,26,22,4,3,51,0.51,29,0.569,2,1,0.667,3,0,28,23,6,22,23,0.11800000000000001,0.431,0.451,17.654,87,riffle_perfect,win
1050,21,20,1,1,42,0.5,22,0.524,1,3,0.25,0,0,27,15,13,12,17,0.31,0.28600000000000003,0.405,17.657,91,riffle_perfect,win
1064,24,19,5,2,45,0.5329999999999999,26,0.578,3,3,0.5,2,5,30,15,14,12,19,0.311,0.267,0.42200000000000004,17.654,9,riffle_perfect,win
1074,22,20,2,3,45,0.489,25,0.556,3,1,0.75,4,1,27,18,12,15,18,0.267,0.33299999999999996,0.4,17.625999999999998,19,riffle_perfect,win
1080,26,17,9,3,46,0.565,29,0.63,7,1,0.875,3,0,31,15,13,12,21,0.28300000000000003,0.261,0.457,17.604,25,riffle_perfect,win
1084,22,21,1,0,43,0.512,22,0.512,2,0,1.0,2,3,31,12,14,6,23,0.326,0.14,0.535,17.577,29,riffle_perfect,win
1104,23,21,2,3,47,0.489,26,0.5529999999999999,7,2,0.778,2,2,29,18,13,15,19,0.27699999999999997,0.319,0.40399999999999997,17.695,49,riffle_perfect,win
1105,22,21,1,3,46,0.478,25,0.5429999999999999,1,0,1.0,1,2,26,20,16,12,18,0.348,0.261,0.391,17.702,50,riffle_perfect,win
1115,24,19,5,3,46,0.522,27,0.5870000000000001,2,5,0.28600000000000003,3,0,26,20,11,17,18,0.239,0.37,0.391,17.699,60,riffle_perfect,win
1130,26,18,8,3,47,0.5529999999999999,29,0.617,7,2,0.778,3,3,23,24,13,17,17,0.27699999999999997,0.36200000000000004,0.36200000000000004,17.73,75,riffle_perfect,win
1146,22,18,4,3,43,0.512,25,0.581,1,0,1.0,3,1,26,17,14,16,13,0.326,0.37200000000000005,0.302,17.730999999999998,91,riffle_perfect,win
1147,21,19,2,2,42,0.5,23,0.5479999999999999,1,2,0.33299999999999996,0,0,21,21,14,18,10,0.33299999999999996,0.429,0.23800000000000002,17.734,92,riffle_perfect,win
1150,22,18,4,3,43,0.512,25,0.581,2,2,0.5,2,1,27,16,13,13,17,0.302,0.302,0.395,17.749000000000002,95,riffle_perfect,win
1152,22,21,1,1,44,0.5,23,0.523,4,3,0.5710000000000001,4,1,25,19,12,11,21,0.273,0.25,0.47700000000000004,17.429000000000002,1,riffle_perfect,win
1161,22,21,1,1,44,0.5,23,0.523,6,0,1.0,3,2,27,17,13,9,22,0.295,0.205,0.5,17.682000000000002,10,riffle_perfect,win
1169,27,16,11,3,46,0.5870000000000001,30,0.652,4,2,0.667,3,0,24,22,13,14,19,0.28300000000000003,0.304,0.413,17.647000000000002,18,riffle_perfect,win
1191,23,19,4,3,45,0.511,26,0.578,1,4,0.2,5,3,30,15,7,14,24,0.156,0.311,0.5329999999999999,17.749000000000002,40,riffle_perfect,win
1194,24,18,6,2,44,0.545,26,0.591,4,3,0.5710000000000001,3,1,26,18,17,14,13,0.386,0.318,0.295,17.753,43,riffle_perfect,win
1196,28,14,14,2,44,0.636,30,0.682,4,1,0.8,2,1,20,24,18,17,9,0.409,0.386,0.205,17.752,45,riffle_perfect,win
1199,24,20,4,3,47,0.511,27,0.574,4,2,0.667,6,3,27,20,12,14,21,0.255,0.298,0.447,17.748,48,riffle_perfect,win
1210,22,20,2,3,45,0.489,25,0.556,9,1,0.9,4,1,34,11,13,10,22,0.289,0.222,0.489,17.713,59,riffle_perfect,win
1213,26,17,9,2,45,0.578,28,0.622,3,1,0.75,2,2,32,13,15,10,20,0.33299999999999996,0.222,0.444,17.719,62,riffle_perfect,win
1216,23,19,4,2,44,0.523,25,0.568,4,2,0.667,3,3,22,22,11,16,17,0.25,0.364,0.386,17.713,65,riffle_perfect,win
1218,26,17,9,0,43,0.605,26,0.605,6,2,0.75,1,0,26,17,18,9,16,0.419,0.209,0.37200000000000005,17.71,67,riffle_perfect,win
1224,22,21,1,3,46,0.478,25,0.5429999999999999,3,2,0.6,1,3,35,11,10,9,27,0.217,0.196,0.5870000000000001,17.721,73,riffle_perfect,win
1226,26,18,8,3,47,0.5529999999999999,29,0.617,5,5,0.5,3,0,24,23,11,17,19,0.23399999999999999,0.36200000000000004,0.40399999999999997,17.715999999999998,75,riffle_perfect,win
1234,22,21,1,3,46,0.478,25,0.5429999999999999,6,2,0.75,0,3,23,23,14,12,20,0.304,0.261,0.435,17.747,83,riffle_perfect,win
1237,22,21,1,1,44,0.5,23,0.523,5,2,0.7140000000000001,1,2,26,18,12,10,22,0.273,0.22699999999999998,0.5,17.73,86,riffle_perfect,win
1257,21,20,1,3,44,0.47700000000000004,24,0.545,4,4,0.5,0,3,27,17,16,13,15,0.364,0.295,0.341,17.743,10,riffle_perfect,win
1264,22,20,2,2,44,0.5,24,0.545,4,2,0.667,2,0,23,21,17,10,17,0.386,0.22699999999999998,0.386,17.717,17,riffle_perfect,win
1266,24,21,3,1,46,0.522,25,0.5429999999999999,5,1,0.833,3,3,23,23,14,11,21,0.304,0.239,0.457,17.645,19,riffle_perfect,win
1267,24,19,5,3,46,0.522,27,0.5870000000000001,4,1,0.8,4,0,27,19,12,15,19,0.261,0.326,0.413,17.633,20,riffle_perfect,win
1273,27,17,10,2,46,0.5870000000000001,29,0.63,6,0,1.0,3,2,26,20,14,11,21,0.304,0.239,0.457,17.622,26,riffle_perfect,win
1285,27,18,9,2,47,0.574,29,0.617,3,0,1.0,1,3,25,22,17,13,17,0.36200000000000004,0.27699999999999997,0.36200000000000004,17.673,38,riffle_perfect,win
1288,26,15,11,3,44,0.591,29,0.659,3,0,1.0,1,1,25,19,16,10,18,0.364,0.22699999999999998,0.409,17.648,41,riffle_perfect,win
1298,26,15,11,3,44,0.591,29,0.659,6,1,0.857,1,0,25,19,13,13,18,0.295,0.295,0.409,17.668,51,riffle_perfect,win
1305,23,22,1,3,48,0.479,26,0.542,4,2,0.667,3,2,27,21,11,16,21,0.22899999999999998,0.33299999999999996,0.43799999999999994,17.702,58,riffle_perfect,win
1306,26,18,8,1,45,0.578,27,0.6,4,0,1.0,6,1,28,17,14,9,22,0.311,0.2,0.489,17.687,59,riffle_perfect,win
1316,23,20,3,2,45,0.511,25,0.556,4,1,0.8,3,0,25,20,11,13,21,0.244,0.289,0.467,17.688,69,riffle_perfect,win
1322,24,17,7,3,44,0.545,27,0.614,3,2,0.6,3,3,27,17,14,12,18,0.318,0.273,0.409,17.695,75,riffle_perfect,win
1331,24,20,4,3,47,0.511,27,0.574,2,2,0.5,2,0,25,22,8,18,21,0.17,0.38299999999999995,0.447,17.679000000000002,84,riffle_perfect,win
1337,24,21,3,2,47,0.511,26,0.5529999999999999,7,4,0.636,2,2,30,17,10,15,22,0.213,0.319,0.46799999999999997,17.69,90,riffle_perfect,win
1341,25,17,8,2,44,0.568,27,0.614,5,0,1.0,2,2,25,19,16,10,18,0.364,0.22699999999999998,0.409,17.689,94,riffle_perfect,win
1346,23,22,1,3,48,0.479,26,0.542,1,1,0.5,2,1,29,19,14,11,23,0.292,0.22899999999999998,0.479,17.99,3,riffle_perfect,win
1351,21,20,1,3,44,0.47700000000000004,24,0.545,1,1,0.5,5,0,29,15,5,17,22,0.114,0.386,0.5,17.589000000000002,8,riffle_perfect,win
1362,22,19,3,3,44,0.5,25,0.568,2,3,0.4,3,1,33,11,10,15,19,0.22699999999999998,0.341,0.43200000000000005,17.519000000000002,19,riffle_perfect,win
1368,26,18,8,3,47,0.5529999999999999,29,0.617,4,2,0.667,2,1,30,17,14,10,23,0.298,0.213,0.489,17.522000000000002,25,riffle_perfect,win
1370,23,21,2,0,44,0.523,23,0.523,7,2,0.778,0,2,25,19,13,20,11,0.295,0.455,0.25,17.554000000000002,27,riffle_perfect,win
1372,21,20,1,3,44,0.47700000000000004,24,0.545,4,3,0.5710000000000001,3,2,24,20,10,12,22,0.22699999999999998,0.273,0.5,17.543,29,riffle_perfect,win
1389,23,21,2,1,45,0.511,24,0.5329999999999999,6,3,0.667,2,2,28,17,12,13,20,0.267,0.289,0.444,17.579,46,riffle_perfect,win
1397,29,20,9,3,52,0.5579999999999999,32,0.615,4,3,0.5710000000000001,2,2,32,20,17,11,24,0.327,0.212,0.462,17.586,54,riffle_perfect,win
1404,23,19,4,2,44,0.523,25,0.568,2,2,0.5,2,0,20,24,13,15,16,0.295,0.341,0.364,17.567,61,riffle_perfect,win
1405,23,20,3,3,46,0.5,26,0.565,4,2,0.667,1,3,24,22,18,9,19,0.391,0.196,0.413,17.57,62,riffle_perfect,win
1406,24,23,1,1,48,0.5,25,0.521,6,1,0.857,2,3,30,18,8,14,26,0.16699999999999998,0.292,0.542,17.565,63,riffle_perfect,win
1408,24,21,3,0,45,0.5329999999999999,24,0.5329999999999999,5,1,0.833,1,0,29,16,13,12,20,0.289,0.267,0.444,17.567,65,riffle_perfect,win
1409,25,19,6,1,45,0.556,26,0.578,3,1,0.75,4,0,29,16,9,15,21,0.2,0.33299999999999996,0.467,17.573,66,riffle_perfect,win
1412,28,17,11,3,48,0.583,31,0.6459999999999999,2,6,0.25,2,0,26,22,12,17,19,0.25,0.354,0.396,17.59,69,riffle_perfect,win
1417,25,22,3,3,50,0.5,28,0.56,1,1,0.5,4,3,30,20,9,18,23,0.18,0.36,0.46,17.59,74,riffle_perfect,win
1420,25,16,9,3,44,0.568,28,0.636,2,3,0.4,3,0,28,16,8,16,20,0.182,0.364,0.455,17.585,77,riffle_perfect,win
1421,21,19,2,3,43,0.488,24,0.5579999999999999,4,3,0.5710000000000001,2,2,30,13,12,10,21,0.27899999999999997,0.233,0.488,17.590999999999998,78,riffle_perfect,win
1436,22,20,2,3,45,0.489,25,0.556,0,2,0.0,1,0,27,18,13,12,20,0.289,0.267,0.444,17.595,93,riffle_perfect,win
1439,22,21,1,2,45,0.489,24,0.5329999999999999,3,4,0.429,3,2,25,20,10,18,17,0.222,0.4,0.37799999999999995,17.589000000000002,96,riffle_perfect,win
1443,24,21,3,0,45,0.5329999999999999,24,0.5329999999999999,4,1,0.8,0,3,29,16,10,12,23,0.222,0.267,0.511,17.658,4,riffle_perfect,win
1445,24,17,7,3,44,0.545,27,0.614,6,0,1.0,2,2,26,18,13,17,14,0.295,0.386,0.318,17.732,6,riffle_perfect,win
1447,22,21,1,3,46,0.478,25,0.5429999999999999,5,5,0.5,1,2,26,20,9,13,24,0.196,0.28300000000000003,0.522,17.732,8,riffle_perfect,win
1451,22,21,1,2,45,0.489,24,0.5329999999999999,2,3,0.4,2,2,26,19,14,20,11,0.311,0.444,0.244,17.761,12,riffle_perfect,win
1454,23,18,5,3,44,0.523,26,0.591,3,2,0.6,3,1,29,15,10,10,24,0.22699999999999998,0.22699999999999998,0.545,17.715999999999998,15,riffle_perfect,win
1455,27,16,11,2,45,0.6,29,0.644,4,1,0.8,5,2,22,23,18,15,12,0.4,0.33299999999999996,0.267,17.692999999999998,16,riffle_perfect,win
1458,24,18,6,2,44,0.545,26,0.591,2,2,0.5,1,0,32,12,13,10,21,0.295,0.22699999999999998,0.47700000000000004,17.675,19,riffle_perfect,win
1466,22,21,1,3,46,0.478,25,0.5429999999999999,4,4,0.5,4,1,33,13,7,12,27,0.152,0.261,0.5870000000000001,17.65,27,riffle_perfect,win
1472,22,20,2,2,44,0.5,24,0.545,3,4,0.429,4,3,28,16,9,13,22,0.205,0.295,0.5,17.601,33,riffle_perfect,win
1475,23,19,4,3,45,0.511,26,0.578,3,1,0.75,1,1,21,24,12,18,15,0.267,0.4,0.33299999999999996,17.63,36,riffle_perfect,win
1482,28,22,6,0,50,0.56,28,0.56,5,1,0.833,2,0,31,19,16,12,22,0.32,0.24,0.44,17.673,43,riffle_perfect,win
1483,31,14,17,3,48,0.6459999999999999,34,0.708,6,2,0.75,1,0,30,18,16,11,21,0.33299999999999996,0.22899999999999998,0.43799999999999994,17.660999999999998,44,riffle_perfect,win
1490,25,23,2,2,50,0.5,27,0.54,2,3,0.4,4,5,32,18,13,6,31,0.26,0.12,0.62,17.639,51,riffle_perfect,win
1494,22,21,1,1,44,0.5,23,0.523,4,0,1.0,2,0,26,18,9,14,21,0.205,0.318,0.47700000000000004,17.659000000000002,55,riffle_perfect,win
1498,25,18,7,3,46,0.5429999999999999,28,0.609,3,2,0.6,7,1,25,21,13,15,18,0.28300000000000003,0.326,0.391,17.68,59,riffle_perfect,win
1503,25,21,4,1,47,0.532,26,0.5529999999999999,1,2,0.33299999999999996,4,1,33,14,14,11,22,0.298,0.23399999999999999,0.46799999999999997,17.657,64,riffle_perfect,win
1507,24,20,4,1,45,0.5329999999999999,25,0.556,3,2,0.6,2,1,30,15,10,10,25,0.222,0.222,0.556,17.642,68,riffle_perfect,win
1509,23,22,1,2,47,0.489,25,0.532,1,5,0.16699999999999998,3,1,22,25,12,22,13,0.255,0.46799999999999997,0.27699999999999997,17.634,70,riffle_perfect,win
1521,23,20,3,1,44,0.523,24,0.545,2,3,0.4,2,1,29,15,12,14,18,0.273,0.318,0.409,17.678,82,riffle_perfect,win
1527,24,18,6,2,44,0.545,26,0.591,5,3,0.625,3,0,25,19,12,14,18,0.273,0.318,0.409,17.688,88,riffle_perfect,win
1538,23,22,1,3,48,0.479,26,0.542,3,2,0.6,1,4,31,17,13,15,20,0.271,0.312,0.41700000000000004,18.144000000000002,3,riffle_perfect,win
1542,25,20,5,1,46,0.5429999999999999,26,0.565,3,2,0.6,2,2,28,18,10,12,24,0.217,0.261,0.522,18.048,7,riffle_perfect,win
1543,26,19,7,2,47,0.5529999999999999,28,0.596,1,0,1.0,1,3,26,21,13,17,17,0.27699999999999997,0.36200000000000004,0.36200000000000004,18.009,8,riffle_perfect,win
1552,24,19,5,3,46,0.522,27,0.5870000000000001,4,1,0.8,3,3,30,16,10,12,24,0.217,0.261,0.522,17.906,17,riffle_perfect,win
1572,26,24,2,0,50,0.52,26,0.52,2,3,0.4,2,4,31,19,17,11,22,0.34,0.22,0.44,17.754,37,riffle_perfect,win
1574,26,20,6,1,47,0.5529999999999999,27,0.574,3,4,0.429,5,0,22,25,14,15,18,0.298,0.319,0.38299999999999995,17.732,39,riffle_perfect,win
1579,22,19,3,3,44,0.5,25,0.568,1,0,1.0,2,1,31,13,16,7,21,0.364,0.159,0.47700000000000004,17.708,44,riffle_perfect,win
1589,26,14,12,3,43,0.605,29,0.674,5,1,0.833,3,0,20,23,16,14,13,0.37200000000000005,0.326,0.302,17.649,54,riffle_perfect,win
1591,25,17,8,2,44,0.568,27,0.614,6,1,0.857,2,3,27,17,17,10,17,0.386,0.22699999999999998,0.386,17.655,56,riffle_perfect,win
1595,25,18,7,1,44,0.568,26,0.591,6,1,0.857,4,1,27,17,17,9,18,0.386,0.205,0.409,17.652,60,riffle_perfect,win
1599,25,18,7,3,46,0.5429999999999999,28,0.609,5,1,0.833,2,1,32,14,12,12,22,0.261,0.261,0.478,17.65,64,riffle_perfect,win
1616,25,18,7,3,46,0.5429999999999999,28,0.609,6,3,0.667,1,3,28,18,17,12,17,0.37,0.261,0.37,17.691,81,riffle_perfect,win
1636,27,15,12,3,45,0.6,30,0.667,2,6,0.25,3,3,25,20,17,13,15,0.37799999999999995,0.289,0.33299999999999996,17.695,5,riffle_perfect,win
1641,22,21,1,2,45,0.489,24,0.5329999999999999,6,1,0.857,1,3,28,17,8,17,20,0.17800000000000002,0.37799999999999995,0.444,17.594,10,riffle_perfect,win
1645,23,20,3,3,46,0.5,26,0.565,4,2,0.667,4,3,32,14,11,11,24,0.239,0.239,0.522,17.471,14,riffle_perfect,win
1653,22,21,1,2,45,0.489,24,0.5329999999999999,2,1,0.667,2,2,28,17,13,16,16,0.289,0.35600000000000004,0.35600000000000004,17.551,22,riffle_perfect,win
1656,27,15,12,3,45,0.6,30,0.667,4,0,1.0,3,2,31,14,8,10,27,0.17800000000000002,0.222,0.6,17.575,25,riffle_perfect,win
1662,22,20,2,3,45,0.489,25,0.556,3,2,0.6,2,2,27,18,12,12,21,0.267,0.267,0.467,17.65,31,riffle_perfect,win
1666,26,19,7,3,48,0.542,29,0.604,4,0,1.0,0,2,32,16,16,16,16,0.33299999999999996,0.33299999999999996,0.33299999999999996,17.689,35,riffle_perfect,win
1677,25,19,6,1,45,0.556,26,0.578,4,3,0.5710000000000001,1,0,29,16,15,12,18,0.33299999999999996,0.267,0.4,17.729,46,riffle_perfect,win
1691,22,21,1,3,46,0.478,25,0.5429999999999999,3,0,1.0,0,2,31,15,9,15,22,0.196,0.326,0.478,17.686,60,riffle_perfect,win
1695,23,20,3,2,45,0.511,25,0.556,4,2,0.667,3,1,28,17,17,9,19,0.37799999999999995,0.2,0.42200000000000004,17.713,64,riffle_perfect,win
1703,23,21,2,3,47,0.489,26,0.5529999999999999,3,2,0.6,2,1,26,21,14,9,24,0.298,0.191,0.511,17.726,72,riffle_perfect,win
1706,27,17,10,2,46,0.5870000000000001,29,0.63,4,2,0.667,2,0,28,18,14,12,20,0.304,0.261,0.435,17.727,75,riffle_perfect,win
1708,26,20,6,2,48,0.542,28,0.583,6,2,0.75,2,4,30,18,19,7,22,0.396,0.146,0.45799999999999996,17.713,77,riffle_perfect,win
1710,24,19,5,2,45,0.5329999999999999,26,0.578,3,1,0.75,3,1,25,20,13,12,20,0.289,0.267,0.444,17.71,79,riffle_perfect,win
1732,21,20,1,2,43,0.488,23,0.535,4,1,0.8,2,2,27,16,11,18,14,0.256,0.419,0.326,17.944000000000003,5,riffle_perfect,win
1739,23,21,2,1,45,0.511,24,0.5329999999999999,3,2,0.6,2,0,23,22,12,15,18,0.267,0.33299999999999996,0.4,17.932000000000002,12,riffle_perfect,win
1749,24,16,8,3,43,0.5579999999999999,27,0.628,5,1,0.833,3,4,27,16,14,12,17,0.326,0.27899999999999997,0.395,17.797,22,riffle_perfect,win
1752,25,17,8,2,44,0.568,27,0.614,5,3,0.625,1,3,24,20,11,14,19,0.25,0.318,0.43200000000000005,17.802,25,riffle_perfect,win
1763,25,17,8,2,44,0.568,27,0.614,2,4,0.33299999999999996,1,1,28,16,9,16,19,0.205,0.364,0.43200000000000005,17.774,36,riffle_perfect,win
1772,27,16,11,3,46,0.5870000000000001,30,0.652,6,2,0.75,4,2,29,17,14,10,22,0.304,0.217,0.478,17.771,45,riffle_perfect,win
1773,26,18,8,1,45,0.578,27,0.6,1,3,0.25,5,1,23,22,11,17,17,0.244,0.37799999999999995,0.37799999999999995,17.752,46,riffle_perfect,win
1776,27,19,8,3,49,0.551,30,0.612,3,1,0.75,2,1,30,19,18,16,15,0.36700000000000005,0.327,0.306,17.768,49,riffle_perfect,win
1780,25,19,6,1,45,0.556,26,0.578,2,1,0.667,3,0,22,23,15,14,16,0.33299999999999996,0.311,0.35600000000000004,17.752,53,riffle_perfect,win
1785,31,16,15,0,47,0.66,31,0.66,4,0,1.0,3,2,26,21,19,9,19,0.40399999999999997,0.191,0.40399999999999997,17.750999999999998,58,riffle_perfect,win
1789,23,20,3,3,46,0.5,26,0.565,5,2,0.7140000000000001,3,1,30,16,11,15,20,0.239,0.326,0.435,17.755,62,riffle_perfect,win
1798,28,16,12,2,46,0.609,30,0.652,2,0,1.0,4,0,28,18,17,11,18,0.37,0.239,0.391,17.752,71,riffle_perfect,win
1802,23,20,3,3,46,0.5,26,0.565,2,3,0.4,2,1,22,24,14,15,17,0.304,0.326,0.37,17.753,75,riffle_perfect,win
1804,21,20,1,3,44,0.47700000000000004,24,0.545,3,2,0.6,2,2,26,18,14,7,23,0.318,0.159,0.523,17.769000000000002,77,riffle_perfect,win
1806,22,20,2,3,45,0.489,25,0.556,3,1,0.75,2,1,28,17,11,12,22,0.244,0.267,0.489,17.777,79,riffle_perfect,win
1811,28,16,12,0,44,0.636,28,0.636,3,3,0.5,0,0,25,19,19,9,16,0.43200000000000005,0.205,0.364,17.792,84,riffle_perfect,win
1817,22,20,2,3,45,0.489,25,0.556,2,1,0.667,1,2,25,20,10,17,18,0.222,0.37799999999999995,0.4,17.791,90,riffle_perfect,win
1821,23,21,2,3,47,0.489,26,0.5529999999999999,2,3,0.4,4,1,29,18,10,17,20,0.213,0.36200000000000004,0.426,17.776,94,riffle_perfect,win
1824,22,20,2,1,43,0.512,23,0.535,3,2,0.6,4,3,18,25,11,15,17,0.256,0.349,0.395,16.808,1,riffle_perfect,win
1825,24,20,4,2,46,0.522,26,0.565,3,3,0.5,2,0,27,19,12,18,16,0.261,0.391,0.348,17.37,2,riffle_perfect,win
1826,30,13,17,2,45,0.667,32,0.711,5,1,0.833,4,2,29,16,12,9,24,0.267,0.2,0.5329999999999999,17.619,3,riffle_perfect,win
1829,22,20,2,3,45,0.489,25,0.556,3,2,0.6,1,2,30,15,9,14,22,0.2,0.311,0.489,17.477,6,riffle_perfect,win
1840,27,18,9,2,47,0.574,29,0.617,5,3,0.625,2,0,25,22,15,15,17,0.319,0.319,0.36200000000000004,17.628,17,riffle_perfect,win
1853,25,21,4,1,47,0.532,26,0.5529999999999999,4,1,0.8,4,3,29,18,12,10,25,0.255,0.213,0.532,17.656,30,riffle_perfect,win
1854,29,15,14,3,47,0.617,32,0.6809999999999999,6,1,0.857,3,3,28,19,14,14,19,0.298,0.298,0.40399999999999997,17.667,31,riffle_perfect,win
1858,23,18,5,3,44,0.523,26,0.591,4,2,0.667,3,2,27,17,14,10,20,0.318,0.22699999999999998,0.455,17.68,35,riffle_perfect,win
1860,27,19,8,3,49,0.551,30,0.612,2,2,0.5,3,3,30,19,13,14,22,0.265,0.28600000000000003,0.449,17.69,37,riffle_perfect,win
1863,22,20,2,3,45,0.489,25,0.556,2,1,0.667,5,2,29,16,9,12,24,0.2,0.267,0.5329999999999999,17.651,40,riffle_perfect,win
1864,24,19,5,2,45,0.5329999999999999,26,0.578,2,0,1.0,5,2,29,16,9,12,24,0.2,0.267,0.5329999999999999,17.648,41,riffle_perfect,win
1868,24,18,6,3,45,0.5329999999999999,27,0.6,3,3,0.5,3,1,22,23,13,16,16,0.289,0.35600000000000004,0.35600000000000004,17.639,45,riffle_perfect,win
1887,26,21,5,2,49,0.531,28,0.5710000000000001,3,3,0.5,4,1,27,22,13,15,21,0.265,0.306,0.429,17.644000000000002,64,riffle_perfect,win
1894,24,19,5,1,44,0.545,25,0.568,5,3,0.625,4,1,22,22,12,10,22,0.273,0.22699999999999998,0.5,17.65,71,riffle_perfect,win
1900,24,19,5,0,43,0.5579999999999999,24,0.5579999999999999,3,1,0.75,3,2,22,21,16,8,19,0.37200000000000005,0.18600000000000003,0.442,17.67,77,riffle_perfect,win
1902,20,19,1,3,42,0.47600000000000003,23,0.5479999999999999,2,1,0.667,1,0,35,7,10,14,18,0.23800000000000002,0.33299999999999996,0.429,17.677,79,riffle_perfect,win
1905,24,22,2,2,48,0.5,26,0.542,3,3,0.5,3,2,28,20,13,12,23,0.271,0.25,0.479,17.669,82,riffle_perfect,win
1906,23,20,3,2,45,0.511,25,0.556,4,3,0.5710000000000001,1,1,29,16,12,14,19,0.267,0.311,0.42200000000000004,17.678,83,riffle_perfect,win
1912,22,19,3,3,44,0.5,25,0.568,5,2,0.7140000000000001,3,0,22,22,11,17,16,0.25,0.386,0.364,17.673,89,riffle_perfect,win
1914,21,20,1,3,44,0.47700000000000004,24,0.545,5,1,0.833,1,2,26,18,14,15,15,0.318,0.341,0.341,17.683,91,riffle_perfect,win
1929,24,21,3,2,47,0.511,26,0.5529999999999999,3,5,0.375,1,1,25,22,15,12,20,0.319,0.255,0.426,17.605,10,riffle_clumpy,win
1931,23,19,4,2,44,0.523,25,0.568,5,3,0.625,2,1,23,21,16,8,20,0.364,0.182,0.455,17.682000000000002,12,riffle_clumpy,win
1945,22,21,1,2,45,0.489,24,0.5329999999999999,4,3,0.5710000000000001,0,3,26,19,11,17,17,0.244,0.37799999999999995,0.37799999999999995,17.687,26,riffle_clumpy,win
1966,27,19,8,2,48,0.562,29,0.604,3,3,0.5,4,2,30,18,10,12,26,0.20800000000000002,0.25,0.542,17.694000000000003,47,riffle_clumpy,win
1970,24,19,5,3,46,0.522,27,0.5870000000000001,5,4,0.556,1,3,23,23,15,13,18,0.326,0.28300000000000003,0.391,17.668,51,riffle_clumpy,win
1975,27,13,14,3,43,0.628,30,0.698,5,2,0.7140000000000001,2,3,25,18,18,9,16,0.419,0.209,0.37200000000000005,17.647000000000002,56,riffle_clumpy,win
1982,25,20,5,1,46,0.5429999999999999,26,0.565,4,2,0.667,4,3,23,23,15,13,18,0.326,0.28300000000000003,0.391,17.621,63,riffle_clumpy,win
1993,28,17,11,3,48,0.583,31,0.6459999999999999,6,3,0.667,2,2,27,21,17,15,16,0.354,0.312,0.33299999999999996,17.644000000000002,74,riffle_clumpy,win
1995,24,19,5,3,46,0.522,27,0.5870000000000001,4,2,0.667,4,0,29,17,12,16,18,0.261,0.348,0.391,17.652,76,riffle_clumpy,win
1997,27,19,8,1,47,0.574,28,0.596,4,5,0.444,3,1,23,24,16,16,15,0.34,0.34,0.319,17.647000000000002,78,riffle_clumpy,win
2001,22,21,1,2,45,0.489,24,0.5329999999999999,1,5,0.16699999999999998,3,3,23,22,12,16,17,0.267,0.35600000000000004,0.37799999999999995,17.646,82,riffle_clumpy,win
2002,22,21,1,2,45,0.489,24,0.5329999999999999,2,1,0.667,3,1,27,18,9,18,18,0.2,0.4,0.4,17.645,83,riffle_clumpy,win
2006,23,19,4,2,44,0.523,25,0.568,3,0,1.0,3,0,27,17,15,9,20,0.341,0.205,0.455,17.673,87,riffle_clumpy,win
2014,21,20,1,3,44,0.47700000000000004,24,0.545,1,0,1.0,0,2,26,18,14,12,18,0.318,0.273,0.409,17.678,95,riffle_clumpy,win
2018,22,19,3,3,44,0.5,25,0.568,1,3,0.25,4,0,27,17,10,16,18,0.22699999999999998,0.364,0.409,17.598,3,riffle_clumpy,win
2022,23,20,3,2,45,0.511,25,0.556,3,0,1.0,5,1,22,23,10,14,21,0.222,0.311,0.467,17.552,7,riffle_clumpy,win
2029,24,20,4,3,47,0.511,27,0.574,2,1,0.667,2,3,28,19,12,12,23,0.255,0.255,0.489,17.653,14,riffle_clumpy,win
2033,21,20,1,3,44,0.47700000000000004,24,0.545,3,6,0.33299999999999996,3,3,25,19,15,12,17,0.341,0.273,0.386,17.619,18,riffle_clumpy,win
2034,24,16,8,3,43,0.5579999999999999,27,0.628,2,1,0.667,1,1,26,17,16,10,17,0.37200000000000005,0.233,0.395,17.593,19,riffle_clumpy,win
2037,22,20,2,1,43,0.512,23,0.535,4,2,0.667,1,0,24,19,10,19,14,0.233,0.442,0.326,17.625999999999998,22,riffle_clumpy,win
2038,22,21,1,2,45,0.489,24,0.5329999999999999,6,3,0.667,1,1,29,16,11,14,20,0.244,0.311,0.444,17.648,23,riffle_clumpy,win
2062,26,15,11,3,44,0.591,29,0.659,5,2,0.7140000000000001,4,2,25,19,14,9,21,0.318,0.205,0.47700000000000004,17.665,47,riffle_clumpy,win
2067,23,18,5,3,44,0.523,26,0.591,1,5,0.16699999999999998,3,2,28,16,15,13,16,0.341,0.295,0.364,17.699,52,riffle_clumpy,win
2080,25,18,7,0,43,0.581,25,0.581,3,1,0.75,0,2,26,17,12,11,20,0.27899999999999997,0.256,0.465,17.754,65,riffle_clumpy,win
2084,28,17,11,0,45,0.622,28,0.622,3,2,0.6,1,0,23,22,16,12,17,0.35600000000000004,0.267,0.37799999999999995,17.777,69,riffle_clumpy,win
2087,25,17,8,3,45,0.556,28,0.622,6,0,1.0,2,3,27,18,13,13,19,0.289,0.289,0.42200000000000004,17.756,72,riffle_clumpy,win
2097,25,18,7,3,46,0.5429999999999999,28,0.609,7,1,0.875,1,2,25,21,19,10,17,0.413,0.217,0.37,17.747,82,riffle_clumpy,win
2102,23,21,2,2,46,0.5,25,0.5429999999999999,4,4,0.5,5,3,24,22,13,13,20,0.28300000000000003,0.28300000000000003,0.435,17.750999999999998,87,riffle_clumpy,win
2113,26,18,8,3,47,0.5529999999999999,29,0.617,5,2,0.7140000000000001,4,0,30,17,13,15,19,0.27699999999999997,0.319,0.40399999999999997,17.137999999999998,2,riffle_clumpy,win
2116,26,16,10,3,45,0.578,29,0.644,3,1,0.75,0,2,32,13,11,15,19,0.244,0.33299999999999996,0.42200000000000004,17.646,5,riffle_clumpy,win
2126,25,18,7,2,45,0.556,27,0.6,3,3,0.5,0,2,24,21,11,18,16,0.244,0.4,0.35600000000000004,17.667,15,riffle_clumpy,win
2127,25,18,7,3,46,0.5429999999999999,28,0.609,2,1,0.667,1,4,26,20,16,11,19,0.348,0.239,0.413,17.682000000000002,16,riffle_clumpy,win
2132,23,18,5,3,44,0.523,26,0.591,4,1,0.8,2,3,30,14,10,16,18,0.22699999999999998,0.364,0.409,17.750999999999998,21,riffle_clumpy,win
2134,23,21,2,1,45,0.511,24,0.5329999999999999,4,2,0.667,3,1,28,17,14,14,17,0.311,0.311,0.37799999999999995,17.771,23,riffle_clumpy,win
2136,26,20,6,2,48,0.542,28,0.583,3,2,0.6,4,1,28,20,15,12,21,0.312,0.25,0.43799999999999994,17.794,25,riffle_clumpy,win
2139,24,22,2,1,47,0.511,25,0.532,4,1,0.8,3,0,31,16,12,13,22,0.255,0.27699999999999997,0.46799999999999997,17.805,28,riffle_clumpy,win
2140,24,20,4,3,47,0.511,27,0.574,5,1,0.833,1,3,25,22,9,20,18,0.191,0.426,0.38299999999999995,17.805,29,riffle_clumpy,win
2142,24,17,7,3,44,0.545,27,0.614,2,1,0.667,2,2,23,21,15,15,14,0.341,0.341,0.318,17.768,31,riffle_clumpy,win
2150,23,20,3,2,45,0.511,25,0.556,3,2,0.6,2,0,28,17,12,12,21,0.267,0.267,0.467,17.733,39,riffle_clumpy,win
2157,24,21,3,1,46,0.522,25,0.5429999999999999,6,2,0.75,2,1,28,18,13,12,21,0.28300000000000003,0.261,0.457,17.677,46,riffle_clumpy,win
2158,32,13,19,3,48,0.667,35,0.7290000000000001,6,1,0.857,4,1,25,23,18,13,17,0.375,0.271,0.354,17.673,47,riffle_clumpy,win
2163,24,19,5,2,45,0.5329999999999999,26,0.578,4,1,0.8,4,3,31,14,11,13,21,0.244,0.289,0.467,17.651,52,riffle_clumpy,win
2169,24,20,4,2,46,0.522,26,0.565,4,5,0.444,4,0,30,16,15,11,20,0.326,0.239,0.435,17.624000000000002,58,riffle_clumpy,win
2178,26,19,7,3,48,0.542,29,0.604,7,0,1.0,4,3,25,23,15,15,18,0.312,0.312,0.375,17.645,67,riffle_clumpy,win
2182,21,20,1,3,44,0.47700000000000004,24,0.545,4,0,1.0,2,0,27,17,12,10,22,0.273,0.22699999999999998,0.5,17.65,71,riffle_clumpy,win
2189,24,22,2,3,49,0.49,27,0.551,5,2,0.7140000000000001,1,3,27,22,15,13,21,0.306,0.265,0.429,17.653,78,riffle_clumpy,win
2193,26,15,11,3,44,0.591,29,0.659,4,1,0.8,1,1,32,12,18,8,18,0.409,0.182,0.409,17.665,82,riffle_clumpy,win
2201,26,17,9,3,46,0.565,29,0.63,2,2,0.5,1,1,19,27,15,15,16,0.326,0.326,0.348,17.660999999999998,90,riffle_clumpy,win
2202,24,21,3,1,46,0.522,25,0.5429999999999999,5,3,0.625,3,1,27,19,13,11,22,0.28300000000000003,0.239,0.478,17.657,91,riffle_clumpy,win
2203,28,19,9,1,48,0.583,29,0.604,4,1,0.8,6,3,26,22,12,13,23,0.25,0.271,0.479,17.643,92,riffle_clumpy,win
2208,31,16,15,2,49,0.633,33,0.6729999999999999,3,3,0.5,3,3,34,15,17,11,21,0.34700000000000003,0.22399999999999998,0.429,18.333,1,riffle_clumpy,win
2213,23,20,3,2,45,0.511,25,0.556,2,2,0.5,2,2,24,21,19,11,15,0.42200000000000004,0.244,0.33299999999999996,17.754,6,riffle_clumpy,win
2215,25,18,7,2,45,0.556,27,0.6,3,3,0.5,5,3,22,23,12,16,17,0.267,0.35600000000000004,0.37799999999999995,17.817,8,riffle_clumpy,win
2218,24,18,6,2,44,0.545,26,0.591,2,2,0.5,6,2,24,20,11,12,21,0.25,0.273,0.47700000000000004,17.705,11,riffle_clumpy,win
2223,24,20,4,0,44,0.545,24,0.545,3,2,0.6,0,4,24,20,13,16,15,0.295,0.364,0.341,17.654,16,riffle_clumpy,win
2224,27,19,8,0,46,0.5870000000000001,27,0.5870000000000001,5,1,0.833,5,0,25,21,14,13,19,0.304,0.28300000000000003,0.413,17.581,17,riffle_clumpy,win
2227,26,16,10,3,45,0.578,29,0.644,3,0,1.0,3,3,26,19,15,11,19,0.33299999999999996,0.244,0.42200000000000004,17.648,20,riffle_clumpy,win
2228,21,19,2,3,43,0.488,24,0.5579999999999999,3,2,0.6,1,1,26,17,11,12,20,0.256,0.27899999999999997,0.465,17.645,21,riffle_clumpy,win
2237,25,21,4,1,47,0.532,26,0.5529999999999999,6,1,0.857,2,1,25,22,10,20,17,0.213,0.426,0.36200000000000004,17.713,30,riffle_clumpy,win
2249,22,21,1,3,46,0.478,25,0.5429999999999999,2,2,0.5,3,3,32,14,9,10,27,0.196,0.217,0.5870000000000001,17.662,42,riffle_clumpy,win
2253,23,20,3,2,45,0.511,25,0.556,1,0,1.0,5,1,29,16,12,11,22,0.267,0.244,0.489,17.698,46,riffle_clumpy,win
2254,23,21,2,2,46,0.5,25,0.5429999999999999,2,1,0.667,3,2,30,16,9,15,22,0.196,0.326,0.478,17.695,47,riffle_clumpy,win
2255,23,21,2,3,47,0.489,26,0.5529999999999999,1,1,0.5,3,2,27,20,17,12,18,0.36200000000000004,0.255,0.38299999999999995,17.695999999999998,48,riffle_clumpy,win
2262,25,18,7,3,46,0.5429999999999999,28,0.609,7,2,0.778,1,2,28,18,14,13,19,0.304,0.28300000000000003,0.413,17.701,55,riffle_clumpy,win
2280,26,16,10,3,45,0.578,29,0.644,3,1,0.75,0,3,28,17,15,13,17,0.33299999999999996,0.289,0.37799999999999995,17.711,73,riffle_clumpy,win
2291,21,20,1,2,43,0.488,23,0.535,5,0,1.0,2,3,31,12,13,10,20,0.302,0.233,0.465,17.701,84,riffle_clumpy,win
2301,27,16,11,2,45,0.6,29,0.644,3,1,0.75,2,3,25,20,17,8,20,0.37799999999999995,0.17800000000000002,0.444,17.708,94,riffle_clumpy,win
2303,24,21,3,2,47,0.511,26,0.5529999999999999,5,2,0.7140000000000001,4,1,30,17,13,9,25,0.27699999999999997,0.191,0.532,17.704,96,riffle_clumpy,win
2318,25,15,10,2,42,0.595,27,0.643,4,1,0.8,0,0,31,11,13,6,23,0.31,0.14300000000000002,0.5479999999999999,17.572,15,riffle_clumpy,win
2319,24,18,6,3,45,0.5329999999999999,27,0.6,3,1,0.75,1,2,23,22,9,18,18,0.2,0.4,0.4,17.577,16,riffle_clumpy,win
2321,23,19,4,3,45,0.511,26,0.578,1,2,0.33299999999999996,1,3,28,17,14,12,19,0.311,0.267,0.42200000000000004,17.575,18,riffle_clumpy,win
2323,30,12,18,3,45,0.667,33,0.733,6,0,1.0,4,0,26,19,15,13,17,0.33299999999999996,0.289,0.37799999999999995,17.546,20,riffle_clumpy,win
2328,24,19,5,1,44,0.545,25,0.568,4,3,0.5710000000000001,5,3,27,17,12,11,21,0.273,0.25,0.47700000000000004,17.589000000000002,25,riffle_clumpy,win
2331,22,19,3,3,44,0.5,25,0.568,3,2,0.6,3,4,28,16,13,14,17,0.295,0.318,0.386,17.596,28,riffle_clumpy,win
2337,27,15,12,2,44,0.614,29,0.659,5,1,0.833,4,0,22,22,11,14,19,0.25,0.318,0.43200000000000005,17.607,34,riffle_clumpy,win
2343,27,16,11,3,46,0.5870000000000001,30,0.652,4,4,0.5,3,1,29,17,19,9,18,0.413,0.196,0.391,17.618,40,riffle_clumpy,win
2346,24,18,6,3,45,0.5329999999999999,27,0.6,3,1,0.75,2,1,22,23,15,16,14,0.33299999999999996,0.35600000000000004,0.311,17.645,43,riffle_clumpy,win
2350,29,14,15,2,45,0.644,31,0.6890000000000001,4,0,1.0,4,2,23,22,19,13,13,0.42200000000000004,0.289,0.289,17.636,47,riffle_clumpy,win
2358,21,20,1,3,44,0.47700000000000004,24,0.545,1,5,0.16699999999999998,0,1,26,18,14,14,16,0.318,0.318,0.364,17.622,55,riffle_clumpy,win
2366,25,17,8,3,45,0.556,28,0.622,4,5,0.444,4,1,28,17,9,13,23,0.2,0.289,0.511,17.628,63,riffle_clumpy,win
2376,23,22,1,0,45,0.511,23,0.511,3,2,0.6,2,2,29,16,12,13,20,0.267,0.289,0.444,17.616,73,riffle_clumpy,win
2382,24,21,3,2,47,0.511,26,0.5529999999999999,6,1,0.857,2,4,29,18,14,13,20,0.298,0.27699999999999997,0.426,17.633,79,riffle_clumpy,win
2385,24,20,4,1,45,0.5329999999999999,25,0.556,2,1,0.667,3,1,25,20,16,13,16,0.35600000000000004,0.289,0.35600000000000004,17.63,82,riffle_clumpy,win
2388,22,19,3,3,44,0.5,25,0.568,4,3,0.5710000000000001,1,4,30,14,14,11,19,0.318,0.25,0.43200000000000005,17.629,85,riffle_clumpy,win
2410,28,16,12,3,47,0.596,31,0.66,3,0,1.0,2,2,22,25,19,10,18,0.40399999999999997,0.213,0.38299999999999995,17.675,11,riffle_clumpy,win
2414,22,21,1,3,46,0.478,25,0.5429999999999999,3,3,0.5,5,3,27,19,9,18,19,0.196,0.391,0.413,17.691,15,riffle_clumpy,win
2418,25,15,10,1,41,0.61,26,0.634,4,1,0.8,1,1,25,16,16,9,16,0.39,0.22,0.39,17.674,19,riffle_clumpy,win
2427,23,20,3,3,46,0.5,26,0.565,3,3,0.5,1,3,29,17,14,14,18,0.304,0.304,0.391,17.665,28,riffle_clumpy,win
2428,23,17,6,3,43,0.535,26,0.605,4,1,0.8,2,1,29,14,14,12,17,0.326,0.27899999999999997,0.395,17.647000000000002,29,riffle_clumpy,win
2432,22,21,1,2,45,0.489,24,0.5329999999999999,1,1,0.5,3,2,25,20,11,13,21,0.244,0.289,0.467,17.645,33,riffle_clumpy,win
2434,21,20,1,2,43,0.488,23,0.535,2,4,0.33299999999999996,3,1,27,16,13,11,19,0.302,0.256,0.442,17.643,35,riffle_clumpy,win
2441,24,19,5,2,45,0.5329999999999999,26,0.578,3,3,0.5,5,2,28,17,12,16,17,0.267,0.35600000000000004,0.37799999999999995,17.682000000000002,42,riffle_clumpy,win
2442,25,19,6,3,47,0.532,28,0.596,4,1,0.8,4,3,27,20,13,14,20,0.27699999999999997,0.298,0.426,17.686,43,riffle_clumpy,win
2445,27,18,9,2,47,0.574,29,0.617,4,1,0.8,3,4,28,19,17,11,19,0.36200000000000004,0.23399999999999999,0.40399999999999997,17.643,46,riffle_clumpy,win
2468,22,20,2,2,44,0.5,24,0.545,6,3,0.667,0,3,24,20,14,15,15,0.318,0.341,0.341,17.613,69,riffle_clumpy,win
2473,26,17,9,3,46,0.565,29,0.63,1,5,0.16699999999999998,2,2,28,18,17,12,17,0.37,0.261,0.37,17.619,74,riffle_clumpy,win
2474,24,18,6,2,44,0.545,26,0.591,3,1,0.75,0,0,30,14,12,14,18,0.273,0.318,0.409,17.619,75,riffle_clumpy,win
2482,26,13,13,3,42,0.619,29,0.69,7,0,1.0,1,1,28,14,13,6,23,0.31,0.14300000000000002,0.5479999999999999,17.624000000000002,83,riffle_clumpy,win
2483,28,21,7,1,50,0.56,29,0.58,4,1,0.8,1,4,32,18,16,16,18,0.32,0.32,0.36,17.632,84,riffle_clumpy,win
2490,21,19,2,3,43,0.488,24,0.5579999999999999,6,0,1.0,3,1,20,23,9,18,16,0.209,0.419,0.37200000000000005,17.654,91,riffle_clumpy,win
2502,23,18,5,1,42,0.5479999999999999,24,0.5710000000000001,7,0,1.0,3,1,24,18,13,12,17,0.31,0.28600000000000003,0.405,17.276,7,riffle_clumpy,win
2507,28,14,14,2,44,0.636,30,0.682,5,2,0.7140000000000001,3,0,25,19,15,7,22,0.341,0.159,0.5,17.309,12,riffle_clumpy,win
2508,21,20,1,3,44,0.47700000000000004,24,0.545,3,1,0.75,1,3,30,14,13,8,23,0.295,0.182,0.523,17.344,13,riffle_clumpy,win
2514,21,19,2,3,43,0.488,24,0.5579999999999999,2,2,0.5,1,1,25,18,13,14,16,0.302,0.326,0.37200000000000005,17.476,19,riffle_clumpy,win
2515,26,21,5,1,48,0.542,27,0.562,2,3,0.4,3,2,25,23,16,11,21,0.33299999999999996,0.22899999999999998,0.43799999999999994,17.521,20,riffle_clumpy,win
2523,22,21,1,3,46,0.478,25,0.5429999999999999,4,1,0.8,1,1,26,20,12,15,19,0.261,0.326,0.413,17.489,28,riffle_clumpy,win
2528,22,18,4,3,43,0.512,25,0.581,5,1,0.833,4,3,19,24,14,16,13,0.326,0.37200000000000005,0.302,17.492,33,riffle_clumpy,win
2532,30,15,15,0,45,0.667,30,0.667,4,3,0.5710000000000001,5,3,21,24,16,11,18,0.35600000000000004,0.244,0.4,17.506,37,riffle_clumpy,win
2536,24,17,7,3,44,0.545,27,0.614,3,3,0.5,2,2,28,16,13,11,20,0.295,0.25,0.455,17.598,41,riffle_clumpy,win
2540,26,16,10,3,45,0.578,29,0.644,3,2,0.6,4,2,28,17,14,14,17,0.311,0.311,0.37799999999999995,17.645,45,riffle_clumpy,win
2545,24,22,2,1,47,0.511,25,0.532,3,1,0.75,4,4,30,17,12,14,21,0.255,0.298,0.447,17.646,50,riffle_clumpy,win
2547,24,20,4,0,44,0.545,24,0.545,5,2,0.7140000000000001,2,2,31,13,17,8,19,0.386,0.182,0.43200000000000005,17.642,52,riffle_clumpy,win
2554,21,19,2,2,42,0.5,23,0.5479999999999999,3,2,0.6,0,0,25,17,16,14,12,0.381,0.33299999999999996,0.28600000000000003,17.66,59,riffle_clumpy,win
2556,25,17,8,2,44,0.568,27,0.614,4,3,0.5710000000000001,1,2,26,18,13,13,18,0.295,0.295,0.409,17.67,61,riffle_clumpy,win
2559,25,15,10,3,43,0.581,28,0.6509999999999999,6,2,0.75,3,1,23,20,11,15,17,0.256,0.349,0.395,17.684,64,riffle_clumpy,win
2561,24,21,3,2,47,0.511,26,0.5529999999999999,1,0,1.0,3,2,31,16,12,12,23,0.255,0.255,0.489,17.679000000000002,66,riffle_clumpy,win
2564,25,20,5,1,46,0.5429999999999999,26,0.565,4,2,0.667,6,2,29,17,9,12,25,0.196,0.261,0.5429999999999999,17.655,69,riffle_clumpy,win
2572,24,21,3,2,47,0.511,26,0.5529999999999999,3,2,0.6,4,1,31,16,12,10,25,0.255,0.213,0.532,17.695,77,riffle_clumpy,win
2578,24,22,2,3,49,0.49,27,0.551,3,4,0.429,0,1,35,14,14,12,23,0.28600000000000003,0.245,0.469,17.702,83,riffle_clumpy,win
2586,26,18,8,0,44,0.591,26,0.591,2,0,1.0,2,0,20,24,19,9,16,0.43200000000000005,0.205,0.364,17.68,91,riffle_clumpy,win
2596,23,19,4,2,44,0.523,25,0.568,2,1,0.667,0,3,26,18,15,11,18,0.341,0.25,0.409,18.154,5,riffle_clumpy,win
2604,25,17,8,3,45,0.556,28,0.622,2,2,0.5,4,2,28,17,13,12,20,0.289,0.267,0.444,17.957,13,riffle_clumpy,win
2606,20,19,1,3,42,0.47600000000000003,23,0.5479999999999999,2,3,0.4,1,0,23,19,13,10,19,0.31,0.23800000000000002,0.452,17.912,15,riffle_clumpy,win
2616,23,20,3,3,46,0.5,26,0.565,4,4,0.5,2,4,27,19,17,11,18,0.37,0.239,0.391,17.907,25,riffle_clumpy,win
2624,21,19,2,3,43,0.488,24,0.5579999999999999,5,2,0.7140000000000001,1,2,24,19,15,14,14,0.349,0.326,0.326,17.883,33,riffle_clumpy,win
2625,25,19,6,3,47,0.532,28,0.596,4,2,0.667,5,1,30,17,10,19,18,0.213,0.40399999999999997,0.38299999999999995,17.867,34,riffle_clumpy,win
2633,26,16,10,2,44,0.591,28,0.636,4,1,0.8,0,4,26,18,15,15,14,0.341,0.341,0.318,17.842,42,riffle_clumpy,win
2640,23,21,2,1,45,0.511,24,0.5329999999999999,4,3,0.5710000000000001,4,0,32,13,8,14,23,0.17800000000000002,0.311,0.511,17.791,49,riffle_clumpy,win
2643,27,18,9,2,47,0.574,29,0.617,6,0,1.0,4,2,33,14,11,10,26,0.23399999999999999,0.213,0.5529999999999999,17.803,52,riffle_clumpy,win
2644,24,19,5,3,46,0.522,27,0.5870000000000001,3,3,0.5,2,1,26,20,17,9,20,0.37,0.196,0.435,17.785,53,riffle_clumpy,win
2645,23,17,6,3,43,0.535,26,0.605,3,4,0.429,0,1,29,14,12,12,19,0.27899999999999997,0.27899999999999997,0.442,17.796,54,riffle_clumpy,win
2654,24,20,4,3,47,0.511,27,0.574,3,3,0.5,4,4,28,19,9,17,21,0.191,0.36200000000000004,0.447,17.773,63,riffle_clumpy,win
2671,21,20,1,3,44,0.47700000000000004,24,0.545,2,5,0.28600000000000003,3,1,25,19,14,12,18,0.318,0.273,0.409,17.707,80,riffle_clumpy,win
2674,25,17,8,3,45,0.556,28,0.622,5,1,0.833,4,3,29,16,14,9,22,0.311,0.2,0.489,17.698,83,riffle_clumpy,win
2675,24,17,7,3,44,0.545,27,0.614,3,1,0.75,3,1,28,16,13,12,19,0.295,0.273,0.43200000000000005,17.705,84,riffle_clumpy,win
2687,26,20,6,2,48,0.542,28,0.583,3,1,0.75,2,1,29,19,17,13,18,0.354,0.271,0.375,17.694000000000003,96,riffle_clumpy,win
2693,28,17,11,2,47,0.596,30,0.638,6,4,0.6,3,0,14,33,20,18,9,0.426,0.38299999999999995,0.191,17.857,6,riffle_clumpy,win
2705,23,16,7,3,42,0.5479999999999999,26,0.619,3,1,0.75,2,1,27,15,12,16,14,0.28600000000000003,0.381,0.33299999999999996,17.771,18,riffle_clumpy,win
2714,27,19,8,3,49,0.551,30,0.612,4,2,0.667,2,4,25,24,15,18,16,0.306,0.36700000000000005,0.327,17.726,27,riffle_clumpy,win
2717,23,18,5,3,44,0.523,26,0.591,3,3,0.5,2,2,32,12,10,13,21,0.22699999999999998,0.295,0.47700000000000004,17.703,30,riffle_clumpy,win
2719,25,20,5,2,47,0.532,27,0.574,4,4,0.5,3,2,26,21,13,15,19,0.27699999999999997,0.319,0.40399999999999997,17.717,32,riffle_clumpy,win
2722,24,19,5,2,45,0.5329999999999999,26,0.578,4,0,1.0,1,2,28,17,16,14,15,0.35600000000000004,0.311,0.33299999999999996,17.727999999999998,35,riffle_clumpy,win
2731,25,20,5,1,46,0.5429999999999999,26,0.565,6,1,0.857,3,0,28,18,12,17,17,0.261,0.37,0.37,17.726,44,riffle_clumpy,win
2751,27,17,10,1,45,0.6,28,0.622,3,1,0.75,3,2,24,21,14,12,19,0.311,0.267,0.42200000000000004,17.726,64,riffle_clumpy,win
2752,25,17,8,3,45,0.556,28,0.622,4,1,0.8,4,1,23,22,14,13,18,0.311,0.289,0.4,17.717,65,riffle_clumpy,win
2761,23,20,3,3,46,0.5,26,0.565,4,4,0.5,6,1,25,21,11,12,23,0.239,0.261,0.5,17.727,74,riffle_clumpy,win
2783,23,20,3,3,46,0.5,26,0.565,6,2,0.75,2,2,25,21,11,15,20,0.239,0.326,0.435,17.699,96,riffle_clumpy,win
2785,24,19,5,3,46,0.522,27,0.5870000000000001,1,1,0.5,1,1,24,22,17,9,20,0.37,0.196,0.435,17.867,2,riffle_clumpy,win
2788,24,19,5,3,46,0.522,27,0.5870000000000001,4,6,0.4,2,2,26,20,11,14,21,0.239,0.304,0.457,17.694000000000003,5,riffle_clumpy,win
2792,22,20,2,3,45,0.489,25,0.556,7,2,0.778,1,1,24,21,15,15,15,0.33299999999999996,0.33299999999999996,0.33299999999999996,17.605,9,riffle_clumpy,win
2795,26,15,11,2,43,0.605,28,0.6509999999999999,4,1,0.8,2,3,26,17,15,9,19,0.349,0.209,0.442,17.522000000000002,12,riffle_clumpy,win
2798,24,17,7,3,44,0.545,27,0.614,8,1,0.889,4,2,25,19,10,11,23,0.22699999999999998,0.25,0.523,17.514,15,riffle_clumpy,win
2804,26,17,9,3,46,0.565,29,0.63,3,1,0.75,2,3,23,23,19,8,19,0.413,0.174,0.413,17.549,21,riffle_clumpy,win
2829,22,21,1,1,44,0.5,23,0.523,4,2,0.667,1,4,28,16,13,12,19,0.295,0.273,0.43200000000000005,17.660999999999998,46,riffle_clumpy,win
2831,23,22,1,1,46,0.5,24,0.522,2,3,0.4,3,4,32,14,15,8,23,0.326,0.174,0.5,17.68,48,riffle_clumpy,win
2833,24,19,5,3,46,0.522,27,0.5870000000000001,4,1,0.8,4,1,23,23,10,22,14,0.217,0.478,0.304,17.675,50,riffle_clumpy,win
2834,22,21,1,3,46,0.478,25,0.5429999999999999,2,1,0.667,3,1,28,18,11,9,26,0.239,0.196,0.565,17.68,51,riffle_clumpy,win
2844,24,21,3,2,47,0.511,26,0.5529999999999999,9,1,0.9,5,1,29,18,12,14,21,0.255,0.298,0.447,17.707,61,riffle_clumpy,win
2846,23,20,3,2,45,0.511,25,0.556,3,2,0.6,3,1,28,17,13,19,13,0.289,0.42200000000000004,0.289,17.719,63,riffle_clumpy,win
2847,26,18,8,2,46,0.565,28,0.609,2,3,0.4,6,2,32,14,11,7,28,0.239,0.152,0.609,17.692999999999998,64,riffle_clumpy,win
2848,26,14,12,3,43,0.605,29,0.674,6,3,0.667,2,0,18,25,16,12,15,0.37200000000000005,0.27899999999999997,0.349,17.689,65,riffle_clumpy,win
2849,23,19,4,3,45,0.511,26,0.578,2,1,0.667,2,0,26,19,13,14,18,0.289,0.311,0.4,17.691,66,riffle_clumpy,win
2856,22,20,2,3,45,0.489,25,0.556,1,2,0.33299999999999996,3,1,25,20,12,13,20,0.267,0.289,0.444,17.676,73,riffle_clumpy,win
2859,22,21,1,1,44,0.5,23,0.523,6,2,0.75,0,2,18,26,19,13,12,0.43200000000000005,0.295,0.273,17.665,76,riffle_clumpy,win
2863,27,19,8,0,46,0.5870000000000001,27,0.5870000000000001,4,3,0.5710000000000001,3,0,24,22,14,13,19,0.304,0.28300000000000003,0.413,17.663,80,riffle_clumpy,win
2864,22,21,1,3,46,0.478,25,0.5429999999999999,5,2,0.7140000000000001,2,2,28,18,16,11,19,0.348,0.239,0.413,17.669,81,riffle_clumpy,win
2869,24,20,4,1,45,0.5329999999999999,25,0.556,3,4,0.429,3,2,25,20,14,15,16,0.311,0.33299999999999996,0.35600000000000004,17.683,86,riffle_clumpy,win
2874,25,18,7,2,45,0.556,27,0.6,3,2,0.6,2,0,28,17,13,11,21,0.289,0.244,0.467,17.665,91,riffle_clumpy,win
2876,24,21,3,1,46,0.522,25,0.5429999999999999,2,3,0.4,1,3,31,15,16,9,21,0.348,0.196,0.457,17.653,93,riffle_clumpy,win
