Index,player_win,player_loss,push,total_hands,win_pct,win_push,win_push_pct,doubles_won,doubles_lost,doubles_won_pct,player_bj,dealer_bj,dealer_high_card,dealer_low_card,dealer_bust,dealer_draw,dealer_stand,dealer_bust_pct,dealer_draw_pct,dealer_stand_pct,dealer_avg_hand,num_of_shuffles,shuffle_method
0,18,22,6,46,0.391,24,0.522,2,3,0.4,1,3,30,16,8,17,21,0.174,0.37,0.457,17.621,1,python
0,19,23,2,44,0.432,21,0.477,2,2,0.5,2,2,26,18,15,11,18,0.341,0.25,0.409,17.731,2,python
0,29,14,4,47,0.617,33,0.702,3,2,0.6,3,2,25,22,20,10,17,0.426,0.213,0.362,17.27,3,python
0,14,28,4,46,0.304,18,0.391,3,1,0.75,1,4,29,17,9,18,19,0.196,0.391,0.413,17.363,4,python
0,24,16,5,45,0.533,29,0.644,4,2,0.667,3,3,27,18,13,15,17,0.289,0.333,0.378,17.45,5,python
0,18,22,3,43,0.419,21,0.488,4,2,0.667,2,0,28,15,8,13,22,0.186,0.302,0.512,17.369,6,python
0,24,20,4,48,0.5,28,0.583,7,3,0.7,4,0,25,23,12,14,22,0.25,0.292,0.458,17.298,7,python
0,23,15,5,43,0.535,28,0.651,2,0,1.0,3,1,33,10,11,12,20,0.256,0.279,0.465,17.232,8,python
0,18,25,2,45,0.4,20,0.444,3,2,0.6,1,4,33,12,7,15,23,0.156,0.333,0.511,17.351,9,python
0,21,23,4,48,0.438,25,0.521,0,1,0.0,2,4,33,15,13,13,22,0.271,0.271,0.458,17.346,10,python
0,17,22,7,46,0.37,24,0.522,3,2,0.6,2,5,27,19,12,14,20,0.261,0.304,0.435,17.441,11,python
0,22,23,2,47,0.468,24,0.511,4,2,0.667,2,4,25,22,13,14,20,0.277,0.298,0.426,17.465,12,python
0,20,22,3,45,0.444,23,0.511,2,3,0.4,3,2,31,14,12,9,24,0.267,0.2,0.533,17.443,13,python
0,23,21,2,46,0.5,25,0.543,1,3,0.25,2,2,29,17,9,14,23,0.196,0.304,0.5,17.487,14,python
0,26,18,2,46,0.565,28,0.609,2,0,1.0,0,3,25,21,13,16,17,0.283,0.348,0.37,17.479,15,python
0,21,25,2,48,0.438,23,0.479,2,1,0.667,0,1,31,17,12,12,24,0.25,0.25,0.5,17.498,16,python
0,17,24,3,44,0.386,20,0.455,1,1,0.5,1,1,27,17,10,14,20,0.227,0.318,0.455,17.513,17,python
0,23,21,2,46,0.5,25,0.543,1,3,0.25,1,3,26,20,11,20,15,0.239,0.435,0.326,17.509,18,python
0,26,16,3,45,0.578,29,0.644,5,1,0.833,1,0,27,18,15,12,18,0.333,0.267,0.4,17.506,19,python
0,19,23,2,44,0.432,21,0.477,2,2,0.5,2,2,29,15,11,14,19,0.25,0.318,0.432,17.482,20,python
0,14,24,6,44,0.318,20,0.455,0,2,0.0,2,3,31,13,7,16,21,0.159,0.364,0.477,17.489,21,python
0,20,22,4,46,0.435,24,0.522,5,3,0.625,2,3,27,19,9,14,23,0.196,0.304,0.5,17.514,22,python
0,17,23,4,44,0.386,21,0.477,3,2,0.6,1,1,25,19,9,15,20,0.205,0.341,0.455,17.539,23,python
0,24,20,4,48,0.5,28,0.583,5,1,0.833,2,3,24,24,13,15,20,0.271,0.312,0.417,17.52,24,python
0,22,21,7,50,0.44,29,0.58,4,4,0.5,3,1,39,11,9,14,27,0.18,0.28,0.54,17.532,25,python
0,22,23,1,46,0.478,23,0.5,5,5,0.5,1,4,29,17,13,12,21,0.283,0.261,0.457,17.529,26,python
0,16,25,4,45,0.356,20,0.444,4,7,0.364,3,1,28,17,9,19,17,0.2,0.422,0.378,17.514,27,python
0,18,26,3,47,0.383,21,0.447,1,3,0.25,1,3,27,20,14,13,20,0.298,0.277,0.426,17.516,28,python
0,16,19,9,44,0.364,25,0.568,4,1,0.8,3,0,26,18,8,12,24,0.182,0.273,0.545,17.517,29,python
0,19,23,2,44,0.432,21,0.477,3,0,1.0,2,3,26,18,11,14,19,0.25,0.318,0.432,17.535,30,python
0,23,20,3,46,0.5,26,0.565,3,0,1.0,1,2,33,13,11,9,26,0.239,0.196,0.565,17.512,31,python
0,22,22,4,48,0.458,26,0.542,5,2,0.714,2,3,27,21,10,16,22,0.208,0.333,0.458,17.515,32,python
0,16,23,5,44,0.364,21,0.477,2,1,0.667,2,2,19,25,9,18,17,0.205,0.409,0.386,17.519,33,python
0,21,20,4,45,0.467,25,0.556,3,1,0.75,2,3,28,17,8,16,21,0.178,0.356,0.467,17.532,34,python
0,20,23,4,47,0.426,24,0.511,5,3,0.625,3,3,28,19,11,15,21,0.234,0.319,0.447,17.536,35,python
0,26,16,2,44,0.591,28,0.636,3,4,0.429,1,3,31,13,16,9,19,0.364,0.205,0.432,17.538,36,python
0,20,24,5,49,0.408,25,0.51,2,5,0.286,6,3,24,25,14,16,19,0.286,0.327,0.388,17.56,37,python
0,22,22,2,46,0.478,24,0.522,6,5,0.545,4,0,31,15,11,11,24,0.239,0.239,0.522,17.559,38,python
0,22,18,4,44,0.5,26,0.591,5,1,0.833,3,0,24,20,11,15,18,0.25,0.341,0.409,17.56,39,python
0,22,17,6,45,0.489,28,0.622,1,1,0.5,1,2,29,16,10,16,19,0.222,0.356,0.422,17.572,40,python
0,18,23,5,46,0.391,23,0.5,4,1,0.8,2,2,27,19,10,19,17,0.217,0.413,0.37,17.587,41,python
0,20,21,5,46,0.435,25,0.543,2,2,0.5,0,3,31,15,12,14,20,0.261,0.304,0.435,17.595,42,python
0,15,21,8,44,0.341,23,0.523,2,2,0.5,0,3,29,15,8,18,18,0.182,0.409,0.409,17.62,43,python
0,22,22,4,48,0.458,26,0.542,7,2,0.778,1,7,27,21,14,15,19,0.292,0.312,0.396,17.63,44,python
0,15,27,5,47,0.319,20,0.426,4,5,0.444,3,4,30,17,6,17,24,0.128,0.362,0.511,17.649,45,python
0,16,24,5,45,0.356,21,0.467,0,5,0.0,3,2,28,17,9,16,20,0.2,0.356,0.444,17.659,46,python
0,13,28,4,45,0.289,17,0.378,1,6,0.143,1,1,30,15,5,17,23,0.111,0.378,0.511,17.664,47,python
0,21,23,4,48,0.438,25,0.521,3,5,0.375,4,2,30,18,9,19,20,0.188,0.396,0.417,17.663,48,python
0,23,20,4,47,0.489,27,0.574,2,1,0.667,1,1,24,23,14,17,16,0.298,0.362,0.34,17.673,49,python
0,27,15,4,46,0.587,31,0.674,5,3,0.625,0,1,29,17,17,13,16,0.37,0.283,0.348,17.661,50,python
0,27,16,5,48,0.562,32,0.667,3,2,0.6,6,1,25,23,14,12,22,0.292,0.25,0.458,17.659,51,python
0,24,24,2,50,0.48,26,0.52,4,4,0.5,2,1,32,18,12,15,23,0.24,0.3,0.46,17.661,52,python
0,18,25,5,48,0.375,23,0.479,2,3,0.4,0,6,27,21,11,16,21,0.229,0.333,0.438,17.678,53,python
0,22,14,9,45,0.489,31,0.689,6,0,1.0,2,1,31,14,12,11,22,0.267,0.244,0.489,17.674,54,python
0,22,22,0,44,0.5,22,0.5,3,3,0.5,2,1,29,15,10,15,19,0.227,0.341,0.432,17.669,55,python
0,23,17,4,44,0.523,27,0.614,6,2,0.75,2,2,26,18,11,12,21,0.25,0.273,0.477,17.669,56,python
0,22,19,4,45,0.489,26,0.578,3,1,0.75,3,2,26,19,14,11,20,0.311,0.244,0.444,17.671,57,python
0,16,28,4,48,0.333,20,0.417,0,5,0.0,3,2,24,24,9,20,19,0.188,0.417,0.396,17.668,58,python
0,18,23,2,43,0.419,20,0.465,0,2,0.0,1,2,27,16,10,17,16,0.233,0.395,0.372,17.679,59,python
0,21,23,1,45,0.467,22,0.489,3,1,0.75,4,2,30,15,8,12,25,0.178,0.267,0.556,17.668,60,python
0,15,23,6,44,0.341,21,0.477,3,2,0.6,3,2,29,15,8,10,26,0.182,0.227,0.591,17.65,61,python
0,20,24,3,47,0.426,23,0.489,3,2,0.6,4,4,28,19,11,11,25,0.234,0.234,0.532,17.647,62,python
0,23,19,4,46,0.5,27,0.587,6,3,0.667,3,1,26,20,17,9,20,0.37,0.196,0.435,17.648,63,python
0,19,23,4,46,0.413,23,0.5,5,1,0.833,3,1,32,14,9,14,23,0.196,0.304,0.5,17.648,64,python
0,20,21,2,43,0.465,22,0.512,5,3,0.625,2,1,24,19,12,10,21,0.279,0.233,0.488,17.648,65,python
0,22,20,4,46,0.478,26,0.565,3,1,0.75,3,2,27,19,11,13,22,0.239,0.283,0.478,17.655,66,python
0,17,26,1,44,0.386,18,0.409,4,2,0.667,1,2,27,17,10,15,19,0.227,0.341,0.432,17.66,67,python
0,20,18,4,42,0.476,24,0.571,4,0,1.0,0,3,28,14,15,10,17,0.357,0.238,0.405,17.665,68,python
0,24,15,6,45,0.533,30,0.667,3,2,0.6,1,2,31,14,12,10,23,0.267,0.222,0.511,17.669,69,python
0,21,21,2,44,0.477,23,0.523,2,2,0.5,2,1,30,14,9,15,20,0.205,0.341,0.455,17.677,70,python
0,19,24,1,44,0.432,20,0.455,4,1,0.8,4,2,28,16,6,12,26,0.136,0.273,0.591,17.675,71,python
0,21,18,7,46,0.457,28,0.609,3,1,0.75,5,3,29,17,9,13,24,0.196,0.283,0.522,17.673,72,python
0,20,23,2,45,0.444,22,0.489,4,1,0.8,2,2,28,17,10,12,23,0.222,0.267,0.511,17.667,73,python
0,20,20,7,47,0.426,27,0.574,1,1,0.5,3,1,29,18,7,22,18,0.149,0.468,0.383,17.67,74,python
0,19,19,8,46,0.413,27,0.587,5,3,0.625,1,0,28,18,7,17,22,0.152,0.37,0.478,17.669,75,python
0,23,19,3,45,0.511,26,0.578,1,4,0.2,5,1,18,27,11,18,16,0.244,0.4,0.356,17.668,76,python
0,20,19,6,45,0.444,26,0.578,1,3,0.25,5,3,28,17,12,12,21,0.267,0.267,0.467,17.664,77,python
0,18,26,3,47,0.383,21,0.447,0,2,0.0,5,3,30,17,6,14,27,0.128,0.298,0.574,17.653,78,python
0,23,20,2,45,0.511,25,0.556,4,0,1.0,3,4,31,14,10,13,22,0.222,0.289,0.489,17.648,79,python
0,19,25,3,47,0.404,22,0.468,3,4,0.429,1,1,28,19,10,15,22,0.213,0.319,0.468,17.66,80,python
0,20,22,5,47,0.426,25,0.532,3,3,0.5,3,0,27,20,12,16,19,0.255,0.34,0.404,17.658,81,python
0,24,15,6,45,0.533,30,0.667,6,2,0.75,3,1,31,14,8,11,26,0.178,0.244,0.578,17.65,82,python
0,21,20,3,44,0.477,24,0.545,0,2,0.0,2,4,23,21,13,12,19,0.295,0.273,0.432,17.647,83,python
0,24,18,3,45,0.533,27,0.6,3,2,0.6,2,3,30,15,10,18,17,0.222,0.4,0.378,17.647,84,python
0,23,17,5,45,0.511,28,0.622,0,1,0.0,1,0,26,19,11,20,14,0.244,0.444,0.311,17.653,85,python
0,23,18,2,43,0.535,25,0.581,4,3,0.571,0,3,27,16,11,12,20,0.256,0.279,0.465,17.654,86,python
0,17,23,5,45,0.378,22,0.489,3,0,1.0,3,5,26,19,10,13,22,0.222,0.289,0.489,17.645,87,python
0,16,25,4,45,0.356,20,0.444,4,2,0.667,1,1,24,21,10,19,16,0.222,0.422,0.356,17.651,88,python
0,23,18,4,45,0.511,27,0.6,4,3,0.571,2,2,25,20,13,12,20,0.289,0.267,0.444,17.652,89,python
0,24,17,4,45,0.533,28,0.622,5,3,0.625,4,2,26,19,14,11,20,0.311,0.244,0.444,17.656,90,python
0,24,17,4,45,0.533,28,0.622,4,2,0.667,7,0,27,18,13,12,20,0.289,0.267,0.444,17.654,91,python
0,20,19,4,43,0.465,24,0.558,1,3,0.25,2,1,24,19,11,18,14,0.256,0.419,0.326,17.658,92,python
0,22,19,2,43,0.512,24,0.558,3,2,0.6,1,0,31,12,9,14,20,0.209,0.326,0.465,17.651,93,python
0,19,21,5,45,0.422,24,0.533,4,3,0.571,1,2,29,16,12,15,18,0.267,0.333,0.4,17.66,94,python
0,25,15,3,43,0.581,28,0.651,3,2,0.6,3,1,29,14,13,10,20,0.302,0.233,0.465,17.652,95,python
0,22,23,1,46,0.478,23,0.5,3,2,0.6,1,3,25,21,13,18,15,0.283,0.391,0.326,17.654,96,python
0,16,27,4,47,0.34,20,0.426,2,5,0.286,1,1,33,14,10,17,20,0.213,0.362,0.426,17.771,1,python
0,24,18,5,47,0.511,29,0.617,3,1,0.75,3,3,28,19,10,12,25,0.213,0.255,0.532,17.524,2,python
0,20,26,4,50,0.4,24,0.48,2,2,0.5,1,3,32,18,11,15,24,0.22,0.3,0.48,17.659,3,python
0,18,25,2,45,0.4,20,0.444,1,0,1.0,3,1,31,14,9,20,16,0.2,0.444,0.356,17.513,4,python
0,20,19,6,45,0.444,26,0.578,1,2,0.333,1,1,31,14,10,14,21,0.222,0.311,0.467,17.638,5,python
0,16,22,7,45,0.356,23,0.511,3,1,0.75,3,4,35,10,10,10,25,0.222,0.222,0.556,17.707,6,python
0,19,24,2,45,0.422,21,0.467,0,1,0.0,2,2,25,20,9,17,19,0.2,0.378,0.422,17.683,7,python
0,20,23,1,44,0.455,21,0.477,3,3,0.5,3,1,22,22,10,17,17,0.227,0.386,0.386,17.622,8,python
0,27,16,3,46,0.587,30,0.652,6,0,1.0,6,3,26,20,12,13,21,0.261,0.283,0.457,17.489,9,python
0,26,19,2,47,0.553,28,0.596,2,2,0.5,2,2,23,24,13,17,17,0.277,0.362,0.362,17.51,10,python
0,22,17,4,43,0.512,26,0.605,3,4,0.429,1,4,29,14,11,14,18,0.256,0.326,0.419,17.578,11,python
0,22,19,3,44,0.5,25,0.568,1,2,0.333,3,2,27,17,7,16,21,0.159,0.364,0.477,17.631,12,python
0,18,24,2,44,0.409,20,0.455,2,0,1.0,3,3,27,17,10,13,21,0.227,0.295,0.477,17.621,13,python
0,21,21,4,46,0.457,25,0.543,7,3,0.7,1,2,24,22,9,20,17,0.196,0.435,0.37,17.678,14,python
0,23,19,3,45,0.511,26,0.578,3,2,0.6,5,2,28,17,12,12,21,0.267,0.267,0.467,17.673,15,python
0,20,24,4,48,0.417,24,0.5,0,2,0.0,3,2,27,21,12,16,20,0.25,0.333,0.417,17.674,16,python
0,24,19,2,45,0.533,26,0.578,3,6,0.333,2,3,23,22,14,15,16,0.311,0.333,0.356,17.65,17,python
0,15,20,7,42,0.357,22,0.524,4,2,0.667,1,0,22,20,11,15,16,0.262,0.357,0.381,17.677,18,python
0,18,28,3,49,0.367,21,0.429,7,0,1.0,1,2,28,21,10,17,22,0.204,0.347,0.449,17.667,19,python
0,27,15,3,45,0.6,30,0.667,4,3,0.571,3,0,26,19,16,12,17,0.356,0.267,0.378,17.667,20,python
0,19,26,3,48,0.396,22,0.458,4,4,0.5,3,3,30,18,5,17,26,0.104,0.354,0.542,17.669,21,python
0,28,10,7,45,0.622,35,0.778,4,0,1.0,2,1,27,18,18,11,16,0.4,0.244,0.356,17.695,22,python
0,26,18,3,47,0.553,29,0.617,3,2,0.6,4,1,26,21,14,16,17,0.298,0.34,0.362,17.685,23,python
0,20,23,6,49,0.408,26,0.531,2,4,0.333,5,2,29,20,5,20,24,0.102,0.408,0.49,17.679,24,python
0,25,22,2,49,0.51,27,0.551,5,0,1.0,3,4,29,20,14,14,21,0.286,0.286,0.429,17.666,25,python
0,21,24,4,49,0.429,25,0.51,4,2,0.667,2,4,34,15,9,14,26,0.184,0.286,0.531,17.642,26,python
0,19,24,4,47,0.404,23,0.489,1,1,0.5,3,3,34,13,9,17,21,0.191,0.362,0.447,17.646,27,python
0,22,20,2,44,0.5,24,0.545,2,1,0.667,4,1,25,19,13,11,20,0.295,0.25,0.455,17.62,28,python
0,18,24,5,47,0.383,23,0.489,1,6,0.143,2,0,26,21,9,18,20,0.191,0.383,0.426,17.621,29,python
0,26,13,5,44,0.591,31,0.705,5,1,0.833,2,1,25,19,16,10,18,0.364,0.227,0.409,17.61,30,python
0,20,20,5,45,0.444,25,0.556,3,2,0.6,3,0,28,17,10,15,20,0.222,0.333,0.444,17.616,31,python
0,14,26,3,43,0.326,17,0.395,5,0,1.0,2,2,27,16,8,15,20,0.186,0.349,0.465,17.598,32,python
0,21,22,1,44,0.477,22,0.5,5,4,0.556,4,2,29,15,11,7,26,0.25,0.159,0.591,17.609,33,python
0,18,22,6,46,0.391,24,0.522,2,3,0.4,3,5,28,18,9,15,22,0.196,0.326,0.478,17.606,34,python
0,17,22,5,44,0.386,22,0.5,2,3,0.4,0,2,35,9,9,12,23,0.205,0.273,0.523,17.63,35,python
0,20,21,4,45,0.444,24,0.533,5,1,0.833,1,2,23,22,9,18,18,0.2,0.4,0.4,17.632,36,python
0,22,22,3,47,0.468,25,0.532,4,0,1.0,2,2,30,17,13,13,21,0.277,0.277,0.447,17.602,37,python
0,18,23,2,43,0.419,20,0.465,1,2,0.333,0,4,27,16,14,11,18,0.326,0.256,0.419,17.606,38,python
0,14,29,3,46,0.304,17,0.37,2,1,0.667,0,3,27,19,11,14,21,0.239,0.304,0.457,17.616,39,python
0,23,14,8,45,0.511,31,0.689,1,3,0.25,1,0,25,20,13,16,16,0.289,0.356,0.356,17.631,40,python
0,21,22,3,46,0.457,24,0.522,5,2,0.714,1,2,25,21,12,15,19,0.261,0.326,0.413,17.626,41,python
0,19,24,1,44,0.432,20,0.455,3,3,0.5,3,2,31,13,11,9,24,0.25,0.205,0.545,17.624,42,python
0,23,20,2,45,0.511,25,0.556,6,2,0.75,3,3,23,22,14,10,21,0.311,0.222,0.467,17.62,43,python
0,17,27,1,45,0.378,18,0.4,1,1,0.5,1,3,28,17,8,16,21,0.178,0.356,0.467,17.635,44,python
0,24,18,7,49,0.49,31,0.633,3,4,0.429,5,1,28,21,13,10,26,0.265,0.204,0.531,17.615,45,python
0,18,20,6,44,0.409,24,0.545,3,1,0.75,2,1,32,12,8,13,23,0.182,0.295,0.523,17.616,46,python
0,16,24,6,46,0.348,22,0.478,5,2,0.714,1,3,29,17,8,18,20,0.174,0.391,0.435,17.625,47,python
0,12,29,3,44,0.273,15,0.341,2,1,0.667,1,5,30,14,7,14,23,0.159,0.318,0.523,17.623,48,python
0,20,20,6,46,0.435,26,0.565,3,1,0.75,5,1,24,22,9,17,20,0.196,0.37,0.435,17.616,49,python
0,21,22,3,46,0.457,24,0.522,3,5,0.375,1,2,29,17,9,20,17,0.196,0.435,0.37,17.618,50,python
0,17,24,4,45,0.378,21,0.467,2,4,0.333,3,3,25,20,9,14,22,0.2,0.311,0.489,17.62,51,python
0,22,20,4,46,0.478,26,0.565,4,0,1.0,2,5,31,15,10,12,24,0.217,0.261,0.522,17.599,52,python
0,16,25,2,43,0.372,18,0.419,1,1,0.5,1,3,28,15,8,16,19,0.186,0.372,0.442,17.608,53,python
0,19,26,4,49,0.388,23,0.469,3,3,0.5,1,2,26,23,14,12,23,0.286,0.245,0.469,17.611,54,python
0,19,20,7,46,0.413,26,0.565,4,2,0.667,3,4,25,21,14,11,21,0.304,0.239,0.457,17.612,55,python
0,20,22,4,46,0.435,24,0.522,5,1,0.833,2,0,26,20,9,17,20,0.196,0.37,0.435,17.623,56,python
0,18,18,8,44,0.409,26,0.591,4,2,0.667,3,4,28,16,8,16,20,0.182,0.364,0.455,17.626,57,python
0,21,21,3,45,0.467,24,0.533,5,3,0.625,4,0,25,20,9,14,22,0.2,0.311,0.489,17.63,58,python
0,26,15,3,44,0.591,29,0.659,7,0,1.0,0,3,26,18,17,11,16,0.386,0.25,0.364,17.638,59,python
0,16,26,2,44,0.364,18,0.409,1,2,0.333,1,3,33,11,7,13,24,0.159,0.295,0.545,17.64,60,python
0,20,22,4,46,0.435,24,0.522,3,2,0.6,3,4,31,15,10,10,26,0.217,0.217,0.565,17.637,61,python
0,22,19,2,43,0.512,24,0.558,4,2,0.667,1,1,25,18,12,12,19,0.279,0.279,0.442,17.644,62,python
0,13,25,8,46,0.283,21,0.457,2,4,0.333,2,4,30,16,7,11,28,0.152,0.239,0.609,17.642,63,python
0,18,19,7,44,0.409,25,0.568,3,1,0.75,1,1,25,19,13,12,19,0.295,0.273,0.432,17.636,64,python
0,20,24,2,46,0.435,22,0.478,1,1,0.5,0,1,29,17,13,13,20,0.283,0.283,0.435,17.642,65,python
0,21,22,1,44,0.477,22,0.5,3,3,0.5,2,2,28,16,9,15,20,0.205,0.341,0.455,17.643,66,python
0,19,23,7,49,0.388,26,0.531,3,1,0.75,1,4,30,19,12,16,21,0.245,0.327,0.429,17.647,67,python
0,19,25,1,45,0.422,20,0.444,3,2,0.6,3,1,26,19,8,17,20,0.178,0.378,0.444,17.647,68,python
0,21,19,7,47,0.447,28,0.596,6,1,0.857,2,1,27,20,16,10,21,0.34,0.213,0.447,17.643,69,python
0,15,23,5,43,0.349,20,0.465,1,1,0.5,2,0,23,20,10,13,20,0.233,0.302,0.465,17.642,70,python
0,24,22,2,48,0.5,26,0.542,5,2,0.714,4,4,31,17,9,15,24,0.188,0.312,0.5,17.637,71,python
0,22,24,1,47,0.468,23,0.489,4,1,0.8,1,2,25,22,13,13,21,0.277,0.277,0.447,17.639,72,python
0,13,25,5,43,0.302,18,0.419,1,5,0.167,1,3,30,13,9,9,25,0.209,0.209,0.581,17.645,73,python
0,20,17,5,42,0.476,25,0.595,2,1,0.667,1,1,23,19,15,11,16,0.357,0.262,0.381,17.646,74,python
0,16,26,3,45,0.356,19,0.422,4,4,0.5,2,2,26,19,8,17,20,0.178,0.378,0.444,17.645,75,python
0,18,27,2,47,0.383,20,0.426,4,2,0.667,1,4,30,17,10,13,24,0.213,0.277,0.511,17.646,76,python
0,21,21,2,44,0.477,23,0.523,3,3,0.5,2,3,21,23,14,12,18,0.318,0.273,0.409,17.649,77,python
0,21,21,4,46,0.457,25,0.543,5,2,0.714,3,2,25,21,9,19,18,0.196,0.413,0.391,17.653,78,python
0,14,29,6,49,0.286,20,0.408,3,1,0.75,1,4,28,21,7,20,22,0.143,0.408,0.449,17.649,79,python
0,20,25,2,47,0.426,22,0.468,2,2,0.5,4,3,29,18,10,11,26,0.213,0.234,0.553,17.65,80,python
0,19,24,4,47,0.404,23,0.489,2,1,0.667,2,7,30,17,11,10,26,0.234,0.213,0.553,17.648,81,python
0,24,20,2,46,0.522,26,0.565,4,3,0.571,4,2,23,23,12,11,23,0.261,0.239,0.5,17.647,82,python
0,17,21,9,47,0.362,26,0.553,2,1,0.667,0,3,33,14,8,15,24,0.17,0.319,0.511,17.646,83,python
0,24,19,6,49,0.49,30,0.612,1,1,0.5,4,2,27,22,7,18,24,0.143,0.367,0.49,17.641,84,python
0,21,21,3,45,0.467,24,0.533,2,4,0.333,3,2,26,19,11,14,20,0.244,0.311,0.444,17.645,85,python
0,16,22,7,45,0.356,23,0.511,4,6,0.4,1,2,29,16,11,14,20,0.244,0.311,0.444,17.648,86,python
0,19,25,1,45,0.422,20,0.444,5,1,0.833,2,3,24,21,7,22,16,0.156,0.489,0.356,17.645,87,python
0,22,23,2,47,0.468,24,0.511,3,0,1.0,0,3,27,20,11,14,22,0.234,0.298,0.468,17.65,88,python
0,23,22,1,46,0.5,24,0.522,3,2,0.6,2,1,34,12,9,15,22,0.196,0.326,0.478,17.65,89,python
0,17,24,6,47,0.362,23,0.489,2,6,0.25,3,1,31,16,11,11,25,0.234,0.234,0.532,17.65,90,python
0,23,20,2,45,0.511,25,0.556,6,3,0.667,3,3,22,23,8,17,20,0.178,0.378,0.444,17.654,91,python
0,16,25,4,45,0.356,20,0.444,2,3,0.4,2,3,26,19,10,13,22,0.222,0.289,0.489,17.651,92,python
0,18,22,6,46,0.391,24,0.522,2,1,0.667,3,5,29,17,11,10,25,0.239,0.217,0.543,17.654,93,python
0,22,21,2,45,0.489,24,0.533,2,1,0.667,5,1,24,21,12,14,19,0.267,0.311,0.422,17.647,94,python
0,19,22,4,45,0.422,23,0.511,7,3,0.7,3,5,27,18,13,12,20,0.289,0.267,0.444,17.648,95,python
0,19,24,3,46,0.413,22,0.478,3,0,1.0,1,2,29,17,9,15,22,0.196,0.326,0.478,17.645,96,python
0,19,20,5,44,0.432,24,0.545,5,1,0.833,2,1,26,18,13,13,18,0.295,0.295,0.409,18.0,1,python
0,16,22,7,45,0.356,23,0.511,2,1,0.667,3,2,31,14,7,11,27,0.156,0.244,0.6,17.714,2,python
0,20,22,2,44,0.455,22,0.5,4,3,0.571,2,2,29,15,10,13,21,0.227,0.295,0.477,17.839,3,python
0,18,16,9,43,0.419,27,0.628,2,1,0.667,2,2,28,15,6,18,19,0.14,0.419,0.442,17.992,4,python
0,19,23,4,46,0.413,23,0.5,2,2,0.5,0,2,25,21,11,14,21,0.239,0.304,0.457,18.019,5,python
0,16,29,2,47,0.34,18,0.383,2,0,1.0,3,5,31,16,8,11,28,0.17,0.234,0.596,17.923,6,python
0,20,24,3,47,0.426,23,0.489,3,4,0.429,1,2,26,21,10,17,20,0.213,0.362,0.426,17.972,7,python
0,16,23,7,46,0.348,23,0.5,4,1,0.8,2,5,30,16,9,12,25,0.196,0.261,0.543,17.967,8,python
0,19,23,3,45,0.422,22,0.489,2,4,0.333,5,3,30,15,9,14,22,0.2,0.311,0.489,17.891,9,python
0,22,19,3,44,0.5,25,0.568,3,2,0.6,2,2,28,16,11,15,18,0.25,0.341,0.409,17.861,10,python
0,22,17,7,46,0.478,29,0.63,3,1,0.75,2,0,25,21,12,17,17,0.261,0.37,0.37,17.89,11,python
0,17,25,3,45,0.378,20,0.444,5,4,0.556,1,2,28,17,10,19,16,0.222,0.422,0.356,17.867,12,python
0,20,20,8,48,0.417,28,0.583,4,4,0.5,4,1,30,18,8,18,22,0.167,0.375,0.458,17.852,13,python
0,18,21,6,45,0.4,24,0.533,4,3,0.571,2,3,31,14,5,15,25,0.111,0.333,0.556,17.783,14,python
0,12,31,2,45,0.267,14,0.311,2,6,0.25,1,2,24,21,7,19,19,0.156,0.422,0.422,17.82,15,python
0,19,23,3,45,0.422,22,0.489,5,2,0.714,1,4,28,17,11,12,22,0.244,0.267,0.489,17.873,16,python
0,14,25,5,44,0.318,19,0.432,2,1,0.667,2,1,31,13,7,16,21,0.159,0.364,0.477,17.891,17,python
0,23,20,2,45,0.511,25,0.556,1,4,0.2,4,3,26,19,13,13,19,0.289,0.289,0.422,17.847,18,python
0,18,24,3,45,0.4,21,0.467,3,4,0.429,3,0,29,16,7,16,22,0.156,0.356,0.489,17.83,19,python
0,16,28,2,46,0.348,18,0.391,1,3,0.25,3,4,28,18,6,12,28,0.13,0.261,0.609,17.802,20,python
0,24,23,3,50,0.48,27,0.54,3,5,0.375,2,4,25,25,17,10,23,0.34,0.2,0.46,17.795,21,python
0,18,22,3,43,0.419,21,0.488,2,1,0.667,1,4,27,16,14,10,19,0.326,0.233,0.442,17.797,22,python
0,11,29,4,44,0.25,15,0.341,3,0,1.0,2,1,31,13,5,13,26,0.114,0.295,0.591,17.77,23,python
0,24,20,1,45,0.533,25,0.556,5,2,0.714,0,1,28,17,15,9,21,0.333,0.2,0.467,17.749,24,python
0,15,26,5,46,0.326,20,0.435,2,4,0.333,2,3,29,17,4,20,22,0.087,0.435,0.478,17.758,25,python
0,21,21,7,49,0.429,28,0.571,4,4,0.5,6,2,31,18,7,11,31,0.143,0.224,0.633,17.765,26,python
0,22,18,3,43,0.512,25,0.581,6,2,0.75,1,1,25,18,15,9,19,0.349,0.209,0.442,17.759,27,python
0,21,25,0,46,0.457,21,0.457,3,3,0.5,3,4,28,18,8,13,25,0.174,0.283,0.543,17.726,28,python
0,23,18,5,46,0.5,28,0.609,5,3,0.625,4,2,25,21,13,15,18,0.283,0.326,0.391,17.726,29,python
0,20,19,4,43,0.465,24,0.558,6,1,0.857,1,1,29,14,12,10,21,0.279,0.233,0.488,17.742,30,python
0,16,27,4,47,0.34,20,0.426,1,3,0.25,0,3,32,15,9,13,25,0.191,0.277,0.532,17.727,31,python
0,22,17,5,44,0.5,27,0.614,3,2,0.6,4,0,30,14,9,10,25,0.205,0.227,0.568,17.719,32,python
0,19,18,4,41,0.463,23,0.561,5,2,0.714,0,2,26,15,16,9,16,0.39,0.22,0.39,17.73,33,python
0,22,19,3,44,0.5,25,0.568,7,2,0.778,1,2,30,14,10,12,22,0.227,0.273,0.5,17.74,34,python
0,16,24,6,46,0.348,22,0.478,3,1,0.75,3,5,27,19,8,15,23,0.174,0.326,0.5,17.739,35,python
0,26,16,4,46,0.565,30,0.652,5,1,0.833,3,1,24,22,17,11,18,0.37,0.239,0.391,17.717,36,python
0,23,18,4,45,0.511,27,0.6,1,2,0.333,2,1,28,17,12,18,15,0.267,0.4,0.333,17.722,37,python
0,20,20,6,46,0.435,26,0.565,2,2,0.5,2,3,26,20,10,15,21,0.217,0.326,0.457,17.727,38,python
0,15,27,4,46,0.326,19,0.413,3,0,1.0,3,3,31,15,10,14,22,0.217,0.304,0.478,17.727,39,python
0,17,23,5,45,0.378,22,0.489,1,2,0.333,3,3,27,18,10,17,18,0.222,0.378,0.4,17.721,40,python
0,14,28,2,44,0.318,16,0.364,1,1,0.5,0,3,27,17,8,20,16,0.182,0.455,0.364,17.736,41,python
0,25,15,3,43,0.581,28,0.651,10,1,0.909,0,2,22,21,18,12,13,0.419,0.279,0.302,17.75,42,python
0,23,18,5,46,0.5,28,0.609,4,1,0.8,1,1,28,18,8,16,22,0.174,0.348,0.478,17.754,43,python
0,18,20,5,43,0.419,23,0.535,4,1,0.8,1,2,25,18,14,10,19,0.326,0.233,0.442,17.739,44,python
0,21,21,4,46,0.457,25,0.543,0,4,0.0,3,1,28,18,10,16,20,0.217,0.348,0.435,17.74,45,python
0,21,18,7,46,0.457,28,0.609,2,3,0.4,2,1,28,18,12,15,19,0.261,0.326,0.413,17.756,46,python
0,20,22,2,44,0.455,22,0.5,1,5,0.167,3,0,27,17,9,13,22,0.205,0.295,0.5,17.745,47,python
0,18,27,2,47,0.383,20,0.426,2,2,0.5,3,2,31,16,8,15,24,0.17,0.319,0.511,17.742,48,python
0,23,20,4,47,0.489,27,0.574,5,1,0.833,2,0,19,28,12,22,13,0.255,0.468,0.277,17.742,49,python
0,18,26,2,46,0.391,20,0.435,3,5,0.375,4,4,28,18,9,15,22,0.196,0.326,0.478,17.743,50,python
0,16,23,4,43,0.372,20,0.465,1,2,0.333,1,1,26,17,9,15,19,0.209,0.349,0.442,17.74,51,python
0,18,18,8,44,0.409,26,0.591,2,4,0.333,2,1,28,16,7,14,23,0.159,0.318,0.523,17.736,52,python
0,16,23,6,45,0.356,22,0.489,1,3,0.25,3,1,29,16,7,14,24,0.156,0.311,0.533,17.738,53,python
0,25,19,3,47,0.532,28,0.596,5,1,0.833,1,1,23,24,18,12,17,0.383,0.255,0.362,17.744,54,python
0,17,21,6,44,0.386,23,0.523,3,6,0.333,0,1,31,13,13,12,19,0.295,0.273,0.432,17.739,55,python
0,19,24,1,44,0.432,20,0.455,2,2,0.5,2,2,24,20,12,11,21,0.273,0.25,0.477,17.724,56,python
0,19,23,4,46,0.413,23,0.5,4,2,0.667,1,4,31,15,11,15,20,0.239,0.326,0.435,17.716,57,python
0,21,23,3,47,0.447,24,0.511,3,0,1.0,0,3,27,20,9,22,16,0.191,0.468,0.34,17.713,58,python
0,20,25,1,46,0.435,21,0.457,4,1,0.8,4,2,27,19,7,14,25,0.152,0.304,0.543,17.71,59,python
0,17,23,4,44,0.386,21,0.477,1,2,0.333,1,2,26,18,13,10,21,0.295,0.227,0.477,17.713,60,python
0,21,24,3,48,0.438,24,0.5,3,5,0.375,4,3,29,19,10,13,25,0.208,0.271,0.521,17.724,61,python
0,24,17,4,45,0.533,28,0.622,4,3,0.571,0,1,25,20,11,16,18,0.244,0.356,0.4,17.722,62,python
0,19,23,2,44,0.432,21,0.477,7,0,1.0,1,2,27,17,9,14,21,0.205,0.318,0.477,17.726,63,python
0,19,22,3,44,0.432,22,0.5,2,1,0.667,2,3,26,18,10,12,22,0.227,0.273,0.5,17.724,64,python
0,22,21,1,44,0.5,23,0.523,3,3,0.5,3,2,24,20,12,15,17,0.273,0.341,0.386,17.725,65,python
0,15,25,5,45,0.333,20,0.444,3,0,1.0,3,2,31,14,5,18,22,0.111,0.4,0.489,17.718,66,python
0,23,21,0,44,0.523,23,0.523,6,2,0.75,6,0,25,19,11,14,19,0.25,0.318,0.432,17.705,67,python
0,18,21,3,42,0.429,21,0.5,4,2,0.667,1,1,22,20,12,14,16,0.286,0.333,0.381,17.705,68,python
0,18,26,3,47,0.383,21,0.447,2,1,0.667,1,6,29,18,10,14,23,0.213,0.298,0.489,17.715,69,python
0,19,24,1,44,0.432,20,0.455,3,0,1.0,2,2,31,13,9,12,23,0.205,0.273,0.523,17.698,70,python
0,12,24,8,44,0.273,20,0.455,2,1,0.667,0,1,25,19,5,18,21,0.114,0.409,0.477,17.701,71,python
0,17,24,4,45,0.378,21,0.467,4,4,0.5,1,3,27,18,10,16,19,0.222,0.356,0.422,17.706,72,python
0,23,21,3,47,0.489,26,0.553,1,2,0.333,3,1,25,22,11,16,20,0.234,0.34,0.426,17.706,73,python
0,18,20,7,45,0.4,25,0.556,4,1,0.8,2,4,30,15,9,14,22,0.2,0.311,0.489,17.71,74,python
0,23,23,0,46,0.5,23,0.5,2,1,0.667,5,2,26,20,10,15,21,0.217,0.326,0.457,17.689,75,python
0,20,25,3,48,0.417,23,0.479,6,2,0.75,1,1,26,22,12,17,19,0.25,0.354,0.396,17.694,76,python
0,20,20,2,42,0.476,22,0.524,2,0,1.0,0,0,22,20,16,11,15,0.381,0.262,0.357,17.706,77,python
0,17,25,4,46,0.37,21,0.457,2,2,0.5,2,1,32,14,8,12,26,0.174,0.261,0.565,17.7,78,python
0,24,18,1,43,0.558,25,0.581,5,3,0.625,1,2,22,21,12,17,14,0.279,0.395,0.326,17.707,79,python
0,18,22,5,45,0.4,23,0.511,3,1,0.75,0,2,28,17,10,15,20,0.222,0.333,0.444,17.706,80,python
0,22,23,4,49,0.449,26,0.531,2,1,0.667,2,2,30,19,11,18,20,0.224,0.367,0.408,17.707,81,python
0,24,21,2,47,0.511,26,0.553,7,2,0.778,1,1,32,15,7,16,24,0.149,0.34,0.511,17.709,82,python
0,27,17,1,45,0.6,28,0.622,0,1,0.0,6,0,28,17,14,12,19,0.311,0.267,0.422,17.7,83,python
0,21,22,3,46,0.457,24,0.522,1,2,0.333,4,1,27,19,8,17,21,0.174,0.37,0.457,17.696,84,python
0,13,22,10,45,0.289,23,0.511,2,1,0.667,2,2,33,12,7,18,20,0.156,0.4,0.444,17.706,85,python
0,18,24,5,47,0.383,23,0.489,0,3,0.0,1,1,28,19,13,16,18,0.277,0.34,0.383,17.707,86,python
0,24,19,0,43,0.558,24,0.558,2,1,0.667,0,3,31,12,13,12,18,0.302,0.279,0.419,17.709,87,python
0,19,18,8,45,0.422,27,0.6,2,1,0.667,3,2,26,19,9,18,18,0.2,0.4,0.4,17.704,88,python
0,14,25,5,44,0.318,19,0.432,3,3,0.5,1,0,29,15,6,19,19,0.136,0.432,0.432,17.713,89,python
0,21,22,1,44,0.477,22,0.5,4,3,0.571,2,3,22,22,12,16,16,0.273,0.364,0.364,17.71,90,python
0,18,24,5,47,0.383,23,0.489,7,2,0.778,2,2,29,18,9,17,21,0.191,0.362,0.447,17.708,91,python
0,20,25,2,47,0.426,22,0.468,2,4,0.333,3,2,28,19,9,12,26,0.191,0.255,0.553,17.706,92,python
0,22,17,5,44,0.5,27,0.614,2,1,0.667,1,1,26,18,15,13,16,0.341,0.295,0.364,17.709,93,python
0,15,25,5,45,0.333,20,0.444,1,2,0.333,1,1,26,19,7,18,20,0.156,0.4,0.444,17.713,94,python
0,21,20,4,45,0.467,25,0.556,1,2,0.333,2,2,36,9,6,13,26,0.133,0.289,0.578,17.707,95,python
0,14,24,6,44,0.318,20,0.455,0,1,0.0,1,1,24,20,10,12,22,0.227,0.273,0.5,17.703,96,python
0,25,17,2,44,0.568,27,0.614,5,5,0.5,1,1,28,16,12,13,19,0.273,0.295,0.432,17.633,1,python
0,18,25,2,45,0.4,20,0.444,5,2,0.714,2,4,28,17,10,16,19,0.222,0.356,0.422,17.831,2,python
0,17,26,4,47,0.362,21,0.447,1,1,0.5,1,1,28,19,7,20,20,0.149,0.426,0.426,17.967,3,python
0,21,20,4,45,0.467,25,0.556,4,0,1.0,0,2,23,22,15,14,16,0.333,0.311,0.356,18.0,4,python
0,18,20,7,45,0.4,25,0.556,5,2,0.714,1,1,29,16,7,22,16,0.156,0.489,0.356,17.993,5,python
0,19,20,6,45,0.422,25,0.556,2,3,0.4,2,1,32,13,11,16,18,0.244,0.356,0.4,17.923,6,python
0,23,19,2,44,0.523,25,0.568,2,3,0.4,0,0,27,17,16,15,13,0.364,0.341,0.295,17.952,7,python
0,18,25,2,45,0.4,20,0.444,4,5,0.444,3,2,27,18,10,15,20,0.222,0.333,0.444,17.975,8,python
0,18,23,4,45,0.4,22,0.489,2,2,0.5,1,1,28,17,9,15,21,0.2,0.333,0.467,17.929,9,python
0,18,20,8,46,0.391,26,0.565,5,2,0.714,1,2,25,21,11,17,18,0.239,0.37,0.391,17.902,10,python
0,19,21,6,46,0.413,25,0.543,5,2,0.714,4,1,26,20,10,15,21,0.217,0.326,0.457,17.893,11,python
0,23,19,4,46,0.5,27,0.587,5,2,0.714,2,4,25,21,11,12,23,0.239,0.261,0.5,17.826,12,python
0,20,21,3,44,0.455,23,0.523,6,3,0.667,2,5,28,16,11,12,21,0.25,0.273,0.477,17.843,13,python
0,21,20,3,44,0.477,24,0.545,2,1,0.667,2,1,23,21,8,17,19,0.182,0.386,0.432,17.818,14,python
0,20,17,6,43,0.465,26,0.605,4,2,0.667,1,1,28,15,9,13,21,0.209,0.302,0.488,17.766,15,python
0,18,26,1,45,0.4,19,0.422,1,2,0.333,0,2,25,20,10,16,19,0.222,0.356,0.422,17.733,16,python
0,21,24,2,47,0.447,23,0.489,2,2,0.5,3,1,31,16,7,13,27,0.149,0.277,0.574,17.782,17,python
0,16,23,3,42,0.381,19,0.452,3,3,0.5,1,0,20,22,13,12,17,0.31,0.286,0.405,17.763,18,python
0,18,21,4,43,0.419,22,0.512,5,6,0.455,0,0,24,19,6,16,21,0.14,0.372,0.488,17.768,19,python
0,21,18,6,45,0.467,27,0.6,6,5,0.545,4,0,27,18,11,13,21,0.244,0.289,0.467,17.75,20,python
0,18,19,8,45,0.4,26,0.578,5,1,0.833,1,2,23,22,15,15,15,0.333,0.333,0.333,17.774,21,python
0,19,25,1,45,0.422,20,0.444,3,7,0.3,2,6,26,19,11,13,21,0.244,0.289,0.467,17.769,22,python
0,20,20,4,44,0.455,24,0.545,3,2,0.6,3,3,23,21,11,15,18,0.25,0.341,0.409,17.755,23,python
0,20,20,8,48,0.417,28,0.583,4,2,0.667,4,1,22,26,11,17,20,0.229,0.354,0.417,17.744,24,python
0,25,18,2,45,0.556,27,0.6,2,3,0.4,3,1,26,19,15,11,19,0.333,0.244,0.422,17.73,25,python
0,21,18,5,44,0.477,26,0.591,4,3,0.571,2,0,31,13,12,9,23,0.273,0.205,0.523,17.713,26,python
0,20,25,3,48,0.417,23,0.479,2,1,0.667,4,4,25,23,10,12,26,0.208,0.25,0.542,17.676,27,python
0,19,20,8,47,0.404,27,0.574,2,4,0.333,4,0,22,25,11,16,20,0.234,0.34,0.426,17.678,28,python
0,22,19,2,43,0.512,24,0.558,3,0,1.0,3,1,27,16,11,15,17,0.256,0.349,0.395,17.674,29,python
0,21,19,5,45,0.467,26,0.578,1,2,0.333,3,2,27,18,15,12,18,0.333,0.267,0.4,17.644,30,python
0,16,22,8,46,0.348,24,0.522,2,4,0.333,1,2,24,22,9,20,17,0.196,0.435,0.37,17.644,31,python
0,25,17,6,48,0.521,31,0.646,5,3,0.625,3,1,24,24,17,18,13,0.354,0.375,0.271,17.671,32,python
0,15,23,8,46,0.326,23,0.5,3,2,0.6,1,2,29,17,6,19,21,0.13,0.413,0.457,17.692,33,python
0,24,24,2,50,0.48,26,0.52,2,1,0.667,4,5,36,14,10,12,28,0.2,0.24,0.56,17.696,34,python
0,27,13,3,43,0.628,30,0.698,2,1,0.667,2,1,27,16,11,12,20,0.256,0.279,0.465,17.692,35,python
0,17,23,5,45,0.378,22,0.489,2,1,0.667,3,0,31,14,6,20,19,0.133,0.444,0.422,17.685,36,python
0,21,19,4,44,0.477,25,0.568,3,3,0.5,2,4,24,20,13,11,20,0.295,0.25,0.455,17.66,37,python
0,22,21,3,46,0.478,25,0.543,2,2,0.5,3,1,34,12,8,14,24,0.174,0.304,0.522,17.66,38,python
0,23,17,5,45,0.511,28,0.622,2,2,0.5,2,1,27,18,11,12,22,0.244,0.267,0.489,17.66,39,python
0,17,25,6,48,0.354,23,0.479,2,5,0.286,3,3,28,20,4,21,23,0.083,0.438,0.479,17.667,40,python
0,25,17,3,45,0.556,28,0.622,4,1,0.8,4,2,25,20,11,12,22,0.244,0.267,0.489,17.652,41,python
0,25,17,3,45,0.556,28,0.622,7,2,0.778,2,2,26,19,15,12,18,0.333,0.267,0.4,17.649,42,python
0,21,24,3,48,0.438,24,0.5,3,5,0.375,3,2,27,21,10,19,19,0.208,0.396,0.396,17.66,43,python
0,22,21,4,47,0.468,26,0.553,3,5,0.375,1,3,30,17,14,16,17,0.298,0.34,0.362,17.672,44,python
0,23,18,4,45,0.511,27,0.6,3,1,0.75,2,1,25,20,14,14,17,0.311,0.311,0.378,17.676,45,python
0,23,23,0,46,0.5,23,0.5,4,4,0.5,5,0,25,21,10,19,17,0.217,0.413,0.37,17.686,46,python
0,16,27,2,45,0.356,18,0.4,1,3,0.25,1,3,29,16,6,18,21,0.133,0.4,0.467,17.683,47,python
0,21,19,5,45,0.467,26,0.578,3,2,0.6,3,1,28,17,9,15,21,0.2,0.333,0.467,17.679,48,python
0,23,18,4,45,0.511,27,0.6,4,2,0.667,2,2,24,21,14,12,19,0.311,0.267,0.422,17.691,49,python
0,20,21,4,45,0.444,24,0.533,4,1,0.8,0,6,33,12,10,13,22,0.222,0.289,0.489,17.703,50,python
0,20,24,4,48,0.417,24,0.5,3,3,0.5,1,1,29,19,16,11,21,0.333,0.229,0.438,17.701,51,python
0,22,21,3,46,0.478,25,0.543,6,2,0.75,2,0,31,15,12,16,18,0.261,0.348,0.391,17.693,52,python
0,26,22,1,49,0.531,27,0.551,2,0,1.0,2,3,23,26,13,16,20,0.265,0.327,0.408,17.683,53,python
0,22,20,4,46,0.478,26,0.565,4,1,0.8,2,1,24,22,10,17,19,0.217,0.37,0.413,17.675,54,python
0,23,20,3,46,0.5,26,0.565,5,1,0.833,3,2,26,20,13,10,23,0.283,0.217,0.5,17.662,55,python
0,20,23,3,46,0.435,23,0.5,4,4,0.5,1,2,26,20,13,14,19,0.283,0.304,0.413,17.657,56,python
0,20,26,4,50,0.4,24,0.48,5,3,0.625,2,3,32,18,13,14,23,0.26,0.28,0.46,17.654,57,python
0,20,22,4,46,0.435,24,0.522,1,0,1.0,2,2,33,13,10,10,26,0.217,0.217,0.565,17.657,58,python
0,26,16,2,44,0.591,28,0.636,4,1,0.8,1,1,30,14,11,13,20,0.25,0.295,0.455,17.652,59,python
0,17,24,6,47,0.362,23,0.489,0,2,0.0,3,2,32,15,9,17,21,0.191,0.362,0.447,17.643,60,python
0,14,27,4,45,0.311,18,0.4,1,2,0.333,1,6,31,14,9,10,26,0.2,0.222,0.578,17.63,61,python
0,21,20,4,45,0.467,25,0.556,4,0,1.0,0,3,29,16,12,14,19,0.267,0.311,0.422,17.634,62,python
0,22,27,2,51,0.431,24,0.471,1,5,0.167,1,0,28,23,13,15,23,0.255,0.294,0.451,17.627,63,python
0,22,20,2,44,0.5,24,0.545,2,2,0.5,2,1,21,23,13,15,16,0.295,0.341,0.364,17.626,64,python
0,22,17,6,45,0.489,28,0.622,2,0,1.0,2,1,25,20,9,16,20,0.2,0.356,0.444,17.624,65,python
0,18,23,2,43,0.419,20,0.465,5,0,1.0,1,3,28,15,9,16,18,0.209,0.372,0.419,17.631,66,python
0,21,24,1,46,0.457,22,0.478,0,2,0.0,2,2,26,20,10,12,24,0.217,0.261,0.522,17.63,67,python
0,17,26,4,47,0.362,21,0.447,3,3,0.5,2,1,31,16,10,18,19,0.213,0.383,0.404,17.628,68,python
0,17,25,2,44,0.386,19,0.432,1,4,0.2,1,1,31,13,11,11,22,0.25,0.25,0.5,17.61,69,python
0,16,29,4,49,0.327,20,0.408,4,4,0.5,2,2,36,13,8,16,25,0.163,0.327,0.51,17.614,70,python
0,20,21,7,48,0.417,27,0.562,4,4,0.5,1,2,30,18,9,17,22,0.188,0.354,0.458,17.628,71,python
0,20,25,4,49,0.408,24,0.49,6,0,1.0,1,1,28,21,13,15,21,0.265,0.306,0.429,17.636,72,python
0,21,17,6,44,0.477,27,0.614,4,1,0.8,2,1,28,16,17,8,19,0.386,0.182,0.432,17.637,73,python
0,18,23,5,46,0.391,23,0.5,5,1,0.833,1,2,29,17,10,15,21,0.217,0.326,0.457,17.646,74,python
0,24,20,1,45,0.533,25,0.556,1,0,1.0,2,5,36,9,9,12,24,0.2,0.267,0.533,17.639,75,python
0,21,21,5,47,0.447,26,0.553,1,0,1.0,3,1,28,19,13,18,16,0.277,0.383,0.34,17.63,76,python
0,18,25,2,45,0.4,20,0.444,3,3,0.5,1,2,31,14,8,15,22,0.178,0.333,0.489,17.636,77,python
0,16,27,4,47,0.34,20,0.426,2,2,0.5,4,2,27,20,7,21,19,0.149,0.447,0.404,17.638,78,python
0,19,21,4,44,0.432,23,0.523,4,0,1.0,2,2,28,16,8,17,19,0.182,0.386,0.432,17.633,79,python
0,24,18,3,45,0.533,27,0.6,5,1,0.833,2,0,25,20,12,13,20,0.267,0.289,0.444,17.633,80,python
0,11,28,7,46,0.239,18,0.391,1,5,0.167,0,3,32,14,5,15,26,0.109,0.326,0.565,17.635,81,python
0,10,31,4,45,0.222,14,0.311,2,2,0.5,1,4,29,16,5,13,27,0.111,0.289,0.6,17.641,82,python
0,16,21,7,44,0.364,23,0.523,1,1,0.5,1,4,34,10,10,9,25,0.227,0.205,0.568,17.643,83,python
0,20,24,1,45,0.444,21,0.467,3,3,0.5,3,2,30,15,11,11,23,0.244,0.244,0.511,17.637,84,python
0,24,16,5,45,0.533,29,0.644,6,2,0.75,4,1,27,18,15,13,17,0.333,0.289,0.378,17.639,85,python
0,19,25,3,47,0.404,22,0.468,4,1,0.8,3,2,36,11,9,12,26,0.191,0.255,0.553,17.641,86,python
0,17,26,2,45,0.378,19,0.422,3,1,0.75,2,3,30,15,9,13,23,0.2,0.289,0.511,17.638,87,python
0,26,18,3,47,0.553,29,0.617,5,2,0.714,2,2,22,25,19,13,15,0.404,0.277,0.319,17.645,88,python
0,21,23,1,45,0.467,22,0.489,3,4,0.429,5,1,24,21,10,13,22,0.222,0.289,0.489,17.632,89,python
0,17,24,3,44,0.386,20,0.455,4,3,0.571,2,2,28,16,8,14,22,0.182,0.318,0.5,17.636,90,python
0,19,22,3,44,0.432,22,0.5,7,3,0.7,2,1,22,22,11,19,14,0.25,0.432,0.318,17.645,91,python
0,24,15,4,43,0.558,28,0.651,2,3,0.4,1,2,21,22,15,16,12,0.349,0.372,0.279,17.645,92,python
0,23,23,3,49,0.469,26,0.531,3,3,0.5,2,3,28,21,14,12,23,0.286,0.245,0.469,17.646,93,python
0,14,27,5,46,0.304,19,0.413,2,6,0.25,1,4,35,11,8,11,27,0.174,0.239,0.587,17.653,94,python
0,17,22,5,44,0.386,22,0.5,2,3,0.4,1,1,31,13,11,13,20,0.25,0.295,0.455,17.648,95,python
0,20,23,3,46,0.435,23,0.5,2,2,0.5,2,4,27,19,11,14,21,0.239,0.304,0.457,17.657,96,python
0,16,28,3,47,0.34,19,0.404,5,1,0.833,4,1,32,15,7,17,23,0.149,0.362,0.489,17.879,1,python
0,19,20,4,43,0.442,23,0.535,3,2,0.6,0,3,28,15,11,11,21,0.256,0.256,0.488,17.867,2,python
0,17,26,3,46,0.37,20,0.435,3,4,0.429,5,1,31,15,9,17,20,0.196,0.37,0.435,17.703,3,python
0,23,27,1,51,0.451,24,0.471,5,4,0.556,4,3,25,26,16,15,20,0.314,0.294,0.392,17.438,4,python
0,27,20,0,47,0.574,27,0.574,1,1,0.5,3,2,27,20,15,13,19,0.319,0.277,0.404,17.306,5,python
0,25,19,3,47,0.532,28,0.596,4,1,0.8,2,1,26,21,11,14,22,0.234,0.298,0.468,17.356,6,python
0,24,18,5,47,0.511,29,0.617,0,1,0.0,4,0,20,27,14,18,15,0.298,0.383,0.319,17.384,7,python
0,19,20,6,45,0.422,25,0.556,5,2,0.714,1,2,29,16,15,7,23,0.333,0.156,0.511,17.43,8,python
0,20,23,2,45,0.444,22,0.489,2,4,0.333,4,3,28,17,10,16,19,0.222,0.356,0.422,17.494,9,python
0,16,26,3,45,0.356,19,0.422,4,2,0.667,2,2,27,18,10,15,20,0.222,0.333,0.444,17.478,10,python
0,21,19,4,44,0.477,25,0.568,7,1,0.875,2,2,23,21,10,18,16,0.227,0.409,0.364,17.498,11,python
0,15,25,4,44,0.341,19,0.432,6,4,0.6,0,1,28,16,13,13,18,0.295,0.295,0.409,17.557,12,python
0,18,22,5,45,0.4,23,0.511,1,2,0.333,4,6,27,18,8,13,24,0.178,0.289,0.533,17.495,13,python
0,18,24,5,47,0.383,23,0.489,3,3,0.5,2,3,28,19,7,18,22,0.149,0.383,0.468,17.464,14,python
0,21,23,1,45,0.467,22,0.489,5,1,0.833,2,5,26,19,13,12,20,0.289,0.267,0.444,17.467,15,python
0,14,27,3,44,0.318,17,0.386,2,1,0.667,1,1,33,11,5,13,26,0.114,0.295,0.591,17.45,16,python
0,24,16,4,44,0.545,28,0.636,5,5,0.5,3,2,23,21,16,12,16,0.364,0.273,0.364,17.476,17,python
0,19,19,4,42,0.452,23,0.548,4,2,0.667,0,2,28,14,16,9,17,0.381,0.214,0.405,17.522,18,python
0,24,19,1,44,0.545,25,0.568,4,4,0.5,4,0,24,20,9,16,19,0.205,0.364,0.432,17.514,19,python
0,26,16,3,45,0.578,29,0.644,5,2,0.714,1,0,31,14,14,8,23,0.311,0.178,0.511,17.531,20,python
0,24,15,6,45,0.533,30,0.667,6,1,0.857,2,1,23,22,14,15,16,0.311,0.333,0.356,17.549,21,python
0,23,20,6,49,0.469,29,0.592,6,5,0.545,2,3,26,23,11,14,24,0.224,0.286,0.49,17.55,22,python
0,25,17,5,47,0.532,30,0.638,6,1,0.857,4,2,23,24,18,11,18,0.383,0.234,0.383,17.556,23,python
0,27,17,3,47,0.574,30,0.638,3,3,0.5,2,2,32,15,17,10,20,0.362,0.213,0.426,17.553,24,python
0,15,28,5,48,0.312,20,0.417,4,1,0.8,2,3,31,17,10,13,25,0.208,0.271,0.521,17.57,25,python
0,27,15,3,45,0.6,30,0.667,3,2,0.6,0,1,24,21,21,9,15,0.467,0.2,0.333,17.577,26,python
0,16,24,5,45,0.356,21,0.467,2,2,0.5,1,3,26,19,7,17,21,0.156,0.378,0.467,17.582,27,python
0,13,31,3,47,0.277,16,0.34,1,9,0.1,1,2,27,20,6,19,22,0.128,0.404,0.468,17.569,28,python
0,18,24,5,47,0.383,23,0.489,3,3,0.5,1,5,32,15,6,15,26,0.128,0.319,0.553,17.591,29,python
0,20,22,4,46,0.435,24,0.522,4,2,0.667,1,1,32,14,10,18,18,0.217,0.391,0.391,17.598,30,python
0,18,24,4,46,0.391,22,0.478,5,4,0.556,3,3,24,22,10,14,22,0.217,0.304,0.478,17.588,31,python
0,18,22,6,46,0.391,24,0.522,0,3,0.0,3,1,26,20,10,15,21,0.217,0.326,0.457,17.575,32,python
0,19,21,5,45,0.422,24,0.533,4,4,0.5,1,2,31,14,10,17,18,0.222,0.378,0.4,17.592,33,python
0,27,17,4,48,0.562,31,0.646,1,4,0.2,4,2,25,23,13,14,21,0.271,0.292,0.438,17.58,34,python
0,15,27,4,46,0.326,19,0.413,1,3,0.25,1,3,26,20,9,16,21,0.196,0.348,0.457,17.566,35,python
0,23,21,5,49,0.469,28,0.571,6,1,0.857,4,2,30,19,10,17,22,0.204,0.347,0.449,17.566,36,python
0,15,25,2,42,0.357,17,0.405,1,1,0.5,2,3,30,12,10,9,23,0.238,0.214,0.548,17.564,37,python
0,19,19,6,44,0.432,25,0.568,2,5,0.286,2,1,33,11,10,16,18,0.227,0.364,0.409,17.578,38,python
0,22,24,2,48,0.458,24,0.5,3,2,0.6,3,5,34,14,11,13,24,0.229,0.271,0.5,17.56,39,python
0,19,21,3,43,0.442,22,0.512,5,1,0.833,1,1,30,13,7,14,22,0.163,0.326,0.512,17.554,40,python
0,16,25,4,45,0.356,20,0.444,4,2,0.667,1,1,28,17,7,13,25,0.156,0.289,0.556,17.545,41,python
0,22,22,3,47,0.468,25,0.532,7,1,0.875,0,7,32,15,11,13,23,0.234,0.277,0.489,17.551,42,python
0,25,16,3,44,0.568,28,0.636,1,2,0.333,4,1,26,18,12,15,17,0.273,0.341,0.386,17.546,43,python
0,23,21,2,46,0.5,25,0.543,4,1,0.8,3,3,26,20,13,10,23,0.283,0.217,0.5,17.532,44,python
0,19,23,4,46,0.413,23,0.5,3,0,1.0,0,4,29,17,9,12,25,0.196,0.261,0.543,17.53,45,python
0,20,21,3,44,0.455,23,0.523,3,3,0.5,1,2,24,20,13,14,17,0.295,0.318,0.386,17.533,46,python
0,19,24,3,46,0.413,22,0.478,2,3,0.4,3,2,29,17,9,21,16,0.196,0.457,0.348,17.537,47,python
0,17,27,3,47,0.362,20,0.426,0,2,0.0,4,1,28,19,11,13,23,0.234,0.277,0.489,17.531,48,python
0,20,24,3,47,0.426,23,0.489,3,1,0.75,4,4,32,15,10,10,27,0.213,0.213,0.574,17.52,49,python
0,23,19,3,45,0.511,26,0.578,2,1,0.667,2,1,25,20,15,14,16,0.333,0.311,0.356,17.528,50,python
0,25,17,2,44,0.568,27,0.614,4,2,0.667,3,1,22,22,16,11,17,0.364,0.25,0.386,17.524,51,python
0,22,22,5,49,0.449,27,0.551,2,2,0.5,2,4,30,19,12,12,25,0.245,0.245,0.51,17.524,52,python
0,19,24,2,45,0.422,21,0.467,0,3,0.0,2,1,29,16,7,21,17,0.156,0.467,0.378,17.521,53,python
0,16,22,5,43,0.372,21,0.488,2,3,0.4,0,4,32,11,13,11,19,0.302,0.256,0.442,17.526,54,python
0,21,23,3,47,0.447,24,0.511,4,2,0.667,2,1,25,22,13,17,17,0.277,0.362,0.362,17.532,55,python
0,20,21,4,45,0.444,24,0.533,4,4,0.5,0,1,24,21,14,14,17,0.311,0.311,0.378,17.54,56,python
0,24,21,3,48,0.5,27,0.562,5,2,0.714,4,3,32,16,15,12,21,0.312,0.25,0.438,17.554,57,python
0,21,26,2,49,0.429,23,0.469,2,3,0.4,5,5,28,21,8,15,26,0.163,0.306,0.531,17.551,58,python
0,21,20,6,47,0.447,27,0.574,2,1,0.667,5,1,26,21,11,17,19,0.234,0.362,0.404,17.548,59,python
0,20,23,3,46,0.435,23,0.5,2,1,0.667,1,1,29,17,9,18,19,0.196,0.391,0.413,17.541,60,python
0,25,19,2,46,0.543,27,0.587,1,3,0.25,4,3,32,14,15,6,25,0.326,0.13,0.543,17.527,61,python
0,20,22,6,48,0.417,26,0.542,5,5,0.5,0,1,28,20,14,16,18,0.292,0.333,0.375,17.542,62,python
0,22,18,3,43,0.512,25,0.581,1,1,0.5,1,1,27,16,14,15,14,0.326,0.349,0.326,17.545,63,python
0,22,20,3,45,0.489,25,0.556,0,2,0.0,4,2,29,16,11,16,18,0.244,0.356,0.4,17.546,64,python
0,18,25,3,46,0.391,21,0.457,2,0,1.0,1,2,22,24,9,20,17,0.196,0.435,0.37,17.548,65,python
0,21,18,5,44,0.477,26,0.591,0,1,0.0,1,1,21,23,11,18,15,0.25,0.409,0.341,17.561,66,python
0,14,24,9,47,0.298,23,0.489,1,4,0.2,3,2,27,20,6,23,18,0.128,0.489,0.383,17.56,67,python
0,14,28,4,46,0.304,18,0.391,0,4,0.0,3,3,34,12,5,17,24,0.109,0.37,0.522,17.579,68,python
0,18,25,3,46,0.391,21,0.457,3,4,0.429,2,1,26,20,7,16,23,0.152,0.348,0.5,17.579,69,python
0,17,26,3,46,0.37,20,0.435,1,2,0.333,3,3,34,12,6,16,24,0.13,0.348,0.522,17.593,70,python
0,19,21,3,43,0.442,22,0.512,4,2,0.667,2,0,22,21,12,13,18,0.279,0.302,0.419,17.598,71,python
0,21,23,2,46,0.457,23,0.5,2,1,0.667,1,2,25,21,15,14,17,0.326,0.304,0.37,17.597,72,python
0,23,22,3,48,0.479,26,0.542,5,3,0.625,0,2,33,15,16,12,20,0.333,0.25,0.417,17.589,73,python
0,19,22,5,46,0.413,24,0.522,6,1,0.857,2,1,28,18,8,16,22,0.174,0.348,0.478,17.592,74,python
0,11,27,8,46,0.239,19,0.413,0,5,0.0,1,4,32,14,4,17,25,0.087,0.37,0.543,17.605,75,python
0,25,18,3,46,0.543,28,0.609,5,3,0.625,2,3,31,15,10,14,22,0.217,0.304,0.478,17.606,76,python
0,31,20,2,53,0.585,33,0.623,6,3,0.667,2,1,32,21,18,11,24,0.34,0.208,0.453,17.614,77,python
0,20,24,0,44,0.455,20,0.455,2,1,0.667,3,2,25,19,10,15,19,0.227,0.341,0.432,17.611,78,python
0,17,22,8,47,0.362,25,0.532,2,2,0.5,4,4,26,21,5,18,24,0.106,0.383,0.511,17.606,79,python
0,22,23,2,47,0.468,24,0.511,3,2,0.6,4,0,30,17,10,18,19,0.213,0.383,0.404,17.61,80,python
0,15,26,5,46,0.326,20,0.435,3,3,0.5,2,4,27,19,10,17,19,0.217,0.37,0.413,17.605,81,python
0,20,24,3,47,0.426,23,0.489,3,2,0.6,1,3,32,15,11,13,23,0.234,0.277,0.489,17.609,82,python
0,23,17,4,44,0.523,27,0.614,5,0,1.0,1,1,26,18,17,13,14,0.386,0.295,0.318,17.608,83,python
0,25,15,5,45,0.556,30,0.667,2,2,0.5,0,3,29,16,15,12,18,0.333,0.267,0.4,17.614,84,python
0,19,23,1,43,0.442,20,0.465,6,1,0.857,1,1,28,15,12,10,21,0.279,0.233,0.488,17.614,85,python
0,21,21,3,45,0.467,24,0.533,4,1,0.8,2,1,26,19,11,17,17,0.244,0.378,0.378,17.617,86,python
0,15,27,4,46,0.326,19,0.413,2,6,0.25,3,7,27,19,5,17,24,0.109,0.37,0.522,17.622,87,python
0,22,20,7,49,0.449,29,0.592,6,3,0.667,1,3,29,20,14,11,24,0.286,0.224,0.49,17.622,88,python
0,23,20,2,45,0.511,25,0.556,7,0,1.0,3,1,24,21,9,18,18,0.2,0.4,0.4,17.634,89,python
0,18,23,7,48,0.375,25,0.521,4,2,0.667,2,2,31,17,10,12,26,0.208,0.25,0.542,17.632,90,python
0,14,25,6,45,0.311,20,0.444,2,2,0.5,1,2,27,18,7,12,26,0.156,0.267,0.578,17.641,91,python
0,20,24,1,45,0.444,21,0.467,2,5,0.286,2,2,31,14,8,14,23,0.178,0.311,0.511,17.637,92,python
0,22,17,7,46,0.478,29,0.63,1,0,1.0,2,0,19,27,13,21,12,0.283,0.457,0.261,17.633,93,python
0,28,13,5,46,0.609,33,0.717,8,1,0.889,3,1,29,17,15,10,21,0.326,0.217,0.457,17.632,94,python
0,27,19,1,47,0.574,28,0.596,1,0,1.0,7,4,26,21,14,14,19,0.298,0.298,0.404,17.632,95,python
0,29,16,3,48,0.604,32,0.667,7,2,0.778,1,3,33,15,20,8,20,0.417,0.167,0.417,17.635,96,python
0,30,19,5,54,0.556,35,0.648,3,1,0.75,3,1,28,26,20,19,15,0.37,0.352,0.278,17.458,1,python
0,17,25,4,46,0.37,21,0.457,2,3,0.4,2,2,26,20,10,14,22,0.217,0.304,0.478,17.464,2,python
0,15,24,6,45,0.333,21,0.467,2,2,0.5,3,1,27,18,9,17,19,0.2,0.378,0.422,17.299,3,python
0,19,22,6,47,0.404,25,0.532,1,4,0.2,2,3,26,21,9,18,20,0.191,0.383,0.426,17.397,4,python
0,21,21,2,44,0.477,23,0.523,4,1,0.8,5,3,30,14,10,11,23,0.227,0.25,0.523,17.34,5,python
0,16,25,5,46,0.348,21,0.457,2,3,0.4,3,2,23,23,11,16,19,0.239,0.348,0.413,17.432,6,python
0,22,19,3,44,0.5,25,0.568,5,2,0.714,1,4,30,14,11,11,22,0.25,0.25,0.5,17.574,7,python
0,22,20,4,46,0.478,26,0.565,3,0,1.0,1,1,30,16,11,16,19,0.239,0.348,0.413,17.671,8,python
0,20,23,2,45,0.444,22,0.489,5,4,0.556,2,3,27,18,7,13,25,0.156,0.289,0.556,17.549,9,python
0,25,16,3,44,0.568,28,0.636,3,2,0.6,3,0,25,19,8,15,21,0.182,0.341,0.477,17.562,10,python
0,14,27,3,44,0.318,17,0.386,2,1,0.667,3,0,30,14,8,10,26,0.182,0.227,0.591,17.562,11,python
0,15,30,3,48,0.312,18,0.375,2,2,0.5,0,3,30,18,5,21,22,0.104,0.438,0.458,17.638,12,python
0,26,19,2,47,0.553,28,0.596,2,3,0.4,2,1,27,20,13,15,19,0.277,0.319,0.404,17.587,13,python
0,19,23,6,48,0.396,25,0.521,5,4,0.556,1,2,25,23,13,16,19,0.271,0.333,0.396,17.59,14,python
0,22,22,2,46,0.478,24,0.522,2,2,0.5,2,3,26,20,12,14,20,0.261,0.304,0.435,17.586,15,python
0,24,23,1,48,0.5,25,0.521,3,1,0.75,1,1,23,25,12,20,16,0.25,0.417,0.333,17.609,16,python
0,19,25,2,46,0.413,21,0.457,2,6,0.25,4,1,28,18,8,18,20,0.174,0.391,0.435,17.616,17,python
0,17,24,6,47,0.362,23,0.489,4,5,0.444,1,3,31,16,11,17,19,0.234,0.362,0.404,17.623,18,python
0,19,22,4,45,0.422,23,0.511,2,1,0.667,1,6,32,13,10,14,21,0.222,0.311,0.467,17.653,19,python
0,18,22,7,47,0.383,25,0.532,1,2,0.333,2,3,32,15,9,14,24,0.191,0.298,0.511,17.655,20,python
0,15,27,5,47,0.319,20,0.426,2,5,0.286,3,3,29,18,7,12,28,0.149,0.255,0.596,17.623,21,python
0,19,22,4,45,0.422,23,0.511,4,1,0.8,1,2,31,14,11,8,26,0.244,0.178,0.578,17.627,22,python
0,20,21,4,45,0.444,24,0.533,4,0,1.0,2,2,30,15,10,14,21,0.222,0.311,0.467,17.638,23,python
0,20,19,4,43,0.465,24,0.558,4,3,0.571,2,3,28,15,12,14,17,0.279,0.326,0.395,17.628,24,python
0,26,18,1,45,0.578,27,0.6,5,1,0.833,2,2,28,17,11,16,18,0.244,0.356,0.4,17.629,25,python
0,19,23,3,45,0.422,22,0.489,3,2,0.6,1,1,30,15,13,11,21,0.289,0.244,0.467,17.615,26,python
0,21,23,2,46,0.457,23,0.5,5,5,0.5,4,3,31,15,11,16,19,0.239,0.348,0.413,17.605,27,python
0,21,24,1,46,0.457,22,0.478,1,4,0.2,5,2,32,14,9,10,27,0.196,0.217,0.587,17.577,28,python
0,18,24,2,44,0.409,20,0.455,2,2,0.5,2,2,31,13,9,12,23,0.205,0.273,0.523,17.558,29,python
0,19,21,6,46,0.413,25,0.543,4,3,0.571,0,1,27,19,15,17,14,0.326,0.37,0.304,17.573,30,python
0,26,17,1,44,0.591,27,0.614,5,2,0.714,3,1,25,19,12,13,19,0.273,0.295,0.432,17.583,31,python
0,19,25,5,49,0.388,24,0.49,2,4,0.333,1,2,30,19,14,19,16,0.286,0.388,0.327,17.597,32,python
0,22,18,5,45,0.489,27,0.6,4,1,0.8,1,1,27,18,12,13,20,0.267,0.289,0.444,17.604,33,python
0,20,21,4,45,0.444,24,0.533,3,1,0.75,2,2,34,11,10,7,28,0.222,0.156,0.622,17.619,34,python
0,18,25,3,46,0.391,21,0.457,1,1,0.5,4,1,26,20,10,14,22,0.217,0.304,0.478,17.61,35,python
0,22,22,3,47,0.468,25,0.532,4,1,0.8,2,1,31,16,10,7,30,0.213,0.149,0.638,17.612,36,python
0,16,30,1,47,0.34,17,0.362,1,1,0.5,1,3,31,16,9,15,23,0.191,0.319,0.489,17.61,37,python
0,24,20,0,44,0.545,24,0.545,3,0,1.0,1,4,26,18,12,13,19,0.273,0.295,0.432,17.6,38,python
0,16,27,5,48,0.333,21,0.438,3,2,0.6,4,4,27,21,7,19,22,0.146,0.396,0.458,17.578,39,python
0,22,20,6,48,0.458,28,0.583,7,3,0.7,3,0,31,17,9,17,22,0.188,0.354,0.458,17.572,40,python
0,20,21,8,49,0.408,28,0.571,2,2,0.5,4,3,35,14,10,14,25,0.204,0.286,0.51,17.58,41,python
0,21,20,2,43,0.488,23,0.535,1,4,0.2,1,0,22,21,10,18,15,0.233,0.419,0.349,17.592,42,python
0,23,21,3,47,0.489,26,0.553,3,3,0.5,2,5,28,19,16,14,17,0.34,0.298,0.362,17.61,43,python
0,22,23,1,46,0.478,23,0.5,2,2,0.5,6,2,29,17,10,16,20,0.217,0.348,0.435,17.577,44,python
0,19,25,2,46,0.413,21,0.457,5,2,0.714,1,2,34,12,9,13,24,0.196,0.283,0.522,17.584,45,python
0,21,24,3,48,0.438,24,0.5,5,3,0.625,5,1,24,24,8,17,23,0.167,0.354,0.479,17.59,46,python
0,25,19,2,46,0.543,27,0.587,3,4,0.429,4,2,28,18,14,13,19,0.304,0.283,0.413,17.577,47,python
0,13,29,4,46,0.283,17,0.37,5,1,0.833,0,4,27,19,8,12,26,0.174,0.261,0.565,17.57,48,python
0,18,22,4,44,0.409,22,0.5,4,3,0.571,0,3,27,17,9,14,21,0.205,0.318,0.477,17.579,49,python
0,19,22,2,43,0.442,21,0.488,5,4,0.556,0,0,27,16,10,14,19,0.233,0.326,0.442,17.567,50,python
0,21,20,2,43,0.488,23,0.535,4,3,0.571,2,2,30,13,12,12,19,0.279,0.279,0.442,17.572,51,python
0,22,22,3,47,0.468,25,0.532,2,1,0.667,2,3,27,20,17,13,17,0.362,0.277,0.362,17.583,52,python
0,22,16,6,44,0.5,28,0.636,3,1,0.75,4,1,21,23,13,14,17,0.295,0.318,0.386,17.584,53,python
0,22,18,5,45,0.489,27,0.6,6,2,0.75,1,3,37,8,8,13,24,0.178,0.289,0.533,17.583,54,python
0,21,20,4,45,0.467,25,0.556,3,0,1.0,2,1,27,18,6,17,22,0.133,0.378,0.489,17.59,55,python
0,19,19,5,43,0.442,24,0.558,3,2,0.6,5,0,28,15,11,12,20,0.256,0.279,0.465,17.588,56,python
0,22,21,3,46,0.478,25,0.543,1,2,0.333,3,1,29,17,11,15,20,0.239,0.326,0.435,17.587,57,python
0,17,27,1,45,0.378,18,0.4,2,2,0.5,1,3,26,19,12,13,20,0.267,0.289,0.444,17.588,58,python
0,24,17,4,45,0.533,28,0.622,2,3,0.4,5,1,28,17,10,16,19,0.222,0.356,0.422,17.586,59,python
0,22,19,3,44,0.5,25,0.568,3,0,1.0,2,1,29,15,11,14,19,0.25,0.318,0.432,17.588,60,python
0,19,23,4,46,0.413,23,0.5,4,5,0.444,2,4,28,18,7,15,24,0.152,0.326,0.522,17.594,61,python
0,13,25,6,44,0.295,19,0.432,0,1,0.0,3,2,26,18,8,16,20,0.182,0.364,0.455,17.594,62,python
0,23,20,3,46,0.5,26,0.565,3,2,0.6,2,1,26,20,14,10,22,0.304,0.217,0.478,17.584,63,python
0,22,18,4,44,0.5,26,0.591,2,0,1.0,3,3,27,17,12,15,17,0.273,0.341,0.386,17.589,64,python
0,16,29,1,46,0.348,17,0.37,1,2,0.333,3,3,25,21,10,15,21,0.217,0.326,0.457,17.578,65,python
0,25,15,4,44,0.568,29,0.659,3,1,0.75,4,1,30,14,11,12,21,0.25,0.273,0.477,17.576,66,python
0,16,24,3,43,0.372,19,0.442,2,2,0.5,1,2,25,18,8,13,22,0.186,0.302,0.512,17.581,67,python
0,24,19,2,45,0.533,26,0.578,5,0,1.0,5,1,28,17,13,14,18,0.289,0.311,0.4,17.576,68,python
0,14,25,6,45,0.311,20,0.444,2,4,0.333,1,2,24,21,8,18,19,0.178,0.4,0.422,17.58,69,python
0,22,12,10,44,0.5,32,0.727,4,3,0.571,3,1,24,20,14,11,19,0.318,0.25,0.432,17.577,70,python
0,16,24,5,45,0.356,21,0.467,5,0,1.0,1,5,28,17,11,13,21,0.244,0.289,0.467,17.584,71,python
0,19,21,5,45,0.422,24,0.533,2,3,0.4,4,0,30,15,9,18,18,0.2,0.4,0.4,17.571,72,python
0,18,23,6,47,0.383,24,0.511,2,1,0.667,2,3,32,15,9,12,26,0.191,0.255,0.553,17.573,73,python
0,19,22,3,44,0.432,22,0.5,4,1,0.8,0,1,26,18,11,14,19,0.25,0.318,0.432,17.583,74,python
0,21,18,5,44,0.477,26,0.591,4,1,0.8,2,2,25,19,10,19,15,0.227,0.432,0.341,17.587,75,python
0,25,16,2,43,0.581,27,0.628,1,2,0.333,3,0,24,19,14,13,16,0.326,0.302,0.372,17.578,76,python
0,16,27,1,44,0.364,17,0.386,1,3,0.25,2,3,33,11,8,14,22,0.182,0.318,0.5,17.574,77,python
0,27,14,2,43,0.628,29,0.674,5,2,0.714,0,1,26,17,18,10,15,0.419,0.233,0.349,17.58,78,python
0,21,20,3,44,0.477,24,0.545,4,4,0.5,2,1,30,14,11,12,21,0.25,0.273,0.477,17.581,79,python
0,22,22,0,44,0.5,22,0.5,3,1,0.75,3,2,27,17,12,12,20,0.273,0.273,0.455,17.565,80,python
0,22,20,5,47,0.468,27,0.574,3,3,0.5,4,0,29,18,9,17,21,0.191,0.362,0.447,17.567,81,python
0,19,23,4,46,0.413,23,0.5,2,1,0.667,1,3,29,17,10,15,21,0.217,0.326,0.457,17.575,82,python
0,17,20,8,45,0.378,25,0.556,2,1,0.667,1,2,29,16,10,15,20,0.222,0.333,0.444,17.58,83,python
0,20,23,4,47,0.426,24,0.511,2,3,0.4,2,3,33,14,7,15,25,0.149,0.319,0.532,17.584,84,python
0,28,12,5,45,0.622,33,0.733,0,1,0.0,7,1,30,15,11,16,18,0.244,0.356,0.4,17.59,85,python
0,17,21,7,45,0.378,24,0.533,3,1,0.75,2,3,25,20,9,19,17,0.2,0.422,0.378,17.595,86,python
0,18,24,3,45,0.4,21,0.467,5,4,0.556,1,2,27,18,9,18,18,0.2,0.4,0.4,17.598,87,python
0,17,27,3,47,0.362,20,0.426,4,1,0.8,0,5,31,16,12,10,25,0.255,0.213,0.532,17.601,88,python
0,17,26,2,45,0.378,19,0.422,1,3,0.25,2,3,29,16,8,17,20,0.178,0.378,0.444,17.605,89,python
0,17,25,4,46,0.37,21,0.457,3,2,0.6,3,3,30,16,10,13,23,0.217,0.283,0.5,17.601,90,python
0,18,24,1,43,0.419,19,0.442,4,1,0.8,2,1,31,12,5,15,23,0.116,0.349,0.535,17.598,91,python
0,20,20,4,44,0.455,24,0.545,3,2,0.6,2,4,21,23,11,18,15,0.25,0.409,0.341,17.597,92,python
0,16,24,5,45,0.356,21,0.467,2,4,0.333,2,3,30,15,9,19,17,0.2,0.422,0.378,17.613,93,python
0,21,20,8,49,0.429,29,0.592,2,1,0.667,3,2,22,27,12,15,22,0.245,0.306,0.449,17.618,94,python
0,21,20,4,45,0.467,25,0.556,1,1,0.5,2,4,31,14,9,11,25,0.2,0.244,0.556,17.626,95,python
0,19,23,5,47,0.404,24,0.511,5,1,0.833,4,3,23,24,9,18,20,0.191,0.383,0.426,17.628,96,python
0,16,25,5,46,0.348,21,0.457,3,2,0.6,1,6,29,17,9,13,24,0.196,0.283,0.522,17.179,1,python
0,22,23,1,46,0.478,23,0.5,3,4,0.429,2,2,28,18,14,13,19,0.304,0.283,0.413,17.296,2,python
0,17,23,4,44,0.386,21,0.477,5,1,0.833,2,4,29,15,10,12,22,0.227,0.273,0.5,17.561,3,python
0,21,20,5,46,0.457,26,0.565,3,2,0.6,1,4,25,21,15,14,17,0.326,0.304,0.37,17.558,4,python
0,22,18,3,43,0.512,25,0.581,5,1,0.833,0,2,29,14,12,15,16,0.279,0.349,0.372,17.733,5,python
0,18,22,6,46,0.391,24,0.522,2,1,0.667,2,3,30,16,4,16,26,0.087,0.348,0.565,17.738,6,python
0,21,21,3,45,0.467,24,0.533,2,3,0.4,3,0,30,15,11,9,25,0.244,0.2,0.556,17.688,7,python
0,26,17,4,47,0.553,30,0.638,6,0,1.0,4,4,31,16,12,12,23,0.255,0.255,0.489,17.567,8,python
0,16,29,3,48,0.333,19,0.396,2,2,0.5,4,4,33,15,7,11,30,0.146,0.229,0.625,17.592,9,python
0,19,21,8,48,0.396,27,0.562,1,1,0.5,0,2,31,17,11,18,19,0.229,0.375,0.396,17.639,10,python
0,25,16,3,44,0.568,28,0.636,3,3,0.5,3,0,33,11,14,12,18,0.318,0.273,0.409,17.651,11,python
0,19,22,4,45,0.422,23,0.511,1,4,0.2,6,0,30,15,9,13,23,0.2,0.289,0.511,17.624,12,python
0,21,22,3,46,0.457,24,0.522,3,2,0.6,1,2,24,22,11,15,20,0.239,0.326,0.435,17.615,13,python
0,23,22,2,47,0.489,25,0.532,2,0,1.0,1,1,28,19,15,20,12,0.319,0.426,0.255,17.664,14,python
0,19,22,5,46,0.413,24,0.522,6,4,0.6,0,1,27,19,11,14,21,0.239,0.304,0.457,17.671,15,python
0,13,23,9,45,0.289,22,0.489,1,6,0.143,3,2,28,17,4,19,22,0.089,0.422,0.489,17.715,16,python
0,27,20,2,49,0.551,29,0.592,3,2,0.6,4,2,29,20,13,17,19,0.265,0.347,0.388,17.657,17,python
0,18,22,4,44,0.409,22,0.5,1,1,0.5,2,3,28,16,10,12,22,0.227,0.273,0.5,17.632,18,python
0,24,18,3,45,0.533,27,0.6,0,0,0,2,1,25,20,16,13,16,0.356,0.289,0.356,17.633,19,python
0,18,23,3,44,0.409,21,0.477,2,2,0.5,2,2,23,21,9,16,19,0.205,0.364,0.432,17.651,20,python
0,26,16,2,44,0.591,28,0.636,3,1,0.75,2,1,32,12,12,10,22,0.273,0.227,0.5,17.664,21,python
0,22,22,1,45,0.489,23,0.511,7,5,0.583,3,1,27,18,15,11,19,0.333,0.244,0.422,17.667,22,python
0,18,27,1,46,0.391,19,0.413,1,3,0.25,2,4,34,12,11,10,25,0.239,0.217,0.543,17.624,23,python
0,23,20,1,44,0.523,24,0.545,9,3,0.75,4,0,28,16,12,10,22,0.273,0.227,0.5,17.634,24,python
0,23,20,3,46,0.5,26,0.565,5,1,0.833,1,2,27,19,9,12,25,0.196,0.261,0.543,17.627,25,python
0,17,24,6,47,0.362,23,0.489,4,0,1.0,1,1,25,22,10,16,21,0.213,0.34,0.447,17.649,26,python
0,24,19,2,45,0.533,26,0.578,2,1,0.667,4,0,26,19,13,18,14,0.289,0.4,0.311,17.66,27,python
0,17,24,3,44,0.386,20,0.455,4,5,0.444,1,2,23,21,11,17,16,0.25,0.386,0.364,17.677,28,python
0,19,27,0,46,0.413,19,0.413,3,0,1.0,1,2,28,18,6,19,21,0.13,0.413,0.457,17.663,29,python
0,22,24,0,46,0.478,22,0.478,4,1,0.8,2,3,26,20,14,13,19,0.304,0.283,0.413,17.677,30,python
0,19,22,7,48,0.396,26,0.542,5,0,1.0,2,4,31,17,14,16,18,0.292,0.333,0.375,17.667,31,python
0,16,27,3,46,0.348,19,0.413,3,1,0.75,3,3,32,14,4,13,29,0.087,0.283,0.63,17.629,32,python
0,22,21,2,45,0.489,24,0.533,4,2,0.667,4,1,31,14,11,13,21,0.244,0.289,0.467,17.618,33,python
0,23,19,2,44,0.523,25,0.568,4,3,0.571,2,1,18,26,13,17,14,0.295,0.386,0.318,17.61,34,python
0,15,25,4,44,0.341,19,0.432,5,0,1.0,0,2,32,12,8,10,26,0.182,0.227,0.591,17.616,35,python
0,19,23,3,45,0.422,22,0.489,1,2,0.333,2,3,28,17,12,15,18,0.267,0.333,0.4,17.63,36,python
0,17,23,5,45,0.378,22,0.489,3,3,0.5,4,3,30,15,9,14,22,0.2,0.311,0.489,17.628,37,python
0,21,19,4,44,0.477,25,0.568,2,1,0.667,2,1,21,23,11,16,17,0.25,0.364,0.386,17.64,38,python
0,23,21,3,47,0.489,26,0.553,3,1,0.75,2,4,28,19,13,14,20,0.277,0.298,0.426,17.642,39,python
0,22,19,3,44,0.5,25,0.568,5,0,1.0,1,4,28,16,15,12,17,0.341,0.273,0.386,17.656,40,python
0,19,23,4,46,0.413,23,0.5,0,3,0.0,2,3,27,19,9,17,20,0.196,0.37,0.435,17.674,41,python
0,22,20,4,46,0.478,26,0.565,2,1,0.667,3,0,25,21,16,12,18,0.348,0.261,0.391,17.662,42,python
0,21,18,4,43,0.488,25,0.581,3,0,1.0,1,1,26,17,11,15,17,0.256,0.349,0.395,17.664,43,python
0,15,28,7,50,0.3,22,0.44,3,2,0.6,4,4,32,18,10,19,21,0.2,0.38,0.42,17.67,44,python
0,22,24,1,47,0.468,23,0.489,2,5,0.286,2,1,28,19,7,13,27,0.149,0.277,0.574,17.662,45,python
0,14,27,4,45,0.311,18,0.4,2,4,0.333,1,2,28,17,8,16,21,0.178,0.356,0.467,17.671,46,python
0,21,20,4,45,0.467,25,0.556,2,3,0.4,3,1,29,16,8,16,21,0.178,0.356,0.467,17.668,47,python
0,21,20,4,45,0.467,25,0.556,1,2,0.333,1,0,27,18,16,11,18,0.356,0.244,0.4,17.666,48,python
0,15,26,6,47,0.319,21,0.447,2,2,0.5,4,1,27,20,7,15,25,0.149,0.319,0.532,17.644,49,python
0,23,18,3,44,0.523,26,0.591,0,1,0.0,4,1,28,16,9,17,18,0.205,0.386,0.409,17.641,50,python
0,12,29,5,46,0.261,17,0.37,1,4,0.2,1,2,29,17,7,17,22,0.152,0.37,0.478,17.645,51,python
0,27,15,3,45,0.6,30,0.667,3,2,0.6,3,2,28,17,15,10,20,0.333,0.222,0.444,17.629,52,python
0,16,24,4,44,0.364,20,0.455,5,2,0.714,1,3,27,17,8,13,23,0.182,0.295,0.523,17.621,53,python
0,20,18,6,44,0.455,26,0.591,3,1,0.75,3,4,36,8,8,11,25,0.182,0.25,0.568,17.62,54,python
0,22,23,3,48,0.458,25,0.521,3,2,0.6,1,0,31,17,10,12,26,0.208,0.25,0.542,17.623,55,python
0,22,25,1,48,0.458,23,0.479,4,4,0.5,1,1,30,18,11,19,18,0.229,0.396,0.375,17.619,56,python
0,22,20,6,48,0.458,28,0.583,3,2,0.6,4,3,32,16,11,14,23,0.229,0.292,0.479,17.611,57,python
0,27,14,4,45,0.6,31,0.689,7,1,0.875,1,2,25,20,14,13,18,0.311,0.289,0.4,17.622,58,python
0,22,29,2,53,0.415,24,0.453,4,6,0.4,1,2,33,20,7,20,26,0.132,0.377,0.491,17.629,59,python
0,19,20,6,45,0.422,25,0.556,2,2,0.5,3,3,24,21,11,14,20,0.244,0.311,0.444,17.628,60,python
0,19,21,6,46,0.413,25,0.543,4,2,0.667,3,1,25,21,12,15,19,0.261,0.326,0.413,17.627,61,python
0,18,21,5,44,0.409,23,0.523,4,2,0.667,3,1,24,20,8,19,17,0.182,0.432,0.386,17.633,62,python
0,19,22,3,44,0.432,22,0.5,3,1,0.75,2,0,28,16,11,12,21,0.25,0.273,0.477,17.633,63,python
0,21,25,1,47,0.447,22,0.468,6,1,0.857,1,3,28,19,12,13,22,0.255,0.277,0.468,17.633,64,python
0,20,19,5,44,0.455,25,0.568,3,3,0.5,2,1,29,15,5,19,20,0.114,0.432,0.455,17.635,65,python
0,21,22,1,44,0.477,22,0.5,3,1,0.75,1,1,25,19,11,13,20,0.25,0.295,0.455,17.638,66,python
0,21,23,4,48,0.438,25,0.521,3,2,0.6,4,2,27,21,12,15,21,0.25,0.312,0.438,17.632,67,python
0,18,24,3,45,0.4,21,0.467,4,1,0.8,2,3,23,22,11,12,22,0.244,0.267,0.489,17.615,68,python
0,24,19,3,46,0.522,27,0.587,2,2,0.5,3,3,31,15,10,9,27,0.217,0.196,0.587,17.607,69,python
0,17,26,1,44,0.386,18,0.409,4,3,0.571,2,5,33,11,8,13,23,0.182,0.295,0.523,17.611,70,python
0,17,27,4,48,0.354,21,0.438,1,2,0.333,2,1,29,19,9,17,22,0.188,0.354,0.458,17.614,71,python
0,17,23,5,45,0.378,22,0.489,2,4,0.333,1,1,29,16,11,11,23,0.244,0.244,0.511,17.627,72,python
0,16,22,6,44,0.364,22,0.5,2,3,0.4,1,3,27,17,7,17,20,0.159,0.386,0.455,17.632,73,python
0,25,17,3,45,0.556,28,0.622,5,2,0.714,1,2,31,14,13,10,22,0.289,0.222,0.489,17.644,74,python
0,21,20,4,45,0.467,25,0.556,2,2,0.5,3,0,25,20,10,12,23,0.222,0.267,0.511,17.643,75,python
0,19,24,5,48,0.396,24,0.5,7,3,0.7,2,2,24,24,11,18,19,0.229,0.375,0.396,17.647,76,python
0,19,20,6,45,0.422,25,0.556,3,3,0.5,2,1,25,20,10,17,18,0.222,0.378,0.4,17.653,77,python
0,17,25,2,44,0.386,19,0.432,2,2,0.5,1,3,27,17,9,15,20,0.205,0.341,0.455,17.659,78,python
0,23,22,3,48,0.479,26,0.542,4,0,1.0,2,2,30,18,7,16,25,0.146,0.333,0.521,17.661,79,python
0,16,27,4,47,0.34,20,0.426,1,1,0.5,0,2,30,17,11,15,21,0.234,0.319,0.447,17.667,80,python
0,12,26,6,44,0.273,18,0.409,1,3,0.25,1,3,27,17,6,18,20,0.136,0.409,0.455,17.67,81,python
0,18,18,8,44,0.409,26,0.591,0,3,0.0,2,1,26,18,12,14,18,0.273,0.318,0.409,17.666,82,python
0,21,23,1,45,0.467,22,0.489,2,4,0.333,3,6,26,19,13,10,22,0.289,0.222,0.489,17.657,83,python
0,19,20,7,46,0.413,26,0.565,2,2,0.5,2,2,27,19,12,12,22,0.261,0.261,0.478,17.658,84,python
0,17,26,1,44,0.386,18,0.409,2,3,0.4,1,1,24,20,13,14,17,0.295,0.318,0.386,17.654,85,python
0,19,21,5,45,0.422,24,0.533,3,1,0.75,2,4,29,16,7,13,25,0.156,0.289,0.556,17.653,86,python
0,24,19,7,50,0.48,31,0.62,3,4,0.429,4,4,33,17,14,14,22,0.28,0.28,0.44,17.653,87,python
0,20,17,6,43,0.465,26,0.605,5,2,0.714,3,2,24,19,13,10,20,0.302,0.233,0.465,17.655,88,python
0,22,21,2,45,0.489,24,0.533,2,1,0.667,3,2,29,16,15,6,24,0.333,0.133,0.533,17.647,89,python
0,18,24,1,43,0.419,19,0.442,3,2,0.6,3,2,27,16,7,12,24,0.163,0.279,0.558,17.647,90,python
0,21,20,4,45,0.467,25,0.556,4,2,0.667,4,3,24,21,9,18,18,0.2,0.4,0.4,17.655,91,python
0,17,24,7,48,0.354,24,0.5,2,2,0.5,2,2,33,15,10,16,22,0.208,0.333,0.458,17.656,92,python
0,19,21,4,44,0.432,23,0.523,3,1,0.75,1,2,32,12,11,8,25,0.25,0.182,0.568,17.657,93,python
0,15,24,7,46,0.326,22,0.478,2,1,0.667,0,1,28,18,9,17,20,0.196,0.37,0.435,17.654,94,python
0,20,13,9,42,0.476,29,0.69,1,2,0.333,1,2,27,15,13,14,15,0.31,0.333,0.357,17.657,95,python
0,19,22,3,44,0.432,22,0.5,0,3,0.0,4,2,33,11,8,10,26,0.182,0.227,0.591,17.652,96,python
0,20,23,3,46,0.435,23,0.5,1,3,0.25,4,4,27,19,9,16,21,0.196,0.348,0.457,17.267,1,python
0,18,20,7,45,0.4,25,0.556,1,3,0.25,2,2,29,16,11,17,17,0.244,0.378,0.378,17.721,2,python
0,17,25,3,45,0.378,20,0.444,3,1,0.75,2,2,23,22,10,17,18,0.222,0.378,0.4,17.848,3,python
0,15,28,6,49,0.306,21,0.429,7,3,0.7,2,5,21,28,9,24,16,0.184,0.49,0.327,17.933,4,python
0,23,22,5,50,0.46,28,0.56,2,0,1.0,7,4,28,22,12,10,28,0.24,0.2,0.56,17.68,5,python
0,20,24,4,48,0.417,24,0.5,2,3,0.4,2,2,35,13,11,9,28,0.229,0.188,0.583,17.618,6,python
0,24,22,0,46,0.522,24,0.522,6,4,0.6,4,2,25,21,14,14,18,0.304,0.304,0.391,17.61,7,python
0,21,25,3,49,0.429,24,0.49,4,1,0.8,1,5,34,15,15,10,24,0.306,0.204,0.49,17.62,8,python
0,24,19,2,45,0.533,26,0.578,4,1,0.8,3,0,29,16,14,13,18,0.311,0.289,0.4,17.682,9,python
0,20,18,8,46,0.435,28,0.609,4,0,1.0,1,3,23,23,12,17,17,0.261,0.37,0.37,17.747,10,python
0,18,20,7,45,0.4,25,0.556,2,1,0.667,1,0,33,12,7,17,21,0.156,0.378,0.467,17.767,11,python
0,18,26,2,46,0.391,20,0.435,3,4,0.429,2,3,32,14,11,13,22,0.239,0.283,0.478,17.708,12,python
0,22,21,6,49,0.449,28,0.571,6,0,1.0,1,1,24,25,17,10,22,0.347,0.204,0.449,17.721,13,python
0,22,21,3,46,0.478,25,0.543,2,1,0.667,4,2,27,19,11,14,21,0.239,0.304,0.457,17.653,14,python
0,21,18,5,44,0.477,26,0.591,2,2,0.5,2,1,24,20,11,16,17,0.25,0.364,0.386,17.668,15,python
0,23,15,6,44,0.523,29,0.659,1,5,0.167,2,0,27,17,16,17,11,0.364,0.386,0.25,17.661,16,python
0,19,23,3,45,0.422,22,0.489,2,3,0.4,3,3,33,12,12,8,25,0.267,0.178,0.556,17.605,17,python
0,19,22,3,44,0.432,22,0.5,2,5,0.286,3,2,31,13,8,10,26,0.182,0.227,0.591,17.605,18,python
0,15,30,3,48,0.312,18,0.375,2,4,0.333,1,3,23,25,6,22,20,0.125,0.458,0.417,17.618,19,python
0,17,21,5,43,0.395,22,0.512,2,1,0.667,3,1,22,21,9,17,17,0.209,0.395,0.395,17.633,20,python
0,19,25,2,46,0.413,21,0.457,5,2,0.714,1,2,27,19,14,11,21,0.304,0.239,0.457,17.635,21,python
0,16,27,2,45,0.356,18,0.4,2,2,0.5,1,2,32,13,10,13,22,0.222,0.289,0.489,17.621,22,python
0,18,25,3,46,0.391,21,0.457,3,2,0.6,3,2,31,15,7,14,25,0.152,0.304,0.543,17.574,23,python
0,19,22,4,45,0.422,23,0.511,5,3,0.625,2,5,24,21,12,17,16,0.267,0.378,0.356,17.594,24,python
0,18,25,6,49,0.367,24,0.49,2,1,0.667,3,4,31,18,9,19,21,0.184,0.388,0.429,17.568,25,python
0,16,27,2,45,0.356,18,0.4,3,2,0.6,1,1,25,20,10,14,21,0.222,0.311,0.467,17.531,26,python
0,19,23,4,46,0.413,23,0.5,3,1,0.75,3,4,32,14,11,9,26,0.239,0.196,0.565,17.531,27,python
0,20,28,0,48,0.417,20,0.417,1,4,0.2,0,3,31,17,13,14,21,0.271,0.292,0.438,17.542,28,python
0,24,24,3,51,0.471,27,0.529,2,1,0.667,4,1,30,21,14,9,28,0.275,0.176,0.549,17.541,29,python
0,20,21,4,45,0.444,24,0.533,2,5,0.286,4,0,27,18,11,15,19,0.244,0.333,0.422,17.545,30,python
0,21,18,6,45,0.467,27,0.6,3,0,1.0,1,3,31,14,12,12,21,0.267,0.267,0.467,17.557,31,python
0,20,24,4,48,0.417,24,0.5,3,3,0.5,1,2,34,14,6,13,29,0.125,0.271,0.604,17.536,32,python
0,17,25,3,45,0.378,20,0.444,2,4,0.333,3,1,26,19,8,14,23,0.178,0.311,0.511,17.503,33,python
0,20,18,6,44,0.455,26,0.591,6,0,1.0,0,2,25,19,15,11,18,0.341,0.25,0.409,17.518,34,python
0,16,29,3,48,0.333,19,0.396,3,5,0.375,3,2,27,21,8,20,20,0.167,0.417,0.417,17.504,35,python
0,20,17,7,44,0.455,27,0.614,5,0,1.0,2,0,34,10,11,9,24,0.25,0.205,0.545,17.513,36,python
0,23,21,3,47,0.489,26,0.553,3,3,0.5,2,2,32,15,10,15,22,0.213,0.319,0.468,17.525,37,python
0,23,17,6,46,0.5,29,0.63,3,0,1.0,3,1,26,20,12,10,24,0.261,0.217,0.522,17.528,38,python
0,17,23,6,46,0.37,23,0.5,2,5,0.286,3,2,27,19,8,20,18,0.174,0.435,0.391,17.539,39,python
0,23,23,3,49,0.469,26,0.531,4,2,0.667,5,3,26,23,13,16,20,0.265,0.327,0.408,17.55,40,python
0,26,18,1,45,0.578,27,0.6,4,1,0.8,1,1,20,25,15,15,15,0.333,0.333,0.333,17.544,41,python
0,18,20,6,44,0.409,24,0.545,2,0,1.0,3,1,24,20,7,18,19,0.159,0.409,0.432,17.556,42,python
0,22,21,3,46,0.478,25,0.543,3,0,1.0,1,1,27,19,14,12,20,0.304,0.261,0.435,17.568,43,python
0,23,20,3,46,0.5,26,0.565,1,2,0.333,3,0,24,22,16,11,19,0.348,0.239,0.413,17.556,44,python
0,23,22,2,47,0.489,25,0.532,4,2,0.667,3,2,28,19,12,13,22,0.255,0.277,0.468,17.558,45,python
0,22,18,4,44,0.5,26,0.591,5,2,0.714,2,7,33,11,11,13,20,0.25,0.295,0.455,17.555,46,python
0,18,25,2,45,0.4,20,0.444,4,3,0.571,4,1,28,17,9,14,22,0.2,0.311,0.489,17.556,47,python
0,26,17,0,43,0.605,26,0.605,5,1,0.833,1,0,24,19,15,13,15,0.349,0.302,0.349,17.558,48,python
0,24,23,2,49,0.49,26,0.531,5,3,0.625,1,3,31,18,14,10,25,0.286,0.204,0.51,17.556,49,python
0,23,19,4,46,0.5,27,0.587,0,4,0.0,2,0,26,20,13,16,17,0.283,0.348,0.37,17.561,50,python
0,20,23,2,45,0.444,22,0.489,3,1,0.75,5,3,29,16,11,10,24,0.244,0.222,0.533,17.539,51,python
0,16,29,3,48,0.333,19,0.396,3,3,0.5,0,1,28,20,8,15,25,0.167,0.312,0.521,17.546,52,python
0,26,18,3,47,0.553,29,0.617,4,1,0.8,0,8,28,19,15,10,22,0.319,0.213,0.468,17.555,53,python
0,23,20,2,45,0.511,25,0.556,2,0,1.0,1,4,27,18,12,11,22,0.267,0.244,0.489,17.565,54,python
0,22,21,2,45,0.489,24,0.533,3,3,0.5,2,0,30,15,10,14,21,0.222,0.311,0.467,17.57,55,python
0,21,25,1,47,0.447,22,0.468,2,4,0.333,2,3,28,19,11,14,22,0.234,0.298,0.468,17.571,56,python
0,17,22,5,44,0.386,22,0.5,2,3,0.4,4,3,33,11,8,13,23,0.182,0.295,0.523,17.569,57,python
0,25,20,1,46,0.543,26,0.565,3,0,1.0,5,2,31,15,12,14,20,0.261,0.304,0.435,17.563,58,python
0,18,24,4,46,0.391,22,0.478,5,1,0.833,3,1,25,21,10,14,22,0.217,0.304,0.478,17.569,59,python
0,26,17,4,47,0.553,30,0.638,1,3,0.25,4,2,27,20,11,15,21,0.234,0.319,0.447,17.56,60,python
0,18,24,4,46,0.391,22,0.478,4,4,0.5,2,0,31,15,5,17,24,0.109,0.37,0.522,17.581,61,python
0,19,24,1,44,0.432,20,0.455,5,1,0.833,1,0,26,18,8,17,19,0.182,0.386,0.432,17.6,62,python
0,22,20,4,46,0.478,26,0.565,6,2,0.75,1,1,28,18,13,10,23,0.283,0.217,0.5,17.606,63,python
0,18,26,1,45,0.4,19,0.422,1,3,0.25,2,0,25,20,10,15,20,0.222,0.333,0.444,17.599,64,python
0,27,20,3,50,0.54,30,0.6,2,4,0.333,4,1,25,25,14,12,24,0.28,0.24,0.48,17.586,65,python
0,18,24,2,44,0.409,20,0.455,2,2,0.5,0,3,27,17,13,13,18,0.295,0.295,0.409,17.596,66,python
0,27,15,3,45,0.6,30,0.667,2,2,0.5,3,0,29,16,15,8,22,0.333,0.178,0.489,17.597,67,python
0,25,20,3,48,0.521,28,0.583,7,1,0.875,2,3,26,22,16,13,19,0.333,0.271,0.396,17.597,68,python
0,18,23,3,44,0.409,21,0.477,6,1,0.857,2,2,28,16,9,11,24,0.205,0.25,0.545,17.6,69,python
0,17,28,1,46,0.37,18,0.391,1,4,0.2,2,4,24,22,12,14,20,0.261,0.304,0.435,17.605,70,python
0,19,19,6,44,0.432,25,0.568,5,0,1.0,4,2,26,18,8,15,21,0.182,0.341,0.477,17.603,71,python
0,25,21,0,46,0.543,25,0.543,6,1,0.857,3,2,24,22,12,13,21,0.261,0.283,0.457,17.595,72,python
0,18,21,6,45,0.4,24,0.533,2,0,1.0,4,2,27,18,8,12,25,0.178,0.267,0.556,17.591,73,python
0,17,20,8,45,0.378,25,0.556,4,1,0.8,1,2,27,18,6,18,21,0.133,0.4,0.467,17.598,74,python
0,20,19,6,45,0.444,26,0.578,1,1,0.5,2,1,32,13,8,17,20,0.178,0.378,0.444,17.609,75,python
0,23,18,5,46,0.5,28,0.609,6,1,0.857,1,2,21,25,13,18,15,0.283,0.391,0.326,17.612,76,python
0,20,25,3,48,0.417,23,0.479,1,3,0.25,4,4,32,16,11,13,24,0.229,0.271,0.5,17.601,77,python
0,27,16,1,44,0.614,28,0.636,4,1,0.8,4,2,29,15,15,9,20,0.341,0.205,0.455,17.591,78,python
0,16,28,2,46,0.348,18,0.391,1,3,0.25,0,4,30,16,7,19,20,0.152,0.413,0.435,17.604,79,python
0,22,21,3,46,0.478,25,0.543,3,3,0.5,2,2,22,24,12,19,15,0.261,0.413,0.326,17.603,80,python
0,17,24,4,45,0.378,21,0.467,2,0,1.0,3,2,28,17,5,19,21,0.111,0.422,0.467,17.591,81,python
0,26,13,5,44,0.591,31,0.705,5,1,0.833,4,3,26,18,14,10,20,0.318,0.227,0.455,17.597,82,python
0,20,23,3,46,0.435,23,0.5,4,7,0.364,2,1,30,16,10,16,20,0.217,0.348,0.435,17.598,83,python
0,14,27,3,44,0.318,17,0.386,4,2,0.667,0,2,27,17,7,18,19,0.159,0.409,0.432,17.605,84,python
0,16,25,2,43,0.372,18,0.419,2,1,0.667,1,2,26,17,10,13,20,0.233,0.302,0.465,17.593,85,python
0,21,20,4,45,0.467,25,0.556,3,1,0.75,4,4,31,14,9,13,23,0.2,0.289,0.511,17.591,86,python
0,21,22,5,48,0.438,26,0.542,5,2,0.714,3,4,31,17,10,13,25,0.208,0.271,0.521,17.592,87,python
0,16,24,3,43,0.372,19,0.442,2,4,0.333,2,1,23,20,11,19,13,0.256,0.442,0.302,17.59,88,python
0,20,22,5,47,0.426,25,0.532,0,3,0.0,4,1,30,17,8,11,28,0.17,0.234,0.596,17.582,89,python
0,17,27,4,48,0.354,21,0.438,1,2,0.333,1,2,26,22,9,17,22,0.188,0.354,0.458,17.581,90,python
0,23,21,4,48,0.479,27,0.562,0,2,0.0,3,2,29,19,12,16,20,0.25,0.333,0.417,17.578,91,python
0,22,19,4,45,0.489,26,0.578,6,2,0.75,1,2,23,22,12,16,17,0.267,0.356,0.378,17.582,92,python
0,18,24,4,46,0.391,22,0.478,3,2,0.6,1,0,28,18,11,17,18,0.239,0.37,0.391,17.584,93,python
0,16,23,6,45,0.356,22,0.489,2,1,0.667,4,4,30,15,9,18,18,0.2,0.4,0.4,17.582,94,python
0,22,15,7,44,0.5,29,0.659,6,2,0.75,2,2,26,18,13,14,17,0.295,0.318,0.386,17.589,95,python
0,15,30,3,48,0.312,18,0.375,2,3,0.4,2,4,30,18,8,15,25,0.167,0.312,0.521,17.579,96,python
0,23,16,6,45,0.511,29,0.644,3,1,0.75,1,3,25,20,14,16,15,0.311,0.356,0.333,18.0,1,python
0,21,21,5,47,0.447,26,0.553,3,2,0.6,2,1,26,21,9,18,20,0.191,0.383,0.426,18.143,2,python
0,30,12,4,46,0.652,34,0.739,6,0,1.0,3,1,24,22,18,12,16,0.391,0.261,0.348,18.012,3,python
0,25,18,7,50,0.5,32,0.64,4,1,0.8,2,1,21,29,20,21,9,0.4,0.42,0.18,18.106,4,python
0,24,22,2,48,0.5,26,0.542,4,1,0.8,3,1,35,13,12,10,26,0.25,0.208,0.542,17.859,5,python
0,19,27,2,48,0.396,21,0.438,3,4,0.429,2,3,26,22,11,16,21,0.229,0.333,0.438,17.8,6,python
0,26,16,4,46,0.565,30,0.652,7,1,0.875,4,1,29,17,12,15,19,0.261,0.326,0.413,17.799,7,python
0,24,18,5,47,0.511,29,0.617,4,4,0.5,2,0,25,22,16,14,17,0.34,0.298,0.362,17.789,8,python
0,17,25,2,44,0.386,19,0.432,4,0,1.0,2,2,29,15,7,16,21,0.159,0.364,0.477,17.78,9,python
0,20,23,4,47,0.426,24,0.511,2,4,0.333,5,3,29,18,9,12,26,0.191,0.255,0.553,17.769,10,python
0,23,18,3,44,0.523,26,0.591,4,2,0.667,2,1,27,17,18,9,17,0.409,0.205,0.386,17.734,11,python
0,19,21,3,43,0.442,22,0.512,4,1,0.8,3,3,30,13,11,12,20,0.256,0.279,0.465,17.71,12,python
0,9,29,6,44,0.205,15,0.341,1,5,0.167,2,5,29,15,5,15,24,0.114,0.341,0.545,17.659,13,python
0,23,17,4,44,0.523,27,0.614,2,0,1.0,1,1,32,12,14,9,21,0.318,0.205,0.477,17.571,14,python
0,20,19,4,43,0.465,24,0.558,5,1,0.833,2,2,26,17,8,15,20,0.186,0.349,0.465,17.569,15,python
0,19,26,5,50,0.38,24,0.48,2,7,0.222,1,3,26,24,10,19,21,0.2,0.38,0.42,17.59,16,python
0,14,31,2,47,0.298,16,0.34,4,1,0.8,2,2,32,15,6,13,28,0.128,0.277,0.596,17.637,17,python
0,24,19,3,46,0.522,27,0.587,3,0,1.0,0,1,26,20,16,16,14,0.348,0.348,0.304,17.668,18,python
0,19,21,6,46,0.413,25,0.543,4,5,0.444,3,4,31,15,8,14,24,0.174,0.304,0.522,17.671,19,python
0,21,19,4,44,0.477,25,0.568,2,2,0.5,4,3,27,17,14,9,21,0.318,0.205,0.477,17.637,20,python
0,12,32,2,46,0.261,14,0.304,2,4,0.333,1,4,29,17,6,17,23,0.13,0.37,0.5,17.688,21,python
0,16,24,6,46,0.348,22,0.478,3,0,1.0,1,2,32,14,8,13,25,0.174,0.283,0.543,17.666,22,python
0,20,23,3,46,0.435,23,0.5,4,3,0.571,2,1,30,16,8,13,25,0.174,0.283,0.543,17.657,23,python
0,21,20,4,45,0.467,25,0.556,3,0,1.0,0,0,34,11,9,11,25,0.2,0.244,0.556,17.679,24,python
0,23,17,6,46,0.5,29,0.63,1,1,0.5,3,1,29,17,5,20,21,0.109,0.435,0.457,17.685,25,python
0,20,23,4,47,0.426,24,0.511,2,4,0.333,1,2,31,16,8,14,25,0.17,0.298,0.532,17.686,26,python
0,20,21,4,45,0.444,24,0.533,5,3,0.625,1,2,31,14,8,10,27,0.178,0.222,0.6,17.683,27,python
0,25,17,3,45,0.556,28,0.622,4,3,0.571,2,3,26,19,13,18,14,0.289,0.4,0.311,17.708,28,python
0,18,25,3,46,0.391,21,0.457,4,4,0.5,2,3,25,21,9,19,18,0.196,0.413,0.391,17.691,29,python
0,19,23,3,45,0.422,22,0.489,1,4,0.2,2,0,25,20,11,15,19,0.244,0.333,0.422,17.701,30,python
0,21,21,4,46,0.457,25,0.543,2,4,0.333,2,2,27,19,12,18,16,0.261,0.391,0.348,17.719,31,python
0,23,27,0,50,0.46,23,0.46,5,2,0.714,6,4,28,22,13,11,26,0.26,0.22,0.52,17.689,32,python
0,18,25,2,45,0.4,20,0.444,1,2,0.333,3,2,29,16,11,16,18,0.244,0.356,0.4,17.688,33,python
0,24,16,4,44,0.545,28,0.636,5,1,0.833,0,1,22,22,14,18,12,0.318,0.409,0.273,17.686,34,python
0,15,27,3,45,0.333,18,0.4,2,2,0.5,0,5,30,15,4,19,22,0.089,0.422,0.489,17.695,35,python
0,20,26,2,48,0.417,22,0.458,4,4,0.5,1,1,26,22,14,16,18,0.292,0.333,0.375,17.696,36,python
0,21,21,1,43,0.488,22,0.512,2,2,0.5,2,4,28,15,13,12,18,0.302,0.279,0.419,17.676,37,python
0,21,22,2,45,0.467,23,0.511,5,0,1.0,3,2,24,21,9,12,24,0.2,0.267,0.533,17.67,38,python
0,21,18,5,44,0.477,26,0.591,3,3,0.5,0,1,28,16,9,16,19,0.205,0.364,0.432,17.667,39,python
0,22,21,1,44,0.5,23,0.523,2,0,1.0,3,0,25,19,13,11,20,0.295,0.25,0.455,17.679,40,python
0,16,25,5,46,0.348,21,0.457,2,4,0.333,1,4,27,19,10,18,18,0.217,0.391,0.391,17.687,41,python
0,13,28,5,46,0.283,18,0.391,1,3,0.25,0,6,32,14,7,12,27,0.152,0.261,0.587,17.679,42,python
0,12,29,6,47,0.255,18,0.383,1,0,1.0,0,1,35,12,5,20,22,0.106,0.426,0.468,17.691,43,python
0,20,20,4,44,0.455,24,0.545,3,5,0.375,4,1,29,15,8,16,20,0.182,0.364,0.455,17.684,44,python
0,22,27,1,50,0.44,23,0.46,4,3,0.571,1,4,26,24,14,19,17,0.28,0.38,0.34,17.688,45,python
0,23,21,3,47,0.489,26,0.553,1,1,0.5,3,1,25,22,14,13,20,0.298,0.277,0.426,17.683,46,python
0,20,22,4,46,0.435,24,0.522,7,3,0.7,1,4,28,18,12,13,21,0.261,0.283,0.457,17.679,47,python
0,18,29,0,47,0.383,18,0.383,0,3,0.0,1,3,30,17,13,12,22,0.277,0.255,0.468,17.678,48,python
0,19,21,4,44,0.432,23,0.523,7,1,0.875,2,2,27,17,8,20,16,0.182,0.455,0.364,17.696,49,python
0,16,25,4,45,0.356,20,0.444,2,2,0.5,0,2,30,15,8,17,20,0.178,0.378,0.444,17.714,50,python
0,20,22,2,44,0.455,22,0.5,5,2,0.714,1,2,25,19,13,16,15,0.295,0.364,0.341,17.712,51,python
0,19,23,5,47,0.404,24,0.511,6,3,0.667,1,2,32,15,12,11,24,0.255,0.234,0.511,17.722,52,python
0,24,21,5,50,0.48,29,0.58,6,2,0.75,1,6,33,17,13,14,23,0.26,0.28,0.46,17.727,53,python
0,22,21,1,44,0.5,23,0.523,3,2,0.6,2,2,28,16,12,16,16,0.273,0.364,0.364,17.725,54,python
0,19,25,2,46,0.413,21,0.457,0,5,0.0,1,3,25,21,11,13,22,0.239,0.283,0.478,17.724,55,python
0,23,23,2,48,0.479,25,0.521,6,0,1.0,1,1,30,18,13,15,20,0.271,0.312,0.417,17.739,56,python
0,21,20,5,46,0.457,26,0.565,3,1,0.75,3,2,30,16,8,14,24,0.174,0.304,0.522,17.738,57,python
0,23,21,2,46,0.5,25,0.543,2,2,0.5,3,2,31,15,13,14,19,0.283,0.304,0.413,17.74,58,python
0,27,16,4,47,0.574,31,0.66,5,1,0.833,2,1,26,21,17,11,19,0.362,0.234,0.404,17.709,59,python
0,20,24,2,46,0.435,22,0.478,1,7,0.125,2,1,28,18,14,15,17,0.304,0.326,0.37,17.707,60,python
0,16,25,5,46,0.348,21,0.457,1,1,0.5,2,4,32,14,10,16,20,0.217,0.348,0.435,17.709,61,python
0,22,18,6,46,0.478,28,0.609,4,1,0.8,5,2,29,17,14,10,22,0.304,0.217,0.478,17.709,62,python
0,17,21,7,45,0.378,24,0.533,1,2,0.333,3,1,29,16,8,15,22,0.178,0.333,0.489,17.706,63,python
0,19,27,5,51,0.373,24,0.471,2,5,0.286,2,2,30,21,14,12,25,0.275,0.235,0.49,17.7,64,python
0,23,20,3,46,0.5,26,0.565,6,2,0.75,4,0,26,20,12,15,19,0.261,0.326,0.413,17.703,65,python
0,18,25,3,46,0.391,21,0.457,2,0,1.0,2,1,31,15,4,14,28,0.087,0.304,0.609,17.699,66,python
0,25,20,2,47,0.532,27,0.574,6,3,0.667,3,1,32,15,9,11,27,0.191,0.234,0.574,17.695,67,python
0,23,23,1,47,0.489,24,0.511,5,4,0.556,5,3,35,12,11,9,27,0.234,0.191,0.574,17.691,68,python
0,22,22,2,46,0.478,24,0.522,5,3,0.625,3,2,29,17,11,15,20,0.239,0.326,0.435,17.686,69,python
0,14,28,3,45,0.311,17,0.378,2,3,0.4,0,2,30,15,8,17,20,0.178,0.378,0.444,17.691,70,python
0,19,25,3,47,0.404,22,0.468,1,2,0.333,5,3,30,17,5,18,24,0.106,0.383,0.511,17.69,71,python
0,20,23,2,45,0.444,22,0.489,2,1,0.667,2,1,28,17,8,14,23,0.178,0.311,0.511,17.693,72,python
0,21,17,8,46,0.457,29,0.63,1,2,0.333,2,1,30,16,11,12,23,0.239,0.261,0.5,17.688,73,python
0,24,22,2,48,0.5,26,0.542,5,4,0.556,3,1,35,13,12,10,26,0.25,0.208,0.542,17.685,74,python
0,19,20,6,45,0.422,25,0.556,3,2,0.6,1,2,27,18,12,12,21,0.267,0.267,0.467,17.69,75,python
0,17,24,3,44,0.386,20,0.455,2,3,0.4,2,1,28,16,11,13,20,0.25,0.295,0.455,17.697,76,python
0,18,22,4,44,0.409,22,0.5,6,0,1.0,2,2,28,16,9,15,20,0.205,0.341,0.455,17.692,77,python
0,20,22,3,45,0.444,23,0.511,4,5,0.444,3,2,30,15,11,14,20,0.244,0.311,0.444,17.7,78,python
0,17,24,5,46,0.37,22,0.478,3,3,0.5,2,2,23,23,9,17,20,0.196,0.37,0.435,17.707,79,python
0,23,19,6,48,0.479,29,0.604,6,4,0.6,5,1,28,20,9,18,21,0.188,0.375,0.438,17.699,80,python
0,19,23,3,45,0.422,22,0.489,1,2,0.333,2,2,27,18,9,24,12,0.2,0.533,0.267,17.707,81,python
0,22,19,3,44,0.5,25,0.568,2,3,0.4,1,1,27,17,14,14,16,0.318,0.318,0.364,17.716,82,python
0,18,22,7,47,0.383,25,0.532,4,3,0.571,2,0,26,21,11,15,21,0.234,0.319,0.447,17.729,83,python
0,23,21,2,46,0.5,25,0.543,0,4,0.0,1,2,27,19,18,8,20,0.391,0.174,0.435,17.722,84,python
0,22,17,5,44,0.5,27,0.614,2,4,0.333,4,1,31,13,11,13,20,0.25,0.295,0.455,17.717,85,python
0,17,24,2,43,0.395,19,0.442,5,4,0.556,0,2,22,21,10,18,15,0.233,0.419,0.349,17.718,86,python
0,20,20,4,44,0.455,24,0.545,1,2,0.333,2,2,30,14,6,16,22,0.136,0.364,0.5,17.716,87,python
0,20,18,7,45,0.444,27,0.6,2,3,0.4,3,2,30,15,11,14,20,0.244,0.311,0.444,17.719,88,python
0,25,21,1,47,0.532,26,0.553,5,2,0.714,1,3,25,22,14,10,23,0.298,0.213,0.489,17.719,89,python
0,24,21,1,46,0.522,25,0.543,3,0,1.0,2,2,27,19,15,9,22,0.326,0.196,0.478,17.713,90,python
0,19,25,2,46,0.413,21,0.457,2,2,0.5,1,3,33,13,6,15,25,0.13,0.326,0.543,17.712,91,python
0,17,20,6,43,0.395,23,0.535,4,2,0.667,1,0,26,17,12,16,15,0.279,0.372,0.349,17.715,92,python
0,19,22,4,45,0.422,23,0.511,1,2,0.333,4,1,25,20,13,16,16,0.289,0.356,0.356,17.706,93,python
0,25,20,4,49,0.51,29,0.592,5,2,0.714,4,3,31,18,14,7,28,0.286,0.143,0.571,17.697,94,python
0,16,24,4,44,0.364,20,0.455,2,2,0.5,1,4,25,19,12,16,16,0.273,0.364,0.364,17.696,95,python
0,19,28,2,49,0.388,21,0.429,5,3,0.625,2,3,29,20,9,18,22,0.184,0.367,0.449,17.701,96,python
0,25,20,0,45,0.556,25,0.556,5,3,0.625,4,1,27,18,15,12,18,0.333,0.267,0.4,18.037,1,python
0,21,20,4,45,0.467,25,0.556,5,4,0.556,3,1,22,23,14,9,22,0.311,0.2,0.489,17.964,2,python
0,13,24,7,44,0.295,20,0.455,4,2,0.667,1,3,29,15,8,11,25,0.182,0.25,0.568,17.897,3,python
0,22,21,3,46,0.478,25,0.543,3,1,0.75,2,0,27,19,8,15,23,0.174,0.326,0.5,17.73,4,python
0,22,21,2,45,0.489,24,0.533,3,0,1.0,3,5,29,16,13,16,16,0.289,0.356,0.356,17.789,5,python
0,17,23,6,46,0.37,23,0.5,2,1,0.667,4,5,23,23,8,18,20,0.174,0.391,0.435,17.749,6,python
0,16,22,7,45,0.356,23,0.511,2,1,0.667,1,4,24,21,9,17,19,0.2,0.378,0.422,17.77,7,python
0,21,26,4,51,0.412,25,0.49,2,2,0.5,2,4,34,17,12,15,24,0.235,0.294,0.471,17.787,8,python
0,19,21,6,46,0.413,25,0.543,1,4,0.2,5,1,26,20,8,14,24,0.174,0.304,0.522,17.657,9,python
0,16,23,7,46,0.348,23,0.5,2,2,0.5,2,4,26,20,8,17,21,0.174,0.37,0.457,17.684,10,python
0,20,21,3,44,0.455,23,0.523,2,0,1.0,1,7,29,15,10,14,20,0.227,0.318,0.455,17.698,11,python
0,25,18,3,46,0.543,28,0.609,0,1,0.0,2,1,24,22,18,10,18,0.391,0.217,0.391,17.626,12,python
0,18,25,2,45,0.4,20,0.444,2,1,0.667,3,2,25,20,7,19,19,0.156,0.422,0.422,17.652,13,python
0,15,23,8,46,0.326,23,0.5,3,2,0.6,2,2,26,20,11,17,18,0.239,0.37,0.391,17.652,14,python
0,23,17,6,46,0.5,29,0.63,5,2,0.714,1,2,28,18,12,18,16,0.261,0.391,0.348,17.684,15,python
0,13,26,8,47,0.277,21,0.447,1,1,0.5,0,3,28,19,9,14,24,0.191,0.298,0.511,17.707,16,python
0,26,15,2,43,0.605,28,0.651,7,2,0.778,1,1,26,17,12,10,21,0.279,0.233,0.488,17.726,17,python
0,19,22,3,44,0.432,22,0.5,3,1,0.75,3,3,28,16,12,10,22,0.273,0.227,0.5,17.698,18,python
0,18,22,3,43,0.419,21,0.488,3,1,0.75,0,2,20,23,13,14,16,0.302,0.326,0.372,17.695,19,python
0,15,28,2,45,0.333,17,0.378,4,3,0.571,1,2,26,19,12,13,20,0.267,0.289,0.444,17.673,20,python
0,22,18,6,46,0.478,28,0.609,4,2,0.667,7,4,32,14,10,12,24,0.217,0.261,0.522,17.662,21,python
0,13,28,6,47,0.277,19,0.404,2,3,0.4,0,3,23,24,6,18,23,0.128,0.383,0.489,17.689,22,python
0,20,23,2,45,0.444,22,0.489,2,1,0.667,4,1,32,13,10,11,24,0.222,0.244,0.533,17.664,23,python
0,17,23,5,45,0.378,22,0.489,1,1,0.5,3,2,31,14,9,10,26,0.2,0.222,0.578,17.65,24,python
0,18,22,5,45,0.4,23,0.511,3,1,0.75,1,2,26,19,9,22,14,0.2,0.489,0.311,17.642,25,python
0,24,19,1,44,0.545,25,0.568,4,0,1.0,2,3,26,18,15,14,15,0.341,0.318,0.341,17.6,26,python
0,20,25,4,49,0.408,24,0.49,6,2,0.75,2,2,27,22,9,20,20,0.184,0.408,0.408,17.609,27,python
0,17,26,4,47,0.362,21,0.447,1,0,1.0,1,2,32,15,10,11,26,0.213,0.234,0.553,17.598,28,python
0,20,20,6,46,0.435,26,0.565,3,4,0.429,1,1,30,16,10,15,21,0.217,0.326,0.457,17.628,29,python
0,18,22,5,45,0.4,23,0.511,2,4,0.333,1,2,29,16,8,19,18,0.178,0.422,0.4,17.633,30,python
0,18,22,6,46,0.391,24,0.522,1,1,0.5,3,0,31,15,9,13,24,0.196,0.283,0.522,17.642,31,python
0,19,24,6,49,0.388,25,0.51,3,4,0.429,1,1,33,16,7,17,25,0.143,0.347,0.51,17.655,32,python
0,19,25,2,46,0.413,21,0.457,3,3,0.5,1,3,27,19,11,17,18,0.239,0.37,0.391,17.66,33,python
0,18,23,5,46,0.391,23,0.5,2,0,1.0,5,4,27,19,9,12,25,0.196,0.261,0.543,17.644,34,python
0,20,23,5,48,0.417,25,0.521,4,0,1.0,2,3,29,19,6,20,22,0.125,0.417,0.458,17.656,35,python
0,19,25,4,48,0.396,23,0.479,3,3,0.5,2,5,27,21,8,16,24,0.167,0.333,0.5,17.669,36,python
0,21,22,2,45,0.467,23,0.511,4,0,1.0,4,3,33,12,12,9,24,0.267,0.2,0.533,17.663,37,python
0,23,16,6,45,0.511,29,0.644,3,3,0.5,6,1,28,17,12,9,24,0.267,0.2,0.533,17.639,38,python
0,34,9,3,46,0.739,37,0.804,6,2,0.75,2,3,28,18,18,11,17,0.391,0.239,0.37,17.639,39,python
0,18,29,1,48,0.375,19,0.396,2,7,0.222,1,4,24,24,12,18,18,0.25,0.375,0.375,17.637,40,python
0,15,22,5,42,0.357,20,0.476,1,3,0.25,2,2,27,15,11,15,16,0.262,0.357,0.381,17.646,41,python
0,18,24,3,45,0.4,21,0.467,1,1,0.5,3,1,28,17,8,16,21,0.178,0.356,0.467,17.649,42,python
0,27,17,1,45,0.6,28,0.622,3,1,0.75,3,0,26,19,11,15,19,0.244,0.333,0.422,17.656,43,python
0,22,22,1,45,0.489,23,0.511,4,3,0.571,5,2,22,23,7,14,24,0.156,0.311,0.533,17.644,44,python
0,18,23,6,47,0.383,24,0.511,1,1,0.5,2,2,27,20,10,15,22,0.213,0.319,0.468,17.644,45,python
0,16,27,2,45,0.356,18,0.4,3,1,0.75,1,3,30,15,7,15,23,0.156,0.333,0.511,17.646,46,python
0,10,29,6,45,0.222,16,0.356,0,3,0.0,1,4,27,18,6,19,20,0.133,0.422,0.444,17.67,47,python
0,17,27,4,48,0.354,21,0.438,0,1,0.0,3,6,33,15,8,15,25,0.167,0.312,0.521,17.665,48,python
0,20,23,4,47,0.426,24,0.511,0,1,0.0,2,1,30,17,8,16,23,0.17,0.34,0.489,17.668,49,python
0,16,26,4,46,0.348,20,0.435,3,0,1.0,1,4,28,18,8,16,22,0.174,0.348,0.478,17.667,50,python
0,23,21,1,45,0.511,24,0.533,2,0,1.0,2,1,27,18,10,16,19,0.222,0.356,0.422,17.677,51,python
0,21,20,3,44,0.477,24,0.545,3,1,0.75,2,1,28,16,12,12,20,0.273,0.273,0.455,17.682,52,python
0,20,17,8,45,0.444,28,0.622,1,1,0.5,2,1,33,12,11,14,20,0.244,0.311,0.444,17.684,53,python
0,14,24,6,44,0.318,20,0.455,2,2,0.5,1,2,30,14,4,20,20,0.091,0.455,0.455,17.707,54,python
0,16,27,3,46,0.348,19,0.413,3,2,0.6,2,2,28,18,8,16,22,0.174,0.348,0.478,17.708,55,python
0,12,26,7,45,0.267,19,0.422,3,3,0.5,1,1,30,15,7,15,23,0.156,0.333,0.511,17.712,56,python
0,24,17,4,45,0.533,28,0.622,4,2,0.667,2,3,30,15,15,12,18,0.333,0.267,0.4,17.705,57,python
0,18,21,7,46,0.391,25,0.543,2,3,0.4,0,1,34,12,6,14,26,0.13,0.304,0.565,17.714,58,python
0,20,24,4,48,0.417,24,0.5,2,4,0.333,4,2,28,20,10,16,22,0.208,0.333,0.458,17.718,59,python
0,24,18,3,45,0.533,27,0.6,3,0,1.0,3,1,30,15,11,14,20,0.244,0.311,0.444,17.706,60,python
0,20,24,4,48,0.417,24,0.5,4,4,0.5,3,3,32,16,11,19,18,0.229,0.396,0.375,17.703,61,python
0,14,29,4,47,0.298,18,0.383,1,4,0.2,5,5,32,15,9,13,25,0.191,0.277,0.532,17.698,62,python
0,13,28,3,44,0.295,16,0.364,0,2,0.0,1,3,30,14,5,17,22,0.114,0.386,0.5,17.697,63,python
0,17,25,2,44,0.386,19,0.432,1,1,0.5,0,1,28,16,10,15,19,0.227,0.341,0.432,17.701,64,python
0,23,17,6,46,0.5,29,0.63,7,3,0.7,1,1,26,20,15,12,19,0.326,0.261,0.413,17.706,65,python
0,15,25,4,44,0.341,19,0.432,4,1,0.8,1,4,29,15,9,14,21,0.205,0.318,0.477,17.703,66,python
0,19,22,4,45,0.422,23,0.511,2,2,0.5,0,1,24,21,14,17,14,0.311,0.378,0.311,17.708,67,python
0,20,23,3,46,0.435,23,0.5,2,0,1.0,2,2,24,22,9,13,24,0.196,0.283,0.522,17.704,68,python
0,23,20,2,45,0.511,25,0.556,1,0,1.0,3,1,22,23,11,16,18,0.244,0.356,0.4,17.697,69,python
0,20,22,3,45,0.444,23,0.511,2,2,0.5,3,2,31,14,10,11,24,0.222,0.244,0.533,17.7,70,python
0,22,20,3,45,0.489,25,0.556,2,4,0.333,2,1,27,18,14,9,22,0.311,0.2,0.489,17.701,71,python
0,22,19,8,49,0.449,30,0.612,2,1,0.667,2,0,36,13,17,13,19,0.347,0.265,0.388,17.702,72,python
0,20,22,4,46,0.435,24,0.522,1,4,0.2,4,2,29,17,9,15,22,0.196,0.326,0.478,17.685,73,python
0,17,23,4,44,0.386,21,0.477,4,1,0.8,1,2,27,17,12,10,22,0.273,0.227,0.5,17.684,74,python
0,17,24,7,48,0.354,24,0.5,6,3,0.667,1,4,27,21,10,18,20,0.208,0.375,0.417,17.682,75,python
0,26,18,3,47,0.553,29,0.617,0,3,0.0,1,1,34,13,9,19,19,0.191,0.404,0.404,17.686,76,python
0,20,21,4,45,0.444,24,0.533,3,1,0.75,3,4,32,13,9,15,21,0.2,0.333,0.467,17.692,77,python
0,17,25,3,45,0.378,20,0.444,4,3,0.571,0,2,25,20,8,16,21,0.178,0.356,0.467,17.692,78,python
0,17,25,3,45,0.378,20,0.444,1,1,0.5,1,1,31,14,8,15,22,0.178,0.333,0.489,17.689,79,python
0,25,19,4,48,0.521,29,0.604,4,1,0.8,2,4,29,19,13,16,19,0.271,0.333,0.396,17.684,80,python
0,23,18,3,44,0.523,26,0.591,5,1,0.833,2,0,28,16,14,9,21,0.318,0.205,0.477,17.687,81,python
0,21,19,4,44,0.477,25,0.568,5,1,0.833,1,3,26,18,15,9,20,0.341,0.205,0.455,17.69,82,python
0,20,23,2,45,0.444,22,0.489,6,1,0.857,4,1,29,16,10,14,21,0.222,0.311,0.467,17.684,83,python
0,12,29,4,45,0.267,16,0.356,1,2,0.333,3,3,31,14,5,15,25,0.111,0.333,0.556,17.669,84,python
0,15,24,7,46,0.326,22,0.478,1,2,0.333,3,4,37,9,5,16,25,0.109,0.348,0.543,17.667,85,python
0,18,22,5,45,0.4,23,0.511,4,2,0.667,3,2,31,14,9,15,21,0.2,0.333,0.467,17.663,86,python
0,21,26,0,47,0.447,21,0.447,1,1,0.5,2,2,26,21,10,15,22,0.213,0.319,0.468,17.657,87,python
0,14,31,4,49,0.286,18,0.367,1,3,0.25,2,5,38,11,8,16,25,0.163,0.327,0.51,17.654,88,python
0,13,32,2,47,0.277,15,0.319,5,5,0.5,2,3,31,16,6,14,27,0.128,0.298,0.574,17.65,89,python
0,21,26,1,48,0.438,22,0.458,0,0,0,5,3,29,19,8,15,25,0.167,0.312,0.521,17.654,90,python
0,20,22,4,46,0.435,24,0.522,2,1,0.667,2,6,29,17,8,15,23,0.174,0.326,0.5,17.647,91,python
0,17,24,5,46,0.37,22,0.478,3,3,0.5,1,4,29,17,8,17,21,0.174,0.37,0.457,17.657,92,python
0,20,20,3,43,0.465,23,0.535,5,3,0.625,1,4,29,14,11,14,18,0.256,0.326,0.419,17.656,93,python
0,18,25,2,45,0.4,20,0.444,3,2,0.6,1,1,24,21,10,23,12,0.222,0.511,0.267,17.661,94,python
0,25,19,2,46,0.543,27,0.587,5,1,0.833,6,1,29,17,10,11,25,0.217,0.239,0.543,17.657,95,python
0,17,28,3,48,0.354,20,0.417,0,4,0.0,2,3,27,21,11,16,21,0.229,0.333,0.438,17.668,96,python
0,19,24,1,44,0.432,20,0.455,4,1,0.8,3,3,32,12,8,13,23,0.182,0.295,0.523,17.567,1,python
0,21,21,5,47,0.447,26,0.553,2,5,0.286,4,1,24,23,11,12,24,0.234,0.255,0.511,17.516,2,python
0,19,21,5,45,0.422,24,0.533,1,3,0.25,2,2,27,18,10,11,24,0.222,0.244,0.533,17.368,3,python
0,26,15,3,44,0.591,29,0.659,2,1,0.667,3,3,26,18,15,9,20,0.341,0.205,0.455,17.331,4,python
0,17,26,3,46,0.37,20,0.435,5,5,0.5,3,4,27,19,8,21,17,0.174,0.457,0.37,17.437,5,python
0,25,18,3,46,0.543,28,0.609,5,1,0.833,2,2,27,19,14,13,19,0.304,0.283,0.413,17.613,6,python
0,23,19,5,47,0.489,28,0.596,2,2,0.5,5,2,31,16,10,12,25,0.213,0.255,0.532,17.486,7,python
0,24,16,3,43,0.558,27,0.628,8,2,0.8,3,3,26,17,15,9,19,0.349,0.209,0.442,17.43,8,python
0,24,21,2,47,0.511,26,0.553,1,3,0.25,3,2,27,20,13,15,19,0.277,0.319,0.404,17.303,9,python
0,18,27,2,47,0.383,20,0.426,4,1,0.8,3,4,29,18,7,13,27,0.149,0.277,0.574,17.31,10,python
0,17,24,4,45,0.378,21,0.467,3,1,0.75,3,1,25,20,10,17,18,0.222,0.378,0.4,17.404,11,python
0,21,22,4,47,0.447,25,0.532,2,3,0.4,1,4,28,19,10,15,22,0.213,0.319,0.468,17.451,12,python
0,16,22,6,44,0.364,22,0.5,1,0,1.0,0,3,32,12,11,15,18,0.25,0.341,0.409,17.501,13,python
0,20,20,2,42,0.476,22,0.524,6,2,0.75,0,0,25,17,9,17,16,0.214,0.405,0.381,17.564,14,python
0,15,25,5,45,0.333,20,0.444,2,2,0.5,3,4,31,14,7,12,26,0.156,0.267,0.578,17.58,15,python
0,16,25,5,46,0.348,21,0.457,3,1,0.75,1,4,33,13,7,10,29,0.152,0.217,0.63,17.517,16,python
0,21,19,5,45,0.467,26,0.578,2,0,1.0,0,1,27,18,9,16,20,0.2,0.356,0.444,17.517,17,python
0,22,16,5,43,0.512,27,0.628,3,2,0.6,3,2,25,18,11,13,19,0.256,0.302,0.442,17.47,18,python
0,16,21,9,46,0.348,25,0.543,5,1,0.833,3,5,29,17,11,16,19,0.239,0.348,0.413,17.468,19,python
0,18,22,5,45,0.4,23,0.511,3,3,0.5,4,1,26,19,9,13,23,0.2,0.289,0.511,17.452,20,python
0,18,20,7,45,0.4,25,0.556,1,1,0.5,4,1,27,18,7,14,24,0.156,0.311,0.533,17.43,21,python
0,13,28,4,45,0.289,17,0.378,2,4,0.333,3,2,30,15,6,18,21,0.133,0.4,0.467,17.451,22,python
0,20,25,2,47,0.426,22,0.468,0,5,0.0,3,1,21,26,10,18,19,0.213,0.383,0.404,17.42,23,python
0,19,22,5,46,0.413,24,0.522,2,1,0.667,2,1,28,18,8,14,24,0.174,0.304,0.522,17.436,24,python
0,20,17,5,42,0.476,25,0.595,1,1,0.5,1,2,20,22,13,14,15,0.31,0.333,0.357,17.466,25,python
0,21,22,3,46,0.457,24,0.522,3,0,1.0,3,5,26,20,10,13,23,0.217,0.283,0.5,17.455,26,python
0,25,16,4,45,0.556,29,0.644,4,3,0.571,2,2,27,18,13,13,19,0.289,0.289,0.422,17.456,27,python
0,21,19,6,46,0.457,27,0.587,1,1,0.5,5,0,32,14,5,19,22,0.109,0.413,0.478,17.488,28,python
0,23,18,4,45,0.511,27,0.6,4,3,0.571,4,1,28,17,11,14,20,0.244,0.311,0.444,17.485,29,python
0,17,22,6,45,0.378,23,0.511,2,2,0.5,2,1,25,20,8,17,20,0.178,0.378,0.444,17.52,30,python
0,15,24,7,46,0.326,22,0.478,1,3,0.25,4,1,25,21,4,16,26,0.087,0.348,0.565,17.5,31,python
0,17,21,6,44,0.386,23,0.523,3,2,0.6,2,3,25,19,9,15,20,0.205,0.341,0.455,17.513,32,python
0,19,25,1,45,0.422,20,0.444,3,1,0.75,3,2,29,16,8,16,21,0.178,0.356,0.467,17.515,33,python
0,19,21,5,45,0.422,24,0.533,4,2,0.667,4,2,30,15,10,15,20,0.222,0.333,0.444,17.504,34,python
0,24,19,3,46,0.522,27,0.587,7,1,0.875,3,0,28,18,10,13,23,0.217,0.283,0.5,17.497,35,python
0,18,23,3,44,0.409,21,0.477,3,2,0.6,2,1,26,18,8,18,18,0.182,0.409,0.409,17.501,36,python
0,21,21,3,45,0.467,24,0.533,1,2,0.333,1,2,27,18,12,13,20,0.267,0.289,0.444,17.497,37,python
0,17,24,6,47,0.362,23,0.489,3,2,0.6,1,2,29,18,11,13,23,0.234,0.277,0.489,17.508,38,python
0,26,13,7,46,0.565,33,0.717,6,2,0.75,5,2,23,23,11,21,14,0.239,0.457,0.304,17.519,39,python
0,20,21,7,48,0.417,27,0.562,2,4,0.333,2,0,27,21,9,19,20,0.188,0.396,0.417,17.52,40,python
0,18,18,8,44,0.409,26,0.591,2,4,0.333,2,1,29,15,8,16,20,0.182,0.364,0.455,17.527,41,python
0,22,21,1,44,0.5,23,0.523,3,2,0.6,4,1,24,20,13,11,20,0.295,0.25,0.455,17.538,42,python
0,22,20,3,45,0.489,25,0.556,5,3,0.625,2,1,30,15,10,11,24,0.222,0.244,0.533,17.525,43,python
0,17,27,1,45,0.378,18,0.4,2,2,0.5,2,5,26,19,11,12,22,0.244,0.267,0.489,17.516,44,python
0,25,18,1,44,0.568,26,0.591,1,3,0.25,4,1,28,16,10,13,21,0.227,0.295,0.477,17.52,45,python
0,20,20,5,45,0.444,25,0.556,6,2,0.75,2,2,31,14,6,15,24,0.133,0.333,0.533,17.529,46,python
0,14,28,1,43,0.326,15,0.349,1,3,0.25,1,1,23,20,7,19,17,0.163,0.442,0.395,17.537,47,python
0,18,20,7,45,0.4,25,0.556,2,2,0.5,2,5,24,21,15,10,20,0.333,0.222,0.444,17.546,48,python
0,18,24,3,45,0.4,21,0.467,3,2,0.6,1,2,24,21,10,18,17,0.222,0.4,0.378,17.551,49,python
0,19,21,7,47,0.404,26,0.553,1,3,0.25,0,2,31,16,9,18,20,0.191,0.383,0.426,17.561,50,python
0,18,19,8,45,0.4,26,0.578,2,0,1.0,2,1,26,19,9,12,24,0.2,0.267,0.533,17.567,51,python
0,20,24,0,44,0.455,20,0.455,3,2,0.6,2,0,25,19,12,12,20,0.273,0.273,0.455,17.556,52,python
0,20,18,6,44,0.455,26,0.591,4,3,0.571,2,0,30,14,12,12,20,0.273,0.273,0.455,17.549,53,python
0,19,22,4,45,0.422,23,0.511,3,2,0.6,4,2,23,22,11,16,18,0.244,0.356,0.4,17.556,54,python
0,19,25,3,47,0.404,22,0.468,4,2,0.667,3,2,25,22,12,16,19,0.255,0.34,0.404,17.556,55,python
0,22,19,5,46,0.478,27,0.587,4,0,1.0,4,4,27,19,13,10,23,0.283,0.217,0.5,17.546,56,python
0,24,18,5,47,0.511,29,0.617,5,1,0.833,4,5,29,18,12,12,23,0.255,0.255,0.489,17.547,57,python
0,15,24,6,45,0.333,21,0.467,3,2,0.6,2,3,27,18,9,16,20,0.2,0.356,0.444,17.556,58,python
0,21,23,1,45,0.467,22,0.489,3,3,0.5,4,3,23,22,10,14,21,0.222,0.311,0.467,17.549,59,python
0,24,17,7,48,0.5,31,0.646,2,0,1.0,3,2,33,15,14,15,19,0.292,0.312,0.396,17.551,60,python
0,18,24,4,46,0.391,22,0.478,5,3,0.625,3,4,33,13,10,10,26,0.217,0.217,0.565,17.548,61,python
0,16,27,7,50,0.32,23,0.46,2,3,0.4,1,2,27,23,9,22,19,0.18,0.44,0.38,17.565,62,python
0,21,21,2,44,0.477,23,0.523,6,3,0.667,2,6,30,14,12,12,20,0.273,0.273,0.455,17.562,63,python
0,20,20,6,46,0.435,26,0.565,5,0,1.0,2,0,22,24,11,17,18,0.239,0.37,0.391,17.569,64,python
0,16,25,5,46,0.348,21,0.457,1,1,0.5,2,2,31,15,10,11,25,0.217,0.239,0.543,17.559,65,python
0,20,23,4,47,0.426,24,0.511,1,5,0.167,3,2,33,14,11,10,26,0.234,0.213,0.553,17.556,66,python
0,20,26,3,49,0.408,23,0.469,2,2,0.5,2,2,27,22,11,16,22,0.224,0.327,0.449,17.549,67,python
0,16,23,6,45,0.356,22,0.489,1,3,0.25,3,0,29,16,7,13,25,0.156,0.289,0.556,17.547,68,python
0,20,19,6,45,0.444,26,0.578,1,3,0.25,2,4,29,16,9,16,20,0.2,0.356,0.444,17.555,69,python
0,26,17,1,44,0.591,27,0.614,4,1,0.8,2,1,23,21,10,19,15,0.227,0.432,0.341,17.562,70,python
0,19,25,2,46,0.413,21,0.457,3,2,0.6,2,1,28,18,10,13,23,0.217,0.283,0.5,17.563,71,python
0,20,22,3,45,0.444,23,0.511,1,1,0.5,2,1,26,19,12,12,21,0.267,0.267,0.467,17.558,72,python
0,21,19,3,43,0.488,24,0.558,2,2,0.5,1,1,30,13,11,13,19,0.256,0.302,0.442,17.562,73,python
0,17,20,8,45,0.378,25,0.556,2,3,0.4,2,2,27,18,9,14,22,0.2,0.311,0.489,17.566,74,python
0,17,18,9,44,0.386,26,0.591,2,1,0.667,0,1,29,15,10,18,16,0.227,0.409,0.364,17.571,75,python
0,20,22,3,45,0.444,23,0.511,3,2,0.6,3,3,27,18,10,16,19,0.222,0.356,0.422,17.572,76,python
0,22,21,3,46,0.478,25,0.543,3,4,0.429,1,0,22,24,13,17,16,0.283,0.37,0.348,17.577,77,python
0,24,19,2,45,0.533,26,0.578,5,3,0.625,3,2,29,16,12,14,19,0.267,0.311,0.422,17.581,78,python
0,22,19,4,45,0.489,26,0.578,4,1,0.8,0,3,27,18,13,15,17,0.289,0.333,0.378,17.585,79,python
0,25,17,3,45,0.556,28,0.622,3,2,0.6,5,2,27,18,15,9,21,0.333,0.2,0.467,17.578,80,python
0,16,24,4,44,0.364,20,0.455,3,1,0.75,3,1,27,17,8,15,21,0.182,0.341,0.477,17.576,81,python
0,19,21,3,43,0.442,22,0.512,4,1,0.8,1,1,27,16,11,12,20,0.256,0.279,0.465,17.569,82,python
0,20,26,1,47,0.426,21,0.447,0,3,0.0,7,3,22,25,6,16,25,0.128,0.34,0.532,17.56,83,python
0,15,27,5,47,0.319,20,0.426,3,1,0.75,1,3,32,15,7,13,27,0.149,0.277,0.574,17.559,84,python
0,18,23,5,46,0.391,23,0.5,0,1,0.0,5,2,28,18,7,15,24,0.152,0.326,0.522,17.548,85,python
0,16,22,6,44,0.364,22,0.5,2,1,0.667,0,2,26,18,9,14,21,0.205,0.318,0.477,17.556,86,python
0,17,24,6,47,0.362,23,0.489,1,2,0.333,6,4,24,23,6,14,27,0.128,0.298,0.574,17.544,87,python
0,20,21,4,45,0.444,24,0.533,5,3,0.625,2,2,24,21,6,18,21,0.133,0.4,0.467,17.547,88,python
0,20,22,3,45,0.444,23,0.511,4,5,0.444,2,3,29,16,9,12,24,0.2,0.267,0.533,17.553,89,python
0,21,20,2,43,0.488,23,0.535,4,3,0.571,1,2,22,21,16,9,18,0.372,0.209,0.419,17.555,90,python
0,18,23,3,44,0.409,21,0.477,2,1,0.667,3,2,29,15,6,13,25,0.136,0.295,0.568,17.556,91,python
0,18,21,6,45,0.4,24,0.533,3,4,0.429,2,1,28,17,12,10,23,0.267,0.222,0.511,17.558,92,python
0,16,27,3,46,0.348,19,0.413,2,3,0.4,4,4,34,12,9,9,28,0.196,0.196,0.609,17.56,93,python
0,20,23,5,48,0.417,25,0.521,7,2,0.778,1,3,24,24,10,20,18,0.208,0.417,0.375,17.568,94,python
0,18,23,4,45,0.4,22,0.489,2,2,0.5,3,2,33,12,6,16,23,0.133,0.356,0.511,17.567,95,python
0,18,24,4,46,0.391,22,0.478,6,4,0.6,2,2,30,16,6,16,24,0.13,0.348,0.522,17.572,96,python
0,21,15,8,44,0.477,29,0.659,4,0,1.0,2,3,28,16,15,11,18,0.341,0.25,0.409,17.957,1,python
0,23,19,4,46,0.5,27,0.587,3,2,0.6,1,2,32,14,14,12,20,0.304,0.261,0.435,17.923,2,python
0,18,22,4,44,0.409,22,0.5,2,2,0.5,2,2,28,16,7,13,24,0.159,0.295,0.545,17.699,3,python
0,21,19,7,47,0.447,28,0.596,2,2,0.5,3,4,22,25,15,14,18,0.319,0.298,0.383,17.722,4,python
0,18,20,6,44,0.409,24,0.545,2,2,0.5,2,3,31,13,11,13,20,0.25,0.295,0.455,17.721,5,python
0,18,23,4,45,0.4,22,0.489,3,4,0.429,2,4,29,16,13,9,23,0.289,0.2,0.511,17.745,6,python
0,22,21,3,46,0.478,25,0.543,2,1,0.667,4,2,33,13,10,11,25,0.217,0.239,0.543,17.707,7,python
0,27,14,7,48,0.562,34,0.708,4,1,0.8,4,1,21,27,21,10,17,0.438,0.208,0.354,17.612,8,python
0,15,25,5,45,0.333,20,0.444,4,0,1.0,0,5,27,18,8,14,23,0.178,0.311,0.511,17.647,9,python
0,17,24,6,47,0.362,23,0.489,3,1,0.75,1,2,32,15,10,14,23,0.213,0.298,0.489,17.66,10,python
0,24,22,2,48,0.5,26,0.542,2,0,1.0,5,1,28,20,11,16,21,0.229,0.333,0.438,17.654,11,python
0,18,26,2,46,0.391,20,0.435,4,0,1.0,3,4,31,15,7,10,29,0.152,0.217,0.63,17.57,12,python
0,17,22,6,45,0.378,23,0.511,3,3,0.5,1,5,23,22,11,19,15,0.244,0.422,0.333,17.608,13,python
0,15,27,3,45,0.333,18,0.4,4,4,0.5,1,1,28,17,8,15,22,0.178,0.333,0.489,17.64,14,python
0,23,22,3,48,0.479,26,0.542,5,2,0.714,1,0,23,25,15,19,14,0.312,0.396,0.292,17.68,15,python
0,16,28,2,46,0.348,18,0.391,1,4,0.2,3,3,24,22,7,15,24,0.152,0.326,0.522,17.621,16,python
0,15,25,4,44,0.341,19,0.432,2,5,0.286,1,3,31,13,9,14,21,0.205,0.318,0.477,17.64,17,python
0,25,16,6,47,0.532,31,0.66,3,2,0.6,4,1,28,19,13,16,18,0.277,0.34,0.383,17.658,18,python
0,19,26,3,48,0.396,22,0.458,2,4,0.333,2,0,26,22,11,20,17,0.229,0.417,0.354,17.683,19,python
0,17,24,4,45,0.378,21,0.467,3,1,0.75,3,2,25,20,10,14,21,0.222,0.311,0.467,17.614,20,python
0,17,22,5,44,0.386,22,0.5,2,2,0.5,3,2,27,17,8,14,22,0.182,0.318,0.5,17.636,21,python
0,15,25,4,44,0.341,19,0.432,1,6,0.143,0,1,27,17,7,15,22,0.159,0.341,0.5,17.67,22,python
0,23,21,5,49,0.469,28,0.571,9,0,1.0,2,1,31,18,16,13,20,0.327,0.265,0.408,17.667,23,python
0,16,25,3,44,0.364,19,0.432,4,1,0.8,1,3,31,13,7,16,21,0.159,0.364,0.477,17.685,24,python
0,26,22,0,48,0.542,26,0.542,6,1,0.857,1,5,32,16,14,12,22,0.292,0.25,0.458,17.682,25,python
0,22,24,1,47,0.468,23,0.489,4,2,0.667,2,1,27,20,13,13,21,0.277,0.277,0.447,17.672,26,python
0,18,21,5,44,0.409,23,0.523,2,4,0.333,1,2,26,18,12,12,20,0.273,0.273,0.455,17.66,27,python
0,13,29,4,46,0.283,17,0.37,4,4,0.5,0,3,30,16,7,12,27,0.152,0.261,0.587,17.676,28,python
0,20,25,1,46,0.435,21,0.457,2,4,0.333,2,0,21,25,12,15,19,0.261,0.326,0.413,17.669,29,python
0,15,26,3,44,0.341,18,0.409,2,5,0.286,0,0,25,19,10,14,20,0.227,0.318,0.455,17.667,30,python
0,18,21,5,44,0.409,23,0.523,4,1,0.8,2,4,30,14,12,10,22,0.273,0.227,0.5,17.65,31,python
0,25,22,2,49,0.51,27,0.551,4,1,0.8,2,3,28,21,16,16,17,0.327,0.327,0.347,17.656,32,python
0,18,23,4,45,0.4,22,0.489,8,3,0.727,2,3,28,17,11,8,26,0.244,0.178,0.578,17.656,33,python
0,21,20,4,45,0.467,25,0.556,3,1,0.75,2,2,26,19,10,16,19,0.222,0.356,0.422,17.631,34,python
0,21,20,3,44,0.477,24,0.545,2,3,0.4,0,3,31,13,14,8,22,0.318,0.182,0.5,17.643,35,python
0,23,22,2,47,0.489,25,0.532,2,2,0.5,2,1,29,18,13,19,15,0.277,0.404,0.319,17.655,36,python
0,22,19,5,46,0.478,27,0.587,5,1,0.833,3,2,26,20,13,10,23,0.283,0.217,0.5,17.643,37,python
0,21,21,6,48,0.438,27,0.562,3,2,0.6,0,0,28,20,11,21,16,0.229,0.438,0.333,17.656,38,python
0,19,23,3,45,0.422,22,0.489,4,4,0.5,1,2,28,17,11,9,25,0.244,0.2,0.556,17.675,39,python
0,18,20,9,47,0.383,27,0.574,5,1,0.833,3,2,31,16,12,14,21,0.255,0.298,0.447,17.673,40,python
0,20,21,4,45,0.444,24,0.533,5,4,0.556,1,0,24,21,15,15,15,0.333,0.333,0.333,17.686,41,python
0,11,28,9,48,0.229,20,0.417,2,4,0.333,1,1,31,17,9,16,23,0.188,0.333,0.479,17.698,42,python
0,16,22,5,43,0.372,21,0.488,2,3,0.4,0,4,27,16,12,14,17,0.279,0.326,0.395,17.703,43,python
0,21,19,4,44,0.477,25,0.568,3,0,1.0,1,1,22,22,14,15,15,0.318,0.341,0.341,17.698,44,python
0,16,22,5,43,0.372,21,0.488,4,1,0.8,2,0,30,13,7,14,22,0.163,0.326,0.512,17.709,45,python
0,20,25,3,48,0.417,23,0.479,5,2,0.714,6,2,29,19,10,14,24,0.208,0.292,0.5,17.68,46,python
0,20,19,5,44,0.455,25,0.568,5,3,0.625,2,2,22,22,10,16,18,0.227,0.364,0.409,17.677,47,python
0,21,19,3,43,0.488,24,0.558,3,3,0.5,4,1,25,18,12,8,23,0.279,0.186,0.535,17.658,48,python
0,18,20,7,45,0.4,25,0.556,1,2,0.333,5,1,26,19,10,16,19,0.222,0.356,0.422,17.641,49,python
0,16,21,9,46,0.348,25,0.543,4,4,0.5,1,2,30,16,7,15,24,0.152,0.326,0.522,17.655,50,python
0,19,22,3,44,0.432,22,0.5,4,3,0.571,0,1,32,12,10,13,21,0.227,0.295,0.477,17.654,51,python
0,15,29,2,46,0.326,17,0.37,2,2,0.5,4,3,29,17,10,13,23,0.217,0.283,0.5,17.635,52,python
0,22,19,4,45,0.489,26,0.578,3,3,0.5,3,3,29,16,12,13,20,0.267,0.289,0.444,17.65,53,python
0,22,22,2,46,0.478,24,0.522,1,1,0.5,4,1,23,23,15,14,17,0.326,0.304,0.37,17.652,54,python
0,24,18,4,46,0.522,28,0.609,1,0,1.0,5,1,29,17,10,13,23,0.217,0.283,0.5,17.646,55,python
0,19,29,2,50,0.38,21,0.42,2,3,0.4,5,4,37,13,8,12,30,0.16,0.24,0.6,17.64,56,python
0,21,22,3,46,0.457,24,0.522,2,4,0.333,2,3,28,18,12,14,20,0.261,0.304,0.435,17.637,57,python
0,17,28,2,47,0.362,19,0.404,2,0,1.0,2,1,25,22,6,19,22,0.128,0.404,0.468,17.637,58,python
0,22,20,3,45,0.489,25,0.556,0,2,0.0,3,1,29,16,12,11,22,0.267,0.244,0.489,17.629,59,python
0,18,23,4,45,0.4,22,0.489,4,1,0.8,2,2,25,20,11,18,16,0.244,0.4,0.356,17.632,60,python
0,16,26,6,48,0.333,22,0.458,1,4,0.2,3,5,35,13,3,18,27,0.062,0.375,0.562,17.639,61,python
0,17,24,3,44,0.386,20,0.455,4,4,0.5,1,3,26,18,8,16,20,0.182,0.364,0.455,17.648,62,python
0,17,26,2,45,0.378,19,0.422,2,4,0.333,1,5,27,18,11,15,19,0.244,0.333,0.422,17.66,63,python
0,12,32,2,46,0.261,14,0.304,0,2,0.0,0,6,30,16,7,17,22,0.152,0.37,0.478,17.666,64,python
0,23,20,2,45,0.511,25,0.556,5,1,0.833,1,3,27,18,17,10,18,0.378,0.222,0.4,17.672,65,python
0,20,18,9,47,0.426,29,0.617,6,1,0.857,0,1,32,15,12,14,21,0.255,0.298,0.447,17.678,66,python
0,21,21,5,47,0.447,26,0.553,7,4,0.636,4,5,26,21,13,13,21,0.277,0.277,0.447,17.68,67,python
0,23,21,4,48,0.479,27,0.562,1,1,0.5,2,2,34,14,13,12,23,0.271,0.25,0.479,17.675,68,python
0,25,21,3,49,0.51,28,0.571,0,1,0.0,2,1,20,29,12,18,19,0.245,0.367,0.388,17.666,69,python
0,18,22,3,43,0.419,21,0.488,2,0,1.0,2,1,27,16,14,10,19,0.326,0.233,0.442,17.665,70,python
0,17,25,2,44,0.386,19,0.432,3,3,0.5,2,2,24,20,9,14,21,0.205,0.318,0.477,17.662,71,python
0,18,22,3,43,0.419,21,0.488,2,3,0.4,1,2,23,20,11,15,17,0.256,0.349,0.395,17.665,72,python
0,16,26,3,45,0.356,19,0.422,1,4,0.2,3,2,27,18,8,14,23,0.178,0.311,0.511,17.661,73,python
0,18,23,5,46,0.391,23,0.5,5,3,0.625,1,2,29,17,9,16,21,0.196,0.348,0.457,17.673,74,python
0,23,14,6,43,0.535,29,0.674,1,2,0.333,2,1,26,17,11,17,15,0.256,0.395,0.349,17.681,75,python
0,18,20,6,44,0.409,24,0.545,3,2,0.6,3,2,30,14,10,11,23,0.227,0.25,0.523,17.685,76,python
0,27,18,2,47,0.574,29,0.617,7,1,0.875,2,3,32,15,14,14,19,0.298,0.298,0.404,17.686,77,python
0,21,20,5,46,0.457,26,0.565,5,2,0.714,0,1,26,20,10,18,18,0.217,0.391,0.391,17.688,78,python
0,28,19,3,50,0.56,31,0.62,4,1,0.8,2,1,30,20,16,16,18,0.32,0.32,0.36,17.694,79,python
0,20,18,4,42,0.476,24,0.571,3,2,0.6,1,3,29,13,10,14,18,0.238,0.333,0.429,17.698,80,python
0,19,19,9,47,0.404,28,0.596,2,3,0.4,1,2,26,21,9,19,19,0.191,0.404,0.404,17.706,81,python
0,21,21,3,45,0.467,24,0.533,6,2,0.75,2,4,24,21,10,18,17,0.222,0.4,0.378,17.707,82,python
0,16,27,2,45,0.356,18,0.4,2,6,0.25,2,3,29,16,7,11,27,0.156,0.244,0.6,17.706,83,python
0,20,23,3,46,0.435,23,0.5,5,3,0.625,4,2,25,21,10,12,24,0.217,0.261,0.522,17.702,84,python
0,29,17,1,47,0.617,30,0.638,8,2,0.8,1,1,26,21,20,13,14,0.426,0.277,0.298,17.701,85,python
0,17,23,5,45,0.378,22,0.489,3,0,1.0,1,3,30,15,11,12,22,0.244,0.267,0.489,17.706,86,python
0,19,23,3,45,0.422,22,0.489,3,4,0.429,3,4,29,16,11,11,23,0.244,0.244,0.511,17.705,87,python
0,21,21,1,43,0.488,22,0.512,3,3,0.5,1,1,29,14,12,11,20,0.279,0.256,0.465,17.708,88,python
0,20,25,1,46,0.435,21,0.457,5,3,0.625,0,6,31,15,10,13,23,0.217,0.283,0.5,17.712,89,python
0,19,22,4,45,0.422,23,0.511,2,6,0.25,3,3,26,19,12,6,27,0.267,0.133,0.6,17.712,90,python
0,16,27,2,45,0.356,18,0.4,1,3,0.25,1,4,27,18,9,15,21,0.2,0.333,0.467,17.715,91,python
0,24,19,3,46,0.522,27,0.587,6,3,0.667,4,2,26,20,15,16,15,0.326,0.348,0.326,17.719,92,python
0,22,23,4,49,0.449,26,0.531,1,3,0.25,3,2,30,19,9,18,22,0.184,0.367,0.449,17.719,93,python
0,20,21,3,44,0.455,23,0.523,3,3,0.5,4,1,24,20,12,15,17,0.273,0.341,0.386,17.718,94,python
0,24,19,4,47,0.511,28,0.596,4,4,0.5,3,1,26,21,11,20,16,0.234,0.426,0.34,17.719,95,python
0,18,26,6,50,0.36,24,0.48,4,3,0.571,2,2,29,21,11,15,24,0.22,0.3,0.48,17.72,96,python
0,19,21,2,42,0.452,21,0.5,3,3,0.5,2,1,25,17,12,14,16,0.286,0.333,0.381,18.148,1,python
0,20,21,4,45,0.444,24,0.533,4,2,0.667,1,3,25,20,10,14,21,0.222,0.311,0.467,17.667,2,python
0,20,21,5,46,0.435,25,0.543,4,2,0.667,3,2,29,17,11,13,22,0.239,0.283,0.478,17.667,3,python
0,27,16,2,45,0.6,29,0.644,6,1,0.857,3,3,23,22,12,11,22,0.267,0.244,0.489,17.556,4,python
0,21,22,1,44,0.477,22,0.5,2,1,0.667,2,3,29,15,13,11,20,0.295,0.25,0.455,17.607,5,python
0,26,18,3,47,0.553,29,0.617,1,1,0.5,3,2,28,19,14,14,19,0.298,0.298,0.404,17.624,6,python
0,20,23,4,47,0.426,24,0.511,3,1,0.75,2,4,28,19,10,12,25,0.213,0.255,0.532,17.675,7,python
0,15,26,4,45,0.333,19,0.422,1,1,0.5,2,5,27,18,10,13,22,0.222,0.289,0.489,17.716,8,python
0,19,18,6,43,0.442,25,0.581,0,2,0.0,2,1,27,16,8,17,18,0.186,0.395,0.419,17.713,9,python
0,20,18,6,44,0.455,26,0.591,5,2,0.714,2,1,28,16,8,14,22,0.182,0.318,0.5,17.711,10,python
0,28,16,2,46,0.609,30,0.652,5,1,0.833,3,0,30,16,17,11,18,0.37,0.239,0.391,17.721,11,python
0,20,24,3,47,0.426,23,0.489,6,3,0.667,1,2,23,24,10,17,20,0.213,0.362,0.426,17.746,12,python
0,20,20,4,44,0.455,24,0.545,1,1,0.5,1,2,29,15,11,13,20,0.25,0.295,0.455,17.751,13,python
0,20,20,3,43,0.465,23,0.535,4,3,0.571,1,1,22,21,13,14,16,0.302,0.326,0.372,17.733,14,python
0,24,16,4,44,0.545,28,0.636,3,0,1.0,3,0,28,16,13,11,20,0.295,0.25,0.455,17.735,15,python
0,20,23,4,47,0.426,24,0.511,3,3,0.5,4,1,26,21,7,15,25,0.149,0.319,0.532,17.684,16,python
0,16,22,5,43,0.372,21,0.488,2,1,0.667,2,0,31,12,6,15,22,0.14,0.349,0.512,17.717,17,python
0,17,21,6,44,0.386,23,0.523,4,2,0.667,2,1,21,23,10,18,16,0.227,0.409,0.364,17.717,18,python
0,19,23,4,46,0.413,23,0.5,1,2,0.333,1,2,31,15,7,16,23,0.152,0.348,0.5,17.734,19,python
0,17,25,4,46,0.37,21,0.457,1,2,0.333,3,2,29,17,9,16,21,0.196,0.348,0.457,17.741,20,python
0,23,19,3,45,0.511,26,0.578,7,1,0.875,2,1,29,16,7,16,22,0.156,0.356,0.489,17.712,21,python
0,22,17,6,45,0.489,28,0.622,3,2,0.6,1,1,29,16,14,12,19,0.311,0.267,0.422,17.702,22,python
0,18,23,4,45,0.4,22,0.489,4,2,0.667,0,4,29,16,10,12,23,0.222,0.267,0.511,17.717,23,python
0,14,26,8,48,0.292,22,0.458,2,3,0.4,1,3,30,18,9,17,22,0.188,0.354,0.458,17.719,24,python
0,20,18,5,43,0.465,25,0.581,5,0,1.0,1,1,26,17,13,11,19,0.302,0.256,0.442,17.737,25,python
0,22,18,5,45,0.489,27,0.6,5,3,0.625,2,3,25,20,11,16,18,0.244,0.356,0.4,17.742,26,python
0,20,23,3,46,0.435,23,0.5,2,3,0.4,1,2,28,18,14,12,20,0.304,0.261,0.435,17.746,27,python
0,21,20,7,48,0.438,28,0.583,0,0,0,3,0,23,25,12,19,17,0.25,0.396,0.354,17.726,28,python
0,18,24,3,45,0.4,21,0.467,3,6,0.333,1,3,26,19,11,14,20,0.244,0.311,0.444,17.744,29,python
0,16,28,6,50,0.32,22,0.44,5,2,0.714,1,1,31,19,9,15,26,0.18,0.3,0.52,17.757,30,python
0,20,22,2,44,0.455,22,0.5,2,3,0.4,1,4,24,20,14,10,20,0.318,0.227,0.455,17.722,31,python
0,20,25,3,48,0.417,23,0.479,1,1,0.5,4,2,30,18,8,15,25,0.167,0.312,0.521,17.686,32,python
0,21,21,3,45,0.467,24,0.533,5,1,0.833,1,3,29,16,13,11,21,0.289,0.244,0.467,17.691,33,python
0,19,21,6,46,0.413,25,0.543,3,3,0.5,2,3,31,15,12,15,19,0.261,0.326,0.413,17.702,34,python
0,16,22,6,44,0.364,22,0.5,2,3,0.4,4,3,27,17,8,16,20,0.182,0.364,0.455,17.702,35,python
0,20,20,6,46,0.435,26,0.565,2,6,0.25,1,1,22,24,15,16,15,0.326,0.348,0.326,17.707,36,python
0,15,24,5,44,0.341,20,0.455,1,6,0.143,1,5,29,15,8,17,19,0.182,0.386,0.432,17.719,37,python
0,23,17,5,45,0.511,28,0.622,6,3,0.667,3,1,28,17,10,17,18,0.222,0.378,0.4,17.728,38,python
0,25,19,4,48,0.521,29,0.604,3,4,0.429,4,2,24,24,9,19,20,0.188,0.396,0.417,17.715,39,python
0,19,19,6,44,0.432,25,0.568,6,1,0.857,1,2,27,17,14,12,18,0.318,0.273,0.409,17.737,40,python
0,18,21,7,46,0.391,25,0.543,2,0,1.0,3,2,25,21,12,17,17,0.261,0.37,0.37,17.739,41,python
0,16,27,1,44,0.364,17,0.386,5,4,0.556,2,5,33,11,9,9,26,0.205,0.205,0.591,17.74,42,python
0,17,25,3,45,0.378,20,0.444,1,4,0.2,4,1,26,19,7,15,23,0.156,0.333,0.511,17.742,43,python
0,22,22,1,45,0.489,23,0.511,4,1,0.8,0,2,26,19,11,16,18,0.244,0.356,0.4,17.742,44,python
0,22,21,2,45,0.489,24,0.533,3,0,1.0,3,5,31,14,10,12,23,0.222,0.267,0.511,17.704,45,python
0,27,19,0,46,0.587,27,0.587,5,3,0.625,5,1,28,18,14,13,19,0.304,0.283,0.413,17.662,46,python
0,15,26,4,45,0.333,19,0.422,7,1,0.875,1,3,26,19,9,13,23,0.2,0.289,0.511,17.654,47,python
0,20,20,5,45,0.444,25,0.556,4,2,0.667,2,2,22,23,10,19,16,0.222,0.422,0.356,17.659,48,python
0,23,18,5,46,0.5,28,0.609,5,2,0.714,4,2,27,19,9,14,23,0.196,0.304,0.5,17.656,49,python
0,18,25,4,47,0.383,22,0.468,1,6,0.143,3,2,29,18,8,17,22,0.17,0.362,0.468,17.665,50,python
0,23,21,3,47,0.489,26,0.553,4,1,0.8,3,6,32,15,15,10,22,0.319,0.213,0.468,17.663,51,python
0,25,18,2,45,0.556,27,0.6,5,1,0.833,1,2,27,18,16,8,21,0.356,0.178,0.467,17.654,52,python
0,17,24,5,46,0.37,22,0.478,0,4,0.0,5,4,26,20,7,17,22,0.152,0.37,0.478,17.645,53,python
0,23,18,4,45,0.511,27,0.6,2,0,1.0,3,4,25,20,15,12,18,0.333,0.267,0.4,17.651,54,python
0,17,26,5,48,0.354,22,0.458,3,3,0.5,4,0,26,22,7,19,22,0.146,0.396,0.458,17.646,55,python
0,26,22,2,50,0.52,28,0.56,4,0,1.0,4,2,35,15,12,8,30,0.24,0.16,0.6,17.645,56,python
0,22,24,3,49,0.449,25,0.51,1,2,0.333,1,3,33,16,14,11,24,0.286,0.224,0.49,17.637,57,python
0,21,20,5,46,0.457,26,0.565,3,3,0.5,3,3,28,18,11,12,23,0.239,0.261,0.5,17.64,58,python
0,20,18,8,46,0.435,28,0.609,3,2,0.6,1,1,21,25,11,21,14,0.239,0.457,0.304,17.648,59,python
0,12,32,2,46,0.261,14,0.304,1,1,0.5,1,5,35,11,6,13,27,0.13,0.283,0.587,17.654,60,python
0,22,18,3,43,0.512,25,0.581,3,1,0.75,2,3,27,16,12,13,18,0.279,0.302,0.419,17.654,61,python
0,22,21,3,46,0.478,25,0.543,7,2,0.778,2,2,31,15,12,12,22,0.261,0.261,0.478,17.664,62,python
0,19,20,8,47,0.404,27,0.574,2,4,0.333,1,3,25,22,8,18,21,0.17,0.383,0.447,17.66,63,python
0,23,18,2,43,0.535,25,0.581,4,3,0.571,2,1,30,13,13,10,20,0.302,0.233,0.465,17.654,64,python
0,19,25,0,44,0.432,19,0.432,5,0,1.0,3,4,31,13,10,13,21,0.227,0.295,0.477,17.654,65,python
0,15,26,3,44,0.341,18,0.409,2,2,0.5,3,2,29,15,7,18,19,0.159,0.409,0.432,17.658,66,python
0,26,15,4,45,0.578,30,0.667,7,3,0.7,2,2,26,19,15,12,18,0.333,0.267,0.4,17.665,67,python
0,11,31,4,46,0.239,15,0.326,1,4,0.2,5,3,28,18,4,19,23,0.087,0.413,0.5,17.667,68,python
0,19,21,4,44,0.432,23,0.523,4,1,0.8,3,4,24,20,15,12,17,0.341,0.273,0.386,17.676,69,python
0,21,21,5,47,0.447,26,0.553,4,1,0.8,1,1,37,10,9,13,25,0.191,0.277,0.532,17.664,70,python
0,25,18,2,45,0.556,27,0.6,2,1,0.667,4,2,24,21,12,11,22,0.267,0.244,0.489,17.662,71,python
0,14,27,2,43,0.326,16,0.372,1,2,0.333,2,2,31,12,8,15,20,0.186,0.349,0.465,17.671,72,python
0,23,20,4,47,0.489,27,0.574,1,2,0.333,2,3,30,17,12,9,26,0.255,0.191,0.553,17.658,73,python
0,23,14,7,44,0.523,30,0.682,4,1,0.8,0,1,31,13,10,17,17,0.227,0.386,0.386,17.671,74,python
0,18,24,3,45,0.4,21,0.467,2,4,0.333,2,2,26,19,12,15,18,0.267,0.333,0.4,17.675,75,python
0,21,21,5,47,0.447,26,0.553,3,0,1.0,1,3,25,22,14,12,21,0.298,0.255,0.447,17.685,76,python
0,19,21,4,44,0.432,23,0.523,1,3,0.25,1,3,30,14,9,15,20,0.205,0.341,0.455,17.693,77,python
0,20,19,7,46,0.435,27,0.587,2,4,0.333,3,1,29,17,11,13,22,0.239,0.283,0.478,17.683,78,python
0,17,22,6,45,0.378,23,0.511,2,1,0.667,1,4,31,14,13,13,19,0.289,0.289,0.422,17.685,79,python
0,19,25,3,47,0.404,22,0.468,4,2,0.667,3,3,30,17,7,11,29,0.149,0.234,0.617,17.67,80,python
0,17,23,5,45,0.378,22,0.489,2,2,0.5,3,2,29,16,9,11,25,0.2,0.244,0.556,17.675,81,python
0,19,17,8,44,0.432,27,0.614,4,0,1.0,2,1,24,20,11,18,15,0.25,0.409,0.341,17.682,82,python
0,15,25,5,45,0.333,20,0.444,1,4,0.2,1,2,26,19,8,19,18,0.178,0.422,0.4,17.683,83,python
0,19,21,4,44,0.432,23,0.523,3,1,0.75,4,2,26,18,9,17,18,0.205,0.386,0.409,17.681,84,python
0,20,23,2,45,0.444,22,0.489,6,2,0.75,2,2,28,17,12,11,22,0.267,0.244,0.489,17.675,85,python
0,22,21,3,46,0.478,25,0.543,2,2,0.5,3,3,29,17,7,13,26,0.152,0.283,0.565,17.67,86,python
0,23,22,1,46,0.5,24,0.522,3,3,0.5,3,2,30,16,9,14,23,0.196,0.304,0.5,17.665,87,python
0,14,25,6,45,0.311,20,0.444,1,2,0.333,1,5,30,15,9,17,19,0.2,0.378,0.422,17.659,88,python
0,16,26,2,44,0.364,18,0.409,5,4,0.556,2,0,29,15,6,13,25,0.136,0.295,0.568,17.653,89,python
0,21,19,6,46,0.457,27,0.587,2,0,1.0,1,2,29,17,11,14,21,0.239,0.304,0.457,17.657,90,python
0,16,25,2,43,0.372,18,0.419,2,2,0.5,0,1,30,13,11,14,18,0.256,0.326,0.419,17.665,91,python
0,21,22,4,47,0.447,25,0.532,3,1,0.75,0,3,26,21,13,18,16,0.277,0.383,0.34,17.663,92,python
0,22,19,6,47,0.468,28,0.596,1,5,0.167,2,1,29,18,12,14,21,0.255,0.298,0.447,17.661,93,python
0,15,27,5,47,0.319,20,0.426,1,4,0.2,2,0,26,21,6,17,24,0.128,0.362,0.511,17.659,94,python
0,16,22,8,46,0.348,24,0.522,4,4,0.5,3,4,28,18,10,15,21,0.217,0.326,0.457,17.656,95,python
0,18,23,3,44,0.409,21,0.477,1,2,0.333,1,4,30,14,12,8,24,0.273,0.182,0.545,17.651,96,python
0,17,28,2,47,0.362,19,0.404,3,2,0.6,1,4,28,19,10,18,19,0.213,0.383,0.404,17.654,1,python
0,19,24,2,45,0.422,21,0.467,5,1,0.833,0,6,25,20,11,13,21,0.244,0.289,0.467,17.667,2,python
0,17,26,3,46,0.37,20,0.435,3,3,0.5,0,2,28,18,12,16,18,0.261,0.348,0.391,17.886,3,python
0,17,25,4,46,0.37,21,0.457,3,2,0.6,2,4,29,17,11,14,21,0.239,0.304,0.457,17.917,4,python
0,25,17,3,45,0.556,28,0.622,1,2,0.333,1,3,31,14,13,10,22,0.289,0.222,0.489,17.858,5,python
0,20,19,6,45,0.444,26,0.578,3,4,0.429,3,0,23,22,12,18,15,0.267,0.4,0.333,17.97,6,python
0,19,23,2,44,0.432,21,0.477,3,2,0.6,3,1,23,21,9,17,18,0.205,0.386,0.409,18.01,7,python
0,19,20,5,44,0.432,24,0.545,2,5,0.286,4,2,26,18,11,10,23,0.25,0.227,0.523,17.858,8,python
0,21,19,8,48,0.438,29,0.604,5,2,0.714,1,1,29,19,8,20,20,0.167,0.417,0.417,17.849,9,python
0,19,28,0,47,0.404,19,0.404,5,3,0.625,2,2,26,21,12,14,21,0.255,0.298,0.447,17.816,10,python
0,21,20,5,46,0.457,26,0.565,2,0,1.0,3,2,27,19,9,17,20,0.196,0.37,0.435,17.855,11,python
0,23,23,1,47,0.489,24,0.511,5,5,0.5,3,2,29,18,13,14,20,0.277,0.298,0.426,17.815,12,python
0,24,20,1,45,0.533,25,0.556,3,2,0.6,2,2,25,20,16,10,19,0.356,0.222,0.422,17.8,13,python
0,20,23,3,46,0.435,23,0.5,4,4,0.5,0,0,33,13,11,14,21,0.239,0.304,0.457,17.846,14,python
0,15,25,4,44,0.341,19,0.432,3,1,0.75,1,3,27,17,7,17,20,0.159,0.386,0.455,17.801,15,python
0,24,23,1,48,0.5,25,0.521,4,4,0.5,2,2,25,23,19,12,17,0.396,0.25,0.354,17.753,16,python
0,19,21,7,47,0.404,26,0.553,2,0,1.0,3,2,29,18,11,17,19,0.234,0.362,0.404,17.736,17,python
0,20,22,2,44,0.455,22,0.5,2,2,0.5,2,2,26,18,12,13,19,0.273,0.295,0.432,17.701,18,python
0,22,21,2,45,0.489,24,0.533,3,3,0.5,6,2,32,13,10,15,20,0.222,0.333,0.444,17.698,19,python
0,19,19,6,44,0.432,25,0.568,2,1,0.667,1,2,25,19,11,13,20,0.25,0.295,0.455,17.733,20,python
0,19,20,7,46,0.413,26,0.565,1,3,0.25,4,1,30,16,8,18,20,0.174,0.391,0.435,17.75,21,python
0,22,15,6,43,0.512,28,0.651,3,1,0.75,2,2,21,22,15,14,14,0.349,0.326,0.326,17.748,22,python
0,18,22,6,46,0.391,24,0.522,1,3,0.25,2,1,31,15,10,15,21,0.217,0.326,0.457,17.748,23,python
0,21,22,3,46,0.457,24,0.522,3,0,1.0,0,4,33,13,8,14,24,0.174,0.304,0.522,17.758,24,python
0,17,24,4,45,0.378,21,0.467,1,1,0.5,1,5,26,19,9,17,19,0.2,0.378,0.422,17.737,25,python
0,21,21,2,44,0.477,23,0.523,1,3,0.25,0,2,24,20,12,15,17,0.273,0.341,0.386,17.748,26,python
0,18,24,3,45,0.4,21,0.467,1,4,0.2,1,2,27,18,9,15,21,0.2,0.333,0.467,17.766,27,python
0,23,21,0,44,0.523,23,0.523,1,1,0.5,1,2,28,16,15,10,19,0.341,0.227,0.432,17.763,28,python
0,16,27,3,46,0.348,19,0.413,6,1,0.857,1,5,27,19,5,17,24,0.109,0.37,0.522,17.762,29,python
0,21,25,3,49,0.429,24,0.49,4,2,0.667,5,6,30,19,9,16,24,0.184,0.327,0.49,17.741,30,python
0,26,18,3,47,0.553,29,0.617,4,2,0.667,0,1,26,21,18,14,15,0.383,0.298,0.319,17.745,31,python
0,24,17,5,46,0.522,29,0.63,3,3,0.5,2,4,27,19,17,13,16,0.37,0.283,0.348,17.745,32,python
0,16,25,5,46,0.348,21,0.457,7,2,0.778,0,4,31,15,12,12,22,0.261,0.261,0.478,17.738,33,python
0,19,18,5,42,0.452,24,0.571,4,2,0.667,1,3,24,18,13,14,15,0.31,0.333,0.357,17.711,34,python
0,25,17,3,45,0.556,28,0.622,5,1,0.833,2,3,27,18,8,15,22,0.178,0.333,0.489,17.7,35,python
0,19,22,5,46,0.413,24,0.522,1,3,0.25,1,4,27,19,11,13,22,0.239,0.283,0.478,17.714,36,python
0,16,25,5,46,0.348,21,0.457,1,1,0.5,7,2,29,17,5,14,27,0.109,0.304,0.587,17.693,37,python
0,14,29,4,47,0.298,18,0.383,4,4,0.5,4,3,26,21,9,13,25,0.191,0.277,0.532,17.703,38,python
0,17,25,3,45,0.378,20,0.444,3,0,1.0,1,3,27,18,9,15,21,0.2,0.333,0.467,17.694,39,python
0,16,24,4,44,0.364,20,0.455,1,2,0.333,4,3,27,17,9,12,23,0.205,0.273,0.523,17.688,40,python
0,18,20,5,43,0.419,23,0.535,5,2,0.714,3,1,26,17,11,12,20,0.256,0.279,0.465,17.682,41,python
0,17,24,5,46,0.37,22,0.478,3,1,0.75,0,2,28,18,11,18,17,0.239,0.391,0.37,17.696,42,python
0,21,24,4,49,0.429,25,0.51,1,3,0.25,3,3,30,19,12,13,24,0.245,0.265,0.49,17.687,43,python
0,17,23,4,44,0.386,21,0.477,1,2,0.333,2,1,33,11,12,12,20,0.273,0.273,0.455,17.685,44,python
0,19,22,3,44,0.432,22,0.5,3,4,0.429,2,1,27,17,12,13,19,0.273,0.295,0.432,17.687,45,python
0,17,17,10,44,0.386,27,0.614,2,2,0.5,3,1,29,15,6,16,22,0.136,0.364,0.5,17.707,46,python
0,16,22,7,45,0.356,23,0.511,2,2,0.5,0,2,25,20,10,16,19,0.222,0.356,0.422,17.718,47,python
0,19,21,4,44,0.432,23,0.523,4,4,0.5,1,1,26,18,8,17,19,0.182,0.386,0.432,17.725,48,python
0,18,22,4,44,0.409,22,0.5,3,2,0.6,1,4,28,16,11,13,20,0.25,0.295,0.455,17.728,49,python
0,20,24,3,47,0.426,23,0.489,1,4,0.2,2,1,25,22,12,12,23,0.255,0.255,0.489,17.738,50,python
0,13,27,3,43,0.302,16,0.372,1,2,0.333,1,3,25,18,7,15,21,0.163,0.349,0.488,17.739,51,python
0,16,29,2,47,0.34,18,0.383,3,3,0.5,2,2,32,15,8,16,23,0.17,0.34,0.489,17.726,52,python
0,24,17,2,43,0.558,26,0.605,2,1,0.667,3,1,22,21,13,13,17,0.302,0.302,0.395,17.723,53,python
0,20,21,4,45,0.444,24,0.533,4,2,0.667,2,2,30,15,12,10,23,0.267,0.222,0.511,17.722,54,python
0,22,20,5,47,0.468,27,0.574,6,2,0.75,1,1,23,24,11,21,15,0.234,0.447,0.319,17.721,55,python
0,24,16,2,42,0.571,26,0.619,4,0,1.0,2,0,21,21,15,10,17,0.357,0.238,0.405,17.72,56,python
0,14,30,2,46,0.304,16,0.348,3,1,0.75,3,1,32,14,8,14,24,0.174,0.304,0.522,17.717,57,python
0,22,21,3,46,0.478,25,0.543,4,0,1.0,2,2,31,15,10,11,25,0.217,0.239,0.543,17.719,58,python
0,18,23,2,43,0.419,20,0.465,3,2,0.6,1,3,18,25,10,15,18,0.233,0.349,0.419,17.733,59,python
0,20,23,2,45,0.444,22,0.489,2,5,0.286,3,3,32,13,12,13,20,0.267,0.289,0.444,17.736,60,python
0,15,22,12,49,0.306,27,0.551,4,3,0.571,0,1,24,25,9,21,19,0.184,0.429,0.388,17.738,61,python
0,24,17,8,49,0.49,32,0.653,8,3,0.727,4,3,27,22,11,13,25,0.224,0.265,0.51,17.737,62,python
0,19,24,3,46,0.413,22,0.478,3,1,0.75,2,3,31,15,15,7,24,0.326,0.152,0.522,17.738,63,python
0,17,27,5,49,0.347,22,0.449,2,8,0.2,4,3,26,23,8,22,19,0.163,0.449,0.388,17.753,64,python
0,26,14,3,43,0.605,29,0.674,4,1,0.8,3,1,24,19,17,11,15,0.395,0.256,0.349,17.753,65,python
0,24,16,5,45,0.533,29,0.644,5,0,1.0,4,2,19,26,14,13,18,0.311,0.289,0.4,17.737,66,python
0,16,24,3,43,0.372,19,0.442,2,1,0.667,2,1,23,20,7,17,19,0.163,0.395,0.442,17.728,67,python
0,20,20,5,45,0.444,25,0.556,3,1,0.75,3,2,31,14,10,9,26,0.222,0.2,0.578,17.715,68,python
0,21,21,3,45,0.467,24,0.533,5,2,0.714,2,2,27,18,15,12,18,0.333,0.267,0.4,17.723,69,python
0,21,21,3,45,0.467,24,0.533,3,2,0.6,3,1,29,16,10,13,22,0.222,0.289,0.489,17.722,70,python
0,25,16,4,45,0.556,29,0.644,8,2,0.8,1,1,25,20,9,17,19,0.2,0.378,0.422,17.722,71,python
0,29,15,2,46,0.63,31,0.674,6,3,0.667,6,0,23,23,14,11,21,0.304,0.239,0.457,17.705,72,python
0,16,21,7,44,0.364,23,0.523,5,6,0.455,2,0,25,19,8,16,20,0.182,0.364,0.455,17.704,73,python
0,24,16,4,44,0.545,28,0.636,5,1,0.833,4,0,23,21,13,10,21,0.295,0.227,0.477,17.697,74,python
0,19,21,6,46,0.413,25,0.543,1,2,0.333,1,2,26,20,10,22,14,0.217,0.478,0.304,17.711,75,python
0,17,24,4,45,0.378,21,0.467,3,6,0.333,3,2,26,19,9,15,21,0.2,0.333,0.467,17.709,76,python
0,19,21,3,43,0.442,22,0.512,1,2,0.333,2,3,24,19,11,15,17,0.256,0.349,0.395,17.701,77,python
0,20,23,3,46,0.435,23,0.5,2,0,1.0,2,3,33,13,9,10,27,0.196,0.217,0.587,17.689,78,python
0,15,24,7,46,0.326,22,0.478,5,4,0.556,1,1,28,18,7,17,22,0.152,0.37,0.478,17.68,79,python
0,21,21,3,45,0.467,24,0.533,2,1,0.667,2,0,27,18,12,14,19,0.267,0.311,0.422,17.676,80,python
0,27,19,2,48,0.562,29,0.604,4,1,0.8,3,3,30,18,18,10,20,0.375,0.208,0.417,17.668,81,python
0,22,19,4,45,0.489,26,0.578,4,1,0.8,4,2,30,15,10,9,26,0.222,0.2,0.578,17.672,82,python
0,20,22,4,46,0.435,24,0.522,4,1,0.8,2,3,29,17,13,15,18,0.283,0.326,0.391,17.674,83,python
0,21,22,3,46,0.457,24,0.522,5,6,0.455,2,2,27,19,11,14,21,0.239,0.304,0.457,17.684,84,python
0,16,25,2,43,0.372,18,0.419,4,2,0.667,0,2,24,19,9,18,16,0.209,0.419,0.372,17.687,85,python
0,23,21,3,47,0.489,26,0.553,6,1,0.857,0,1,32,15,10,14,23,0.213,0.298,0.489,17.693,86,python
0,20,20,5,45,0.444,25,0.556,5,1,0.833,2,2,24,21,11,15,19,0.244,0.333,0.422,17.693,87,python
0,18,21,8,47,0.383,26,0.553,1,2,0.333,2,3,30,17,9,13,25,0.191,0.277,0.532,17.69,88,python
0,22,19,4,45,0.489,26,0.578,6,3,0.667,2,3,25,20,12,16,17,0.267,0.356,0.378,17.691,89,python
0,18,24,4,46,0.391,22,0.478,2,1,0.667,4,1,34,12,10,16,20,0.217,0.348,0.435,17.687,90,python
0,21,19,5,45,0.467,26,0.578,1,2,0.333,3,2,35,10,8,11,26,0.178,0.244,0.578,17.687,91,python
0,27,19,3,49,0.551,30,0.612,5,4,0.556,4,2,30,19,12,15,22,0.245,0.306,0.449,17.685,92,python
0,16,26,4,46,0.348,20,0.435,4,3,0.571,1,1,23,23,10,17,19,0.217,0.37,0.413,17.684,93,python
0,15,25,7,47,0.319,22,0.468,1,0,1.0,2,2,28,19,8,21,18,0.17,0.447,0.383,17.686,94,python
0,21,21,3,45,0.467,24,0.533,5,3,0.625,0,2,30,15,14,11,20,0.311,0.244,0.444,17.685,95,python
0,21,19,5,45,0.467,26,0.578,2,3,0.4,5,1,23,22,12,15,18,0.267,0.333,0.4,17.686,96,python
0,21,19,6,46,0.457,27,0.587,3,2,0.6,6,3,31,15,8,12,26,0.174,0.261,0.565,17.969,1,python
0,19,21,6,46,0.413,25,0.543,2,1,0.667,1,2,35,11,9,13,24,0.196,0.283,0.522,17.719,2,python
0,24,15,4,43,0.558,28,0.651,2,1,0.667,2,1,25,18,12,15,16,0.279,0.349,0.372,17.824,3,python
0,26,19,2,47,0.553,28,0.596,4,3,0.571,3,2,28,19,12,12,23,0.255,0.255,0.489,17.708,4,python
0,19,18,7,44,0.432,26,0.591,4,1,0.8,2,1,27,17,8,18,18,0.182,0.409,0.409,17.706,5,python
0,18,23,4,45,0.4,22,0.489,2,1,0.667,7,1,30,15,6,16,23,0.133,0.356,0.511,17.638,6,python
0,19,22,3,44,0.432,22,0.5,8,3,0.727,1,4,25,19,13,15,16,0.295,0.341,0.364,17.717,7,python
0,17,23,6,46,0.37,23,0.5,7,0,1.0,0,1,29,17,10,14,22,0.217,0.304,0.478,17.772,8,python
0,21,22,4,47,0.447,25,0.532,5,1,0.833,2,3,16,31,16,20,11,0.34,0.426,0.234,17.771,9,python
0,19,26,2,47,0.404,21,0.447,3,4,0.429,4,3,33,14,7,10,30,0.149,0.213,0.638,17.639,10,python
0,22,21,3,46,0.478,25,0.543,2,5,0.286,2,0,30,16,16,11,19,0.348,0.239,0.413,17.601,11,python
0,21,19,3,43,0.488,24,0.558,3,0,1.0,1,3,22,21,14,14,15,0.326,0.326,0.349,17.575,12,python
0,21,24,4,49,0.429,25,0.51,5,3,0.625,2,4,29,20,12,13,24,0.245,0.265,0.49,17.577,13,python
0,17,21,7,45,0.378,24,0.533,1,2,0.333,2,2,28,17,13,11,21,0.289,0.244,0.467,17.606,14,python
0,22,21,3,46,0.478,25,0.543,2,2,0.5,2,3,31,15,13,10,23,0.283,0.217,0.5,17.671,15,python
0,19,23,2,44,0.432,21,0.477,1,2,0.333,1,0,22,22,15,14,15,0.341,0.318,0.341,17.634,16,python
0,19,22,4,45,0.422,23,0.511,4,5,0.444,3,2,36,9,11,7,27,0.244,0.156,0.6,17.682,17,python
0,23,24,2,49,0.469,25,0.51,3,2,0.6,7,3,34,15,6,15,28,0.122,0.306,0.571,17.636,18,python
0,17,25,4,46,0.37,21,0.457,2,2,0.5,4,2,24,22,6,17,23,0.13,0.37,0.5,17.634,19,python
0,17,24,6,47,0.362,23,0.489,1,3,0.25,4,1,27,20,10,11,26,0.213,0.234,0.553,17.631,20,python
0,18,21,5,44,0.409,23,0.523,3,2,0.6,1,3,29,15,11,14,19,0.25,0.318,0.432,17.667,21,python
0,20,26,2,48,0.417,22,0.458,3,6,0.333,3,4,26,22,13,13,22,0.271,0.271,0.458,17.684,22,python
0,22,19,4,45,0.489,26,0.578,5,1,0.833,3,3,31,14,10,16,19,0.222,0.356,0.422,17.691,23,python
0,18,20,6,44,0.409,24,0.545,4,1,0.8,0,2,25,19,9,17,18,0.205,0.386,0.409,17.699,24,python
0,18,22,4,44,0.409,22,0.5,2,2,0.5,2,3,25,19,14,10,20,0.318,0.227,0.455,17.717,25,python
0,16,26,8,50,0.32,24,0.48,0,4,0.0,1,2,25,25,14,18,18,0.28,0.36,0.36,17.758,26,python
0,18,23,5,46,0.391,23,0.5,3,0,1.0,2,2,28,18,7,14,25,0.152,0.304,0.543,17.723,27,python
0,18,23,4,45,0.4,22,0.489,2,0,1.0,1,6,26,19,12,14,19,0.267,0.311,0.422,17.749,28,python
0,20,21,5,46,0.435,25,0.543,2,1,0.667,2,4,31,15,14,13,19,0.304,0.283,0.413,17.743,29,python
0,22,21,3,46,0.478,25,0.543,4,1,0.8,2,4,29,17,10,13,23,0.217,0.283,0.5,17.737,30,python
0,24,21,1,46,0.522,25,0.543,4,1,0.8,2,0,23,23,12,15,19,0.261,0.326,0.413,17.739,31,python
0,22,22,1,45,0.489,23,0.511,6,2,0.75,2,1,27,18,12,9,24,0.267,0.2,0.533,17.721,32,python
0,14,28,5,47,0.298,19,0.404,0,3,0.0,1,6,34,13,7,15,25,0.149,0.319,0.532,17.746,33,python
0,20,21,3,44,0.455,23,0.523,3,2,0.6,3,1,28,16,11,13,20,0.25,0.295,0.455,17.74,34,python
0,17,25,5,47,0.362,22,0.468,5,4,0.556,4,2,29,18,6,18,23,0.128,0.383,0.489,17.733,35,python
0,24,20,2,46,0.522,26,0.565,5,0,1.0,4,2,26,20,9,14,23,0.196,0.304,0.5,17.714,36,python
0,23,17,6,46,0.5,29,0.63,6,1,0.857,4,1,24,22,12,19,15,0.261,0.413,0.326,17.705,37,python
0,19,22,5,46,0.413,24,0.522,5,1,0.833,2,2,26,20,7,19,20,0.152,0.413,0.435,17.706,38,python
0,22,15,6,43,0.512,28,0.651,5,1,0.833,3,1,26,17,12,13,18,0.279,0.302,0.419,17.722,39,python
0,19,20,6,45,0.422,25,0.556,0,2,0.0,3,2,28,17,6,17,22,0.133,0.378,0.489,17.715,40,python
0,20,23,3,46,0.435,23,0.5,3,1,0.75,4,0,30,16,8,17,21,0.174,0.37,0.457,17.692,41,python
0,25,17,6,48,0.521,31,0.646,3,1,0.75,1,3,28,20,14,11,23,0.292,0.229,0.479,17.683,42,python
0,22,25,2,49,0.449,24,0.49,2,2,0.5,4,1,25,24,9,21,19,0.184,0.429,0.388,17.703,43,python
0,24,18,5,47,0.511,29,0.617,3,5,0.375,3,1,26,21,10,14,23,0.213,0.298,0.489,17.707,44,python
0,17,21,7,45,0.378,24,0.533,1,2,0.333,0,3,34,11,11,13,21,0.244,0.289,0.467,17.724,45,python
0,20,25,2,47,0.426,22,0.468,3,2,0.6,1,2,28,19,13,16,18,0.277,0.34,0.383,17.73,46,python
0,21,23,3,47,0.447,24,0.511,4,7,0.364,2,0,26,21,8,20,19,0.17,0.426,0.404,17.733,47,python
0,16,25,4,45,0.356,20,0.444,2,4,0.333,2,3,25,20,10,16,19,0.222,0.356,0.422,17.755,48,python
0,22,19,5,46,0.478,27,0.587,3,5,0.375,6,0,31,15,8,10,28,0.174,0.217,0.609,17.747,49,python
0,19,24,3,46,0.413,22,0.478,1,3,0.25,1,6,28,18,13,13,20,0.283,0.283,0.435,17.749,50,python
0,26,16,1,43,0.605,27,0.628,4,1,0.8,3,0,24,19,11,18,14,0.256,0.419,0.326,17.753,51,python
0,16,27,4,47,0.34,20,0.426,7,4,0.636,3,4,27,20,9,16,22,0.191,0.34,0.468,17.759,52,python
0,24,21,4,49,0.49,28,0.571,4,1,0.8,1,2,27,22,13,16,20,0.265,0.327,0.408,17.767,53,python
0,23,17,5,45,0.511,28,0.622,4,3,0.571,4,1,33,12,9,16,20,0.2,0.356,0.444,17.77,54,python
0,24,17,6,47,0.511,30,0.638,4,5,0.444,1,0,26,21,13,18,16,0.277,0.383,0.34,17.765,55,python
0,17,23,5,45,0.378,22,0.489,1,3,0.25,3,3,27,18,11,15,19,0.244,0.333,0.422,17.769,56,python
0,23,16,4,43,0.535,27,0.628,5,0,1.0,3,3,25,18,12,14,17,0.279,0.326,0.395,17.769,57,python
0,21,29,1,51,0.412,22,0.431,6,10,0.375,3,4,29,22,12,15,24,0.235,0.294,0.471,17.756,58,python
0,26,18,6,50,0.52,32,0.64,10,3,0.769,6,1,23,27,15,12,23,0.3,0.24,0.46,17.753,59,python
0,18,25,2,45,0.4,20,0.444,2,2,0.5,4,1,28,17,9,11,25,0.2,0.244,0.556,17.743,60,python
0,18,23,4,45,0.4,22,0.489,1,4,0.2,2,4,27,18,10,16,19,0.222,0.356,0.422,17.744,61,python
0,26,17,1,44,0.591,27,0.614,6,1,0.857,1,1,23,21,17,8,19,0.386,0.182,0.432,17.752,62,python
0,17,28,5,50,0.34,22,0.44,4,7,0.364,3,1,28,22,5,25,20,0.1,0.5,0.4,17.746,63,python
0,16,28,3,47,0.34,19,0.404,5,1,0.833,0,3,25,22,10,17,20,0.213,0.362,0.426,17.751,64,python
0,19,21,3,43,0.442,22,0.512,1,4,0.2,2,1,26,17,13,14,16,0.302,0.326,0.372,17.754,65,python
0,19,25,4,48,0.396,23,0.479,3,1,0.75,0,3,25,23,15,14,19,0.312,0.292,0.396,17.753,66,python
0,22,19,4,45,0.489,26,0.578,1,2,0.333,5,2,28,17,10,14,21,0.222,0.311,0.467,17.734,67,python
0,24,23,0,47,0.511,24,0.511,4,2,0.667,4,5,31,16,11,14,22,0.234,0.298,0.468,17.725,68,python
0,20,22,4,46,0.435,24,0.522,5,0,1.0,2,3,32,14,8,16,22,0.174,0.348,0.478,17.73,69,python
0,20,21,7,48,0.417,27,0.562,1,1,0.5,2,2,32,16,7,15,26,0.146,0.312,0.542,17.72,70,python
0,18,24,6,48,0.375,24,0.5,2,2,0.5,3,1,28,20,10,18,20,0.208,0.375,0.417,17.715,71,python
0,17,21,6,44,0.386,23,0.523,3,2,0.6,0,2,30,14,11,11,22,0.25,0.25,0.5,17.715,72,python
0,20,18,7,45,0.444,27,0.6,1,3,0.25,2,4,23,22,15,13,17,0.333,0.289,0.378,17.714,73,python
0,16,26,2,44,0.364,18,0.409,4,1,0.8,2,5,26,18,12,13,19,0.273,0.295,0.432,17.711,74,python
0,17,22,6,45,0.378,23,0.511,3,1,0.75,3,2,32,13,7,7,31,0.156,0.156,0.689,17.707,75,python
0,15,23,5,43,0.349,20,0.465,2,1,0.667,2,2,26,17,11,14,18,0.256,0.326,0.419,17.702,76,python
0,20,22,5,47,0.426,25,0.532,3,4,0.429,3,1,33,14,10,13,24,0.213,0.277,0.511,17.705,77,python
0,24,15,5,44,0.545,29,0.659,3,0,1.0,3,2,29,15,13,9,22,0.295,0.205,0.5,17.705,78,python
0,21,19,6,46,0.457,27,0.587,7,5,0.583,1,2,25,21,13,15,18,0.283,0.326,0.391,17.709,79,python
0,18,25,3,46,0.391,21,0.457,3,1,0.75,0,3,30,16,10,15,21,0.217,0.326,0.457,17.708,80,python
0,19,20,7,46,0.413,26,0.565,3,3,0.5,2,3,34,12,10,17,19,0.217,0.37,0.413,17.712,81,python
0,13,25,6,44,0.295,19,0.432,3,2,0.6,1,2,25,19,8,16,20,0.182,0.364,0.455,17.71,82,python
0,17,26,3,46,0.37,20,0.435,1,4,0.2,1,4,31,15,7,19,20,0.152,0.413,0.435,17.705,83,python
0,18,22,4,44,0.409,22,0.5,1,2,0.333,1,1,27,17,11,17,16,0.25,0.386,0.364,17.709,84,python
0,24,23,3,50,0.48,27,0.54,2,4,0.333,2,4,25,25,15,19,16,0.3,0.38,0.32,17.708,85,python
0,20,22,6,48,0.417,26,0.542,3,2,0.6,4,4,27,21,12,18,18,0.25,0.375,0.375,17.713,86,python
0,17,27,4,48,0.354,21,0.438,1,6,0.143,3,3,25,23,7,21,20,0.146,0.438,0.417,17.713,87,python
0,17,26,3,46,0.37,20,0.435,4,0,1.0,1,4,32,14,7,17,22,0.152,0.37,0.478,17.716,88,python
0,26,17,5,48,0.542,31,0.646,7,5,0.583,3,2,30,18,14,13,21,0.292,0.271,0.438,17.718,89,python
0,22,21,1,44,0.5,23,0.523,3,2,0.6,4,2,29,15,9,14,21,0.205,0.318,0.477,17.714,90,python
0,18,21,4,43,0.419,22,0.512,4,1,0.8,1,1,25,18,10,15,18,0.233,0.349,0.419,17.723,91,python
0,21,21,2,44,0.477,23,0.523,1,0,1.0,0,4,26,18,12,13,19,0.273,0.295,0.432,17.728,92,python
0,15,24,6,45,0.333,21,0.467,4,2,0.667,0,2,28,17,9,16,20,0.2,0.356,0.444,17.739,93,python
0,20,22,4,46,0.435,24,0.522,1,1,0.5,3,4,27,19,13,16,17,0.283,0.348,0.37,17.739,94,python
0,18,23,5,46,0.391,23,0.5,3,3,0.5,1,1,32,14,9,14,23,0.196,0.304,0.5,17.741,95,python
0,19,21,6,46,0.413,25,0.543,5,2,0.714,1,2,21,25,13,23,10,0.283,0.5,0.217,17.735,96,python
0,21,24,1,46,0.457,22,0.478,7,4,0.636,2,2,23,23,10,15,21,0.217,0.326,0.457,17.448,1,python
0,23,21,5,49,0.469,28,0.571,2,0,1.0,4,1,26,23,11,18,20,0.224,0.367,0.408,17.633,2,python
0,26,21,1,48,0.542,27,0.562,2,1,0.667,2,2,25,23,19,10,19,0.396,0.208,0.396,17.814,3,python
0,20,21,3,44,0.455,23,0.523,0,2,0.0,6,1,30,14,10,9,25,0.227,0.205,0.568,17.75,4,python
0,15,22,8,45,0.333,23,0.511,2,0,1.0,2,4,27,18,8,16,21,0.178,0.356,0.467,17.85,5,python
0,23,22,3,48,0.479,26,0.542,6,3,0.667,5,4,27,21,15,11,22,0.312,0.229,0.458,17.76,6,python
0,21,22,3,46,0.457,24,0.522,3,2,0.6,2,3,25,21,10,15,21,0.217,0.326,0.457,17.775,7,python
0,17,25,3,45,0.378,20,0.444,2,1,0.667,2,1,34,11,8,13,24,0.178,0.289,0.533,17.651,8,python
0,16,27,3,46,0.348,19,0.413,2,3,0.4,1,1,27,19,11,16,19,0.239,0.348,0.413,17.744,9,python
0,23,19,5,47,0.489,28,0.596,0,1,0.0,3,0,29,18,11,13,23,0.234,0.277,0.489,17.771,10,python
0,24,16,5,45,0.533,29,0.644,5,0,1.0,2,1,24,21,12,19,14,0.267,0.422,0.311,17.752,11,python
0,16,26,4,46,0.348,20,0.435,2,3,0.4,1,3,28,18,10,16,20,0.217,0.348,0.435,17.782,12,python
0,20,18,6,44,0.455,26,0.591,4,2,0.667,2,2,24,20,10,14,20,0.227,0.318,0.455,17.773,13,python
0,13,29,3,45,0.289,16,0.356,2,5,0.286,0,2,30,15,8,13,24,0.178,0.289,0.533,17.745,14,python
0,20,22,3,45,0.444,23,0.511,2,3,0.4,4,1,28,17,8,13,24,0.178,0.289,0.533,17.722,15,python
0,19,21,6,46,0.413,25,0.543,4,2,0.667,3,1,30,16,13,13,20,0.283,0.283,0.435,17.697,16,python
0,22,17,7,46,0.478,29,0.63,4,3,0.571,2,2,28,18,12,18,16,0.261,0.391,0.348,17.712,17,python
0,21,18,5,44,0.477,26,0.591,2,1,0.667,1,2,25,19,14,15,15,0.318,0.341,0.341,17.726,18,python
0,24,18,4,46,0.522,28,0.609,0,1,0.0,1,3,32,14,20,10,16,0.435,0.217,0.348,17.724,19,python
0,20,22,3,45,0.444,23,0.511,2,6,0.25,3,3,35,10,9,13,23,0.2,0.289,0.511,17.715,20,python
0,16,21,5,42,0.381,21,0.5,2,2,0.5,3,1,29,13,8,15,19,0.19,0.357,0.452,17.715,21,python
0,20,23,3,46,0.435,23,0.5,7,2,0.778,3,2,23,23,13,14,19,0.283,0.304,0.413,17.703,22,python
0,16,24,6,46,0.348,22,0.478,1,1,0.5,1,4,30,16,8,17,21,0.174,0.37,0.457,17.707,23,python
0,24,17,4,45,0.533,28,0.622,2,1,0.667,2,0,22,23,14,17,14,0.311,0.378,0.311,17.693,24,python
0,17,24,4,45,0.378,21,0.467,3,2,0.6,2,4,30,15,11,9,25,0.244,0.2,0.556,17.7,25,python
0,19,24,3,46,0.413,22,0.478,2,0,1.0,2,4,28,18,11,14,21,0.239,0.304,0.457,17.719,26,python
0,19,23,4,46,0.413,23,0.5,3,4,0.429,2,3,30,16,11,13,22,0.239,0.283,0.478,17.731,27,python
0,12,29,4,45,0.267,16,0.356,3,1,0.75,1,5,29,16,8,13,24,0.178,0.289,0.533,17.702,28,python
0,16,25,5,46,0.348,21,0.457,4,2,0.667,2,2,29,17,7,15,24,0.152,0.326,0.522,17.715,29,python
0,16,29,3,48,0.333,19,0.396,0,1,0.0,0,1,25,23,8,17,23,0.167,0.354,0.479,17.712,30,python
0,22,19,3,44,0.5,25,0.568,2,1,0.667,1,1,31,13,14,13,17,0.318,0.295,0.386,17.723,31,python
0,24,21,0,45,0.533,24,0.533,1,1,0.5,1,1,27,18,13,14,18,0.289,0.311,0.4,17.74,32,python
0,23,19,3,45,0.511,26,0.578,4,0,1.0,3,2,24,21,17,11,17,0.378,0.244,0.378,17.708,33,python
0,17,28,2,47,0.362,19,0.404,1,7,0.125,1,3,32,15,10,14,23,0.213,0.298,0.489,17.706,34,python
0,21,23,2,46,0.457,23,0.5,4,5,0.444,5,1,30,16,12,10,24,0.261,0.217,0.522,17.697,35,python
0,18,24,3,45,0.4,21,0.467,2,1,0.667,1,2,29,16,8,17,20,0.178,0.378,0.444,17.699,36,python
0,15,23,6,44,0.341,21,0.477,1,1,0.5,3,2,29,15,4,15,25,0.091,0.341,0.568,17.711,37,python
0,22,19,3,44,0.5,25,0.568,3,1,0.75,1,1,33,11,12,8,24,0.273,0.182,0.545,17.706,38,python
0,12,33,2,47,0.255,14,0.298,2,2,0.5,1,5,26,21,8,20,19,0.17,0.426,0.404,17.702,39,python
0,16,25,6,47,0.34,22,0.468,2,3,0.4,1,1,30,17,8,17,22,0.17,0.362,0.468,17.703,40,python
0,18,25,3,46,0.391,21,0.457,0,2,0.0,3,6,31,15,11,11,24,0.239,0.239,0.522,17.693,41,python
0,22,19,6,47,0.468,28,0.596,3,1,0.75,1,5,30,17,8,16,23,0.17,0.34,0.489,17.694,42,python
0,19,23,3,45,0.422,22,0.489,3,1,0.75,2,2,28,17,10,15,20,0.222,0.333,0.444,17.69,43,python
0,23,21,0,44,0.523,23,0.523,4,2,0.667,2,0,24,20,12,11,21,0.273,0.25,0.477,17.69,44,python
0,19,20,6,45,0.422,25,0.556,3,2,0.6,3,2,30,15,10,12,23,0.222,0.267,0.511,17.677,45,python
0,23,19,3,45,0.511,26,0.578,1,2,0.333,1,2,31,14,8,16,21,0.178,0.356,0.467,17.686,46,python
0,23,13,6,42,0.548,29,0.69,4,1,0.8,1,0,23,19,13,17,12,0.31,0.405,0.286,17.694,47,python
0,19,24,1,44,0.432,20,0.455,3,1,0.75,1,1,29,15,11,12,21,0.25,0.273,0.477,17.684,48,python
0,17,27,5,49,0.347,22,0.449,1,2,0.333,5,3,30,19,8,13,28,0.163,0.265,0.571,17.669,49,python
0,15,30,4,49,0.306,19,0.388,2,0,1.0,1,5,33,16,8,15,26,0.163,0.306,0.531,17.682,50,python
0,22,23,4,49,0.449,26,0.531,0,2,0.0,3,1,30,19,11,18,20,0.224,0.367,0.408,17.681,51,python
0,20,22,3,45,0.444,23,0.511,4,2,0.667,3,1,26,19,11,14,20,0.244,0.311,0.444,17.677,52,python
0,20,20,3,43,0.465,23,0.535,6,4,0.6,2,0,28,15,7,17,19,0.163,0.395,0.442,17.679,53,python
0,15,26,4,45,0.333,19,0.422,0,2,0.0,2,3,29,16,8,12,25,0.178,0.267,0.556,17.684,54,python
0,21,20,3,44,0.477,24,0.545,1,5,0.167,3,2,32,12,9,16,19,0.205,0.364,0.432,17.688,55,python
0,15,21,9,45,0.333,24,0.533,2,0,1.0,3,3,28,17,8,16,21,0.178,0.356,0.467,17.7,56,python
0,18,22,5,45,0.4,23,0.511,3,2,0.6,1,1,28,17,10,12,23,0.222,0.267,0.511,17.693,57,python
0,19,19,5,43,0.442,24,0.558,4,2,0.667,0,2,23,20,14,14,15,0.326,0.326,0.349,17.705,58,python
0,22,21,1,44,0.5,23,0.523,1,2,0.333,3,2,26,18,11,12,21,0.25,0.273,0.477,17.689,59,python
0,23,20,5,48,0.479,28,0.583,2,1,0.667,2,3,25,23,13,14,21,0.271,0.292,0.438,17.69,60,python
0,14,26,5,45,0.311,19,0.422,1,4,0.2,2,1,26,19,5,23,17,0.111,0.511,0.378,17.692,61,python
0,15,24,7,46,0.326,22,0.478,0,0,0,1,3,29,17,8,14,24,0.174,0.304,0.522,17.687,62,python
0,20,16,6,42,0.476,26,0.619,1,0,1.0,1,0,25,17,14,11,17,0.333,0.262,0.405,17.674,63,python
0,20,20,4,44,0.455,24,0.545,2,0,1.0,1,0,32,12,7,14,23,0.159,0.318,0.523,17.677,64,python
0,20,22,6,48,0.417,26,0.542,1,2,0.333,3,1,30,18,9,16,23,0.188,0.333,0.479,17.672,65,python
0,20,19,5,44,0.455,25,0.568,4,2,0.667,1,2,26,18,14,12,18,0.318,0.273,0.409,17.671,66,python
0,21,19,3,43,0.488,24,0.558,3,0,1.0,2,1,29,14,11,17,15,0.256,0.395,0.349,17.673,67,python
0,20,21,5,46,0.435,25,0.543,2,0,1.0,1,3,30,16,12,9,25,0.261,0.196,0.543,17.671,68,python
0,20,16,7,43,0.465,27,0.628,3,2,0.6,2,1,26,17,11,13,19,0.256,0.302,0.442,17.661,69,python
0,17,23,4,44,0.386,21,0.477,2,1,0.667,1,4,25,19,11,16,17,0.25,0.364,0.386,17.662,70,python
0,16,20,6,42,0.381,22,0.524,1,1,0.5,0,0,24,18,9,17,16,0.214,0.405,0.381,17.662,71,python
0,20,24,2,46,0.435,22,0.478,2,3,0.4,3,2,30,16,8,15,23,0.174,0.326,0.5,17.65,72,python
0,26,19,1,46,0.565,27,0.587,3,1,0.75,3,3,31,15,14,12,20,0.304,0.261,0.435,17.641,73,python
0,25,20,3,48,0.521,28,0.583,5,4,0.556,4,2,27,21,14,10,24,0.292,0.208,0.5,17.635,74,python
0,25,18,1,44,0.568,26,0.591,3,1,0.75,4,3,28,16,13,9,22,0.295,0.205,0.5,17.624,75,python
0,21,22,1,44,0.477,22,0.5,2,3,0.4,2,1,23,21,11,14,19,0.25,0.318,0.432,17.621,76,python
0,23,23,3,49,0.469,26,0.531,1,2,0.333,1,2,23,26,16,16,17,0.327,0.327,0.347,17.62,77,python
0,23,17,4,44,0.523,27,0.614,2,1,0.667,0,1,25,19,11,15,18,0.25,0.341,0.409,17.625,78,python
0,30,12,2,44,0.682,32,0.727,4,1,0.8,3,1,30,14,16,9,19,0.364,0.205,0.432,17.62,79,python
0,22,20,4,46,0.478,26,0.565,4,1,0.8,1,1,27,19,12,11,23,0.261,0.239,0.5,17.619,80,python
0,19,20,5,44,0.432,24,0.545,0,3,0.0,2,4,31,13,13,13,18,0.295,0.295,0.409,17.628,81,python
0,24,23,4,51,0.471,28,0.549,7,3,0.7,2,3,28,23,15,10,26,0.294,0.196,0.51,17.619,82,python
0,20,22,3,45,0.444,23,0.511,4,2,0.667,3,3,26,19,8,17,20,0.178,0.378,0.444,17.611,83,python
0,23,18,1,42,0.548,24,0.571,3,1,0.75,1,0,20,22,18,14,10,0.429,0.333,0.238,17.618,84,python
0,21,21,2,44,0.477,23,0.523,7,1,0.875,1,1,26,18,14,14,16,0.318,0.318,0.364,17.628,85,python
0,15,25,4,44,0.341,19,0.432,1,3,0.25,2,4,31,13,5,15,24,0.114,0.341,0.545,17.633,86,python
0,19,24,5,48,0.396,24,0.5,3,5,0.375,5,3,33,15,7,13,28,0.146,0.271,0.583,17.632,87,python
0,21,20,2,43,0.488,23,0.535,5,2,0.714,3,1,28,15,12,10,21,0.279,0.233,0.488,17.629,88,python
0,25,18,3,46,0.543,28,0.609,4,2,0.667,3,1,29,17,15,12,19,0.326,0.261,0.413,17.625,89,python
0,21,20,4,45,0.467,25,0.556,2,1,0.667,0,5,28,17,11,18,16,0.244,0.4,0.356,17.63,90,python
0,12,29,5,46,0.261,17,0.37,2,4,0.333,2,3,28,18,5,16,25,0.109,0.348,0.543,17.628,91,python
0,22,19,6,47,0.468,28,0.596,5,2,0.714,0,2,25,22,14,13,20,0.298,0.277,0.426,17.631,92,python
0,21,19,7,47,0.447,28,0.596,7,0,1.0,4,1,33,14,8,17,22,0.17,0.362,0.468,17.631,93,python
0,20,21,5,46,0.435,25,0.543,4,4,0.5,4,2,28,18,10,12,24,0.217,0.261,0.522,17.63,94,python
0,17,24,4,45,0.378,21,0.467,2,3,0.4,0,3,30,15,7,11,27,0.156,0.244,0.6,17.637,95,python
0,16,26,5,47,0.34,21,0.447,1,3,0.25,3,4,32,15,8,17,22,0.17,0.362,0.468,17.64,96,python
0,21,21,3,45,0.467,24,0.533,2,3,0.4,0,1,24,21,11,17,17,0.244,0.378,0.378,17.536,1,python
0,18,24,5,47,0.383,23,0.489,4,1,0.8,2,3,31,16,5,18,24,0.106,0.383,0.511,17.694,2,python
0,21,19,4,44,0.477,25,0.568,3,2,0.6,2,3,21,23,13,12,19,0.295,0.273,0.432,17.761,3,python
0,23,20,2,45,0.511,25,0.556,5,2,0.714,2,3,32,13,9,12,24,0.2,0.267,0.533,17.8,4,python
0,21,20,5,46,0.457,26,0.565,2,1,0.667,3,1,28,18,6,16,24,0.13,0.348,0.522,17.747,5,python
0,29,17,1,47,0.617,30,0.638,5,1,0.833,0,3,24,23,18,12,17,0.383,0.255,0.362,17.697,6,python
0,21,18,5,44,0.477,26,0.591,3,0,1.0,2,3,26,18,12,15,17,0.273,0.341,0.386,17.663,7,python
0,22,21,5,48,0.458,27,0.562,1,1,0.5,3,1,29,19,9,18,21,0.188,0.375,0.438,17.658,8,python
0,19,25,2,46,0.413,21,0.457,2,2,0.5,2,1,34,12,8,12,26,0.174,0.261,0.565,17.559,9,python
0,20,22,2,44,0.455,22,0.5,2,0,1.0,2,2,26,18,13,12,19,0.295,0.273,0.432,17.534,10,python
0,15,28,3,46,0.326,18,0.391,1,2,0.333,1,2,30,16,6,13,27,0.13,0.283,0.587,17.584,11,python
0,23,17,4,44,0.523,27,0.614,1,0,1.0,4,2,26,18,13,9,22,0.295,0.205,0.5,17.574,12,python
0,22,18,4,44,0.5,26,0.591,2,1,0.667,3,3,30,14,10,13,21,0.227,0.295,0.477,17.527,13,python
0,21,17,11,49,0.429,32,0.653,2,1,0.667,1,2,26,23,11,17,21,0.224,0.347,0.429,17.504,14,python
0,20,23,1,44,0.455,21,0.477,5,3,0.625,1,1,25,19,8,18,18,0.182,0.409,0.409,17.562,15,python
0,16,27,3,46,0.348,19,0.413,3,2,0.6,0,3,22,24,8,21,17,0.174,0.457,0.37,17.576,16,python
0,26,17,6,49,0.531,32,0.653,2,1,0.667,3,2,25,24,12,14,23,0.245,0.286,0.469,17.584,17,python
0,21,21,5,47,0.447,26,0.553,2,0,1.0,1,2,26,21,12,18,17,0.255,0.383,0.362,17.615,18,python
0,21,21,3,45,0.467,24,0.533,6,2,0.75,2,3,28,17,11,12,22,0.244,0.267,0.489,17.627,19,python
0,17,25,4,46,0.37,21,0.457,2,7,0.222,2,4,29,17,14,16,16,0.304,0.348,0.348,17.63,20,python
0,20,19,4,43,0.465,24,0.558,2,4,0.333,1,2,30,13,18,8,17,0.419,0.186,0.395,17.651,21,python
0,19,22,2,43,0.442,21,0.488,4,3,0.571,1,1,29,14,9,13,21,0.209,0.302,0.488,17.652,22,python
0,22,19,6,47,0.468,28,0.596,6,1,0.857,3,0,27,20,10,13,24,0.213,0.277,0.511,17.647,23,python
0,18,21,5,44,0.409,23,0.523,1,0,1.0,1,2,26,18,8,17,19,0.182,0.386,0.432,17.668,24,python
0,19,20,5,44,0.432,24,0.545,2,3,0.4,3,1,29,15,14,10,20,0.318,0.227,0.455,17.664,25,python
0,16,25,5,46,0.348,21,0.457,3,0,1.0,2,2,28,18,12,13,21,0.261,0.283,0.457,17.677,26,python
0,16,26,1,43,0.372,17,0.395,7,1,0.875,0,2,30,13,10,9,24,0.233,0.209,0.558,17.656,27,python
0,15,25,6,46,0.326,21,0.457,1,4,0.2,2,2,34,12,5,14,27,0.109,0.304,0.587,17.655,28,python
0,19,21,5,45,0.422,24,0.533,3,2,0.6,1,3,28,17,13,10,22,0.289,0.222,0.489,17.669,29,python
0,20,20,6,46,0.435,26,0.565,2,1,0.667,4,1,25,21,11,10,25,0.239,0.217,0.543,17.614,30,python
0,23,20,2,45,0.511,25,0.556,2,2,0.5,3,2,30,15,12,13,20,0.267,0.289,0.444,17.625,31,python
0,18,25,4,47,0.383,22,0.468,5,4,0.556,2,2,27,20,11,16,20,0.234,0.34,0.426,17.617,32,python
0,19,20,4,43,0.442,23,0.535,3,2,0.6,1,2,22,21,12,16,15,0.279,0.372,0.349,17.636,33,python
0,24,14,3,41,0.585,27,0.659,4,0,1.0,1,0,24,17,16,9,16,0.39,0.22,0.39,17.634,34,python
0,21,18,5,44,0.477,26,0.591,3,3,0.5,2,0,30,14,12,9,23,0.273,0.205,0.523,17.633,35,python
0,19,24,3,46,0.413,22,0.478,1,1,0.5,4,2,25,21,12,14,20,0.261,0.304,0.435,17.627,36,python
0,26,20,1,47,0.553,27,0.574,4,2,0.667,1,6,28,19,18,10,19,0.383,0.213,0.404,17.622,37,python
0,20,21,6,47,0.426,26,0.553,5,2,0.714,1,4,29,18,14,9,24,0.298,0.191,0.511,17.631,38,python
0,20,21,3,44,0.455,23,0.523,3,2,0.6,2,1,28,16,10,17,17,0.227,0.386,0.386,17.638,39,python
0,19,26,2,47,0.404,21,0.447,3,2,0.6,3,3,25,22,6,19,22,0.128,0.404,0.468,17.629,40,python
0,26,17,3,46,0.565,29,0.63,3,2,0.6,3,2,24,22,13,13,20,0.283,0.283,0.435,17.628,41,python
0,19,19,9,47,0.404,28,0.596,3,4,0.429,3,1,29,18,7,16,24,0.149,0.34,0.511,17.631,42,python
0,15,26,6,47,0.319,21,0.447,2,5,0.286,1,1,29,18,10,17,20,0.213,0.362,0.426,17.637,43,python
0,18,23,3,44,0.409,21,0.477,1,2,0.333,3,1,30,14,9,15,20,0.205,0.341,0.455,17.635,44,python
0,21,19,5,45,0.467,26,0.578,4,1,0.8,2,0,25,20,9,20,16,0.2,0.444,0.356,17.633,45,python
0,21,24,2,47,0.447,23,0.489,4,0,1.0,4,2,21,26,9,17,21,0.191,0.362,0.447,17.631,46,python
0,17,25,7,49,0.347,24,0.49,1,3,0.25,5,2,32,17,10,14,25,0.204,0.286,0.51,17.618,47,python
0,20,22,6,48,0.417,26,0.542,3,4,0.429,1,5,30,18,11,17,20,0.229,0.354,0.417,17.637,48,python
0,19,22,4,45,0.422,23,0.511,6,3,0.667,1,1,27,18,13,12,20,0.289,0.267,0.444,17.644,49,python
0,22,21,3,46,0.478,25,0.543,5,2,0.714,4,2,19,27,11,20,15,0.239,0.435,0.326,17.632,50,python
0,17,20,7,44,0.386,24,0.545,3,1,0.75,2,2,26,18,9,15,20,0.205,0.341,0.455,17.626,51,python
0,15,24,7,46,0.326,22,0.478,1,5,0.167,1,0,22,24,8,19,19,0.174,0.413,0.413,17.639,52,python
0,22,19,3,44,0.5,25,0.568,2,2,0.5,2,2,23,21,14,15,15,0.318,0.341,0.341,17.633,53,python
0,21,22,2,45,0.467,23,0.511,1,1,0.5,1,3,30,15,11,16,18,0.244,0.356,0.4,17.634,54,python
0,25,18,3,46,0.543,28,0.609,3,1,0.75,0,1,29,17,13,16,17,0.283,0.348,0.37,17.643,55,python
0,18,26,4,48,0.375,22,0.458,3,3,0.5,1,3,30,18,10,16,22,0.208,0.333,0.458,17.644,56,python
0,23,17,6,46,0.5,29,0.63,4,1,0.8,1,3,31,15,13,11,22,0.283,0.239,0.478,17.641,57,python
0,15,26,4,45,0.333,19,0.422,3,1,0.75,0,5,27,18,10,17,18,0.222,0.378,0.4,17.649,58,python
0,17,25,2,44,0.386,19,0.432,5,6,0.455,0,5,27,17,13,13,18,0.295,0.295,0.409,17.65,59,python
0,19,26,3,48,0.396,22,0.458,2,3,0.4,3,3,27,21,6,19,23,0.125,0.396,0.479,17.65,60,python
0,22,20,4,46,0.478,26,0.565,4,1,0.8,4,4,25,21,9,17,20,0.196,0.37,0.435,17.647,61,python
0,19,22,4,45,0.422,23,0.511,3,2,0.6,1,2,36,9,13,5,27,0.289,0.111,0.6,17.636,62,python
0,20,20,6,46,0.435,26,0.565,2,2,0.5,2,1,22,24,11,21,14,0.239,0.457,0.304,17.658,63,python
0,20,25,2,47,0.426,22,0.468,6,5,0.545,2,2,22,25,12,14,21,0.255,0.298,0.447,17.651,64,python
0,18,30,3,51,0.353,21,0.412,2,6,0.25,3,2,26,25,10,18,23,0.196,0.353,0.451,17.638,65,python
0,22,22,1,45,0.489,23,0.511,5,1,0.833,5,3,26,19,10,12,23,0.222,0.267,0.511,17.611,66,python
0,16,28,4,48,0.333,20,0.417,2,2,0.5,1,4,24,24,13,17,18,0.271,0.354,0.375,17.616,67,python
0,24,17,3,44,0.545,27,0.614,3,3,0.5,2,2,32,12,13,10,21,0.295,0.227,0.477,17.614,68,python
0,15,27,5,47,0.319,20,0.426,1,0,1.0,2,5,24,23,8,16,23,0.17,0.34,0.489,17.609,69,python
0,21,20,4,45,0.467,25,0.556,6,1,0.857,4,3,23,22,7,17,21,0.156,0.378,0.467,17.611,70,python
0,26,15,4,45,0.578,30,0.667,3,0,1.0,5,1,30,15,12,12,21,0.267,0.267,0.467,17.607,71,python
0,24,21,0,45,0.533,24,0.533,4,1,0.8,1,3,30,15,10,14,21,0.222,0.311,0.467,17.602,72,python
0,24,18,3,45,0.533,27,0.6,2,2,0.5,3,2,30,15,13,14,18,0.289,0.311,0.4,17.6,73,python
0,20,23,4,47,0.426,24,0.511,4,3,0.571,2,2,23,24,13,15,19,0.277,0.319,0.404,17.604,74,python
0,23,19,4,46,0.5,27,0.587,2,2,0.5,3,1,24,22,16,12,18,0.348,0.261,0.391,17.607,75,python
0,18,30,2,50,0.36,20,0.4,1,2,0.333,1,4,34,16,8,16,26,0.16,0.32,0.52,17.605,76,python
0,22,20,5,47,0.468,27,0.574,2,4,0.333,2,5,21,26,11,18,18,0.234,0.383,0.383,17.603,77,python
0,19,24,5,48,0.396,24,0.5,2,2,0.5,2,0,28,20,11,17,20,0.229,0.354,0.417,17.607,78,python
0,23,20,1,44,0.523,24,0.545,5,3,0.625,3,1,21,23,15,16,13,0.341,0.364,0.295,17.61,79,python
0,22,27,0,49,0.449,22,0.449,1,6,0.143,4,2,28,21,12,10,27,0.245,0.204,0.551,17.609,80,python
0,18,22,4,44,0.409,22,0.5,1,2,0.333,2,1,26,18,8,20,16,0.182,0.455,0.364,17.611,81,python
0,19,24,3,46,0.413,22,0.478,0,1,0.0,1,3,32,14,11,13,22,0.239,0.283,0.478,17.615,82,python
0,19,17,7,43,0.442,26,0.605,6,4,0.6,2,1,27,16,12,14,17,0.279,0.326,0.395,17.613,83,python
0,20,20,3,43,0.465,23,0.535,3,1,0.75,2,1,25,18,9,13,21,0.209,0.302,0.488,17.611,84,python
0,23,20,3,46,0.5,26,0.565,9,0,1.0,1,0,28,18,13,12,21,0.283,0.261,0.457,17.601,85,python
0,17,27,3,47,0.362,20,0.426,0,2,0.0,4,3,26,21,9,18,20,0.191,0.383,0.426,17.597,86,python
0,21,21,2,44,0.477,23,0.523,2,2,0.5,3,0,32,12,7,14,23,0.159,0.318,0.523,17.593,87,python
0,15,26,5,46,0.326,20,0.435,7,3,0.7,1,2,29,17,7,17,22,0.152,0.37,0.478,17.588,88,python
0,17,22,6,45,0.378,23,0.511,3,1,0.75,1,4,29,16,11,15,19,0.244,0.333,0.422,17.588,89,python
0,25,16,5,46,0.543,30,0.652,5,1,0.833,3,3,27,19,11,9,26,0.239,0.196,0.565,17.584,90,python
0,21,23,1,45,0.467,22,0.489,4,2,0.667,1,4,29,16,12,16,17,0.267,0.356,0.378,17.586,91,python
0,20,22,4,46,0.435,24,0.522,7,0,1.0,0,1,25,21,12,19,15,0.261,0.413,0.326,17.587,92,python
0,23,20,2,45,0.511,25,0.556,2,1,0.667,5,0,26,19,7,15,23,0.156,0.333,0.511,17.587,93,python
0,21,18,6,45,0.467,27,0.6,3,4,0.429,2,1,25,20,7,18,20,0.156,0.4,0.444,17.591,94,python
0,19,23,3,45,0.422,22,0.489,4,4,0.5,2,3,24,21,8,19,18,0.178,0.422,0.4,17.588,95,python
0,16,26,4,46,0.348,20,0.435,1,2,0.333,2,2,30,16,8,14,24,0.174,0.304,0.522,17.58,96,python
0,15,29,1,45,0.333,16,0.356,0,2,0.0,3,1,29,16,7,16,22,0.156,0.356,0.489,18.1,1,python
0,19,22,3,44,0.432,22,0.5,4,3,0.571,2,5,29,15,10,15,19,0.227,0.341,0.432,17.825,2,python
0,21,20,2,43,0.488,23,0.535,3,2,0.6,0,0,25,18,17,11,15,0.395,0.256,0.349,17.639,3,python
0,19,20,4,43,0.442,23,0.535,3,2,0.6,3,0,28,15,11,9,23,0.256,0.209,0.535,17.625,4,python
0,19,19,5,43,0.442,24,0.558,5,1,0.833,2,0,27,16,8,15,20,0.186,0.349,0.465,17.559,5,python
0,17,23,6,46,0.37,23,0.5,1,1,0.5,3,2,30,16,7,15,24,0.152,0.326,0.522,17.426,6,python
0,20,21,3,44,0.455,23,0.523,6,3,0.667,2,2,24,20,12,18,14,0.273,0.409,0.318,17.337,7,python
0,17,20,7,44,0.386,24,0.545,4,6,0.4,0,1,30,14,8,11,25,0.182,0.25,0.568,17.382,8,python
0,23,18,4,45,0.511,27,0.6,6,0,1.0,2,2,30,15,14,12,19,0.311,0.267,0.422,17.412,9,python
0,16,26,2,44,0.364,18,0.409,3,1,0.75,3,2,30,14,7,14,23,0.159,0.318,0.523,17.469,10,python
0,20,19,5,44,0.455,25,0.568,5,2,0.714,1,1,23,21,14,17,13,0.318,0.386,0.295,17.503,11,python
0,24,19,2,45,0.533,26,0.578,5,1,0.833,1,0,24,21,17,13,15,0.378,0.289,0.333,17.504,12,python
0,22,22,1,45,0.489,23,0.511,5,1,0.833,2,3,26,19,12,15,18,0.267,0.333,0.4,17.533,13,python
0,22,18,5,45,0.489,27,0.6,3,1,0.75,3,0,22,23,9,15,21,0.2,0.333,0.467,17.552,14,python
0,21,19,7,47,0.447,28,0.596,2,1,0.667,4,4,27,20,13,13,21,0.277,0.277,0.447,17.589,15,python
0,15,25,3,43,0.349,18,0.419,4,2,0.667,1,1,26,17,7,16,20,0.163,0.372,0.465,17.613,16,python
0,15,25,4,44,0.341,19,0.432,3,1,0.75,1,3,27,17,12,11,21,0.273,0.25,0.477,17.566,17,python
0,18,21,5,44,0.409,23,0.523,3,2,0.6,3,1,29,15,9,17,18,0.205,0.386,0.409,17.606,18,python
0,25,14,7,46,0.543,32,0.696,3,3,0.5,2,2,25,21,10,20,16,0.217,0.435,0.348,17.645,19,python
0,16,26,3,45,0.356,19,0.422,1,4,0.2,1,4,27,18,11,15,19,0.244,0.333,0.422,17.645,20,python
0,23,17,6,46,0.5,29,0.63,3,3,0.5,2,0,31,15,13,14,19,0.283,0.304,0.413,17.642,21,python
0,18,19,9,46,0.391,27,0.587,4,4,0.5,1,3,25,21,9,16,21,0.196,0.348,0.457,17.634,22,python
0,20,24,4,48,0.417,24,0.5,3,3,0.5,7,1,28,20,3,20,25,0.062,0.417,0.521,17.612,23,python
0,22,21,4,47,0.468,26,0.553,7,3,0.7,0,1,26,21,11,21,15,0.234,0.447,0.319,17.645,24,python
0,23,20,2,45,0.511,25,0.556,5,2,0.714,2,2,26,19,11,13,21,0.244,0.289,0.467,17.62,25,python
0,14,28,4,46,0.304,18,0.391,2,3,0.4,2,4,33,13,6,15,25,0.13,0.326,0.543,17.622,26,python
0,16,23,7,46,0.348,23,0.5,1,0,1.0,3,3,26,20,10,14,22,0.217,0.304,0.478,17.63,27,python
0,16,27,2,45,0.356,18,0.4,4,1,0.8,1,1,25,20,12,16,17,0.267,0.356,0.378,17.637,28,python
0,21,20,4,45,0.467,25,0.556,4,2,0.667,3,1,26,19,12,12,21,0.267,0.267,0.467,17.632,29,python
0,22,18,6,46,0.478,28,0.609,4,1,0.8,3,3,23,23,13,17,16,0.283,0.37,0.348,17.626,30,python
0,15,25,4,44,0.341,19,0.432,1,1,0.5,1,2,30,14,9,14,21,0.205,0.318,0.477,17.633,31,python
0,23,23,2,48,0.479,25,0.521,6,1,0.857,2,1,24,24,8,19,21,0.167,0.396,0.438,17.613,32,python
0,18,21,7,46,0.391,25,0.543,1,1,0.5,5,3,27,19,6,18,22,0.13,0.391,0.478,17.625,33,python
0,30,14,4,48,0.625,34,0.708,5,2,0.714,5,0,28,20,14,11,23,0.292,0.229,0.479,17.609,34,python
0,19,25,2,46,0.413,21,0.457,0,2,0.0,2,5,30,16,10,12,24,0.217,0.261,0.522,17.605,35,python
0,18,18,7,43,0.419,25,0.581,1,0,1.0,3,3,21,22,13,20,10,0.302,0.465,0.233,17.599,36,python
0,22,18,5,45,0.489,27,0.6,2,3,0.4,3,3,30,15,8,14,23,0.178,0.311,0.511,17.563,37,python
0,22,19,4,45,0.489,26,0.578,5,2,0.714,4,3,27,18,10,12,23,0.222,0.267,0.511,17.558,38,python
0,18,27,1,46,0.391,19,0.413,3,1,0.75,1,4,28,18,9,12,25,0.196,0.261,0.543,17.538,39,python
0,23,19,4,46,0.5,27,0.587,3,3,0.5,1,2,26,20,10,15,21,0.217,0.326,0.457,17.525,40,python
0,23,18,4,45,0.511,27,0.6,2,2,0.5,2,2,28,17,15,13,17,0.333,0.289,0.378,17.53,41,python
0,24,18,3,45,0.533,27,0.6,3,3,0.5,2,1,28,17,11,10,24,0.244,0.222,0.533,17.512,42,python
0,18,23,4,45,0.4,22,0.489,2,6,0.25,1,3,28,17,10,14,21,0.222,0.311,0.467,17.525,43,python
0,21,25,2,48,0.438,23,0.479,5,4,0.556,3,1,33,15,8,17,23,0.167,0.354,0.479,17.54,44,python
0,25,16,3,44,0.568,28,0.636,0,5,0.0,2,1,25,19,14,14,16,0.318,0.318,0.364,17.541,45,python
0,22,20,5,47,0.468,27,0.574,2,1,0.667,2,1,29,18,9,14,24,0.191,0.298,0.511,17.545,46,python
0,16,24,3,43,0.372,19,0.442,3,1,0.75,1,1,26,17,10,13,20,0.233,0.302,0.465,17.542,47,python
0,20,21,4,45,0.444,24,0.533,3,3,0.5,3,5,25,20,8,14,23,0.178,0.311,0.511,17.547,48,python
0,22,23,1,46,0.478,23,0.5,3,1,0.75,4,4,27,19,12,15,19,0.261,0.326,0.413,17.539,49,python
0,21,24,2,47,0.447,23,0.489,3,1,0.75,4,1,23,24,13,15,19,0.277,0.319,0.404,17.545,50,python
0,19,23,3,45,0.422,22,0.489,4,2,0.667,1,2,30,15,10,19,16,0.222,0.422,0.356,17.546,51,python
0,19,21,6,46,0.413,25,0.543,2,1,0.667,3,3,30,16,4,19,23,0.087,0.413,0.5,17.532,52,python
0,23,18,3,44,0.523,26,0.591,2,1,0.667,2,4,24,20,15,12,17,0.341,0.273,0.386,17.531,53,python
0,21,18,5,44,0.477,26,0.591,2,1,0.667,0,2,30,14,12,12,20,0.273,0.273,0.455,17.529,54,python
0,19,23,3,45,0.422,22,0.489,0,1,0.0,1,1,29,16,12,12,21,0.267,0.267,0.467,17.543,55,python
0,23,19,5,47,0.489,28,0.596,5,2,0.714,1,3,27,20,9,18,20,0.191,0.383,0.426,17.548,56,python
0,21,20,2,43,0.488,23,0.535,3,5,0.375,1,2,27,16,13,15,15,0.302,0.349,0.349,17.559,57,python
0,20,24,3,47,0.426,23,0.489,7,3,0.7,2,3,24,23,14,12,21,0.298,0.255,0.447,17.566,58,python
0,22,23,2,47,0.468,24,0.511,4,1,0.8,2,2,30,17,9,14,24,0.191,0.298,0.511,17.568,59,python
0,17,23,5,45,0.378,22,0.489,2,3,0.4,1,1,30,15,12,14,19,0.267,0.311,0.422,17.575,60,python
0,20,24,3,47,0.426,23,0.489,1,1,0.5,3,2,31,16,9,13,25,0.191,0.277,0.532,17.575,61,python
0,24,18,4,46,0.522,28,0.609,5,0,1.0,6,3,24,22,10,17,19,0.217,0.37,0.413,17.57,62,python
0,24,18,2,44,0.545,26,0.591,5,1,0.833,3,3,30,14,8,15,21,0.182,0.341,0.477,17.574,63,python
0,21,20,2,43,0.488,23,0.535,9,4,0.692,1,2,26,17,14,11,18,0.326,0.256,0.419,17.578,64,python
0,22,20,3,45,0.489,25,0.556,3,2,0.6,2,3,26,19,9,11,25,0.2,0.244,0.556,17.57,65,python
0,25,19,5,49,0.51,30,0.612,2,2,0.5,2,1,23,26,14,15,20,0.286,0.306,0.408,17.571,66,python
0,25,21,1,47,0.532,26,0.553,5,4,0.556,2,2,24,23,14,14,19,0.298,0.298,0.404,17.573,67,python
0,18,21,6,45,0.4,24,0.533,3,2,0.6,1,2,31,14,10,12,23,0.222,0.267,0.511,17.586,68,python
0,26,18,1,45,0.578,27,0.6,3,1,0.75,1,2,27,18,16,11,18,0.356,0.244,0.4,17.587,69,python
0,20,20,3,43,0.465,23,0.535,4,0,1.0,2,3,23,20,13,13,17,0.302,0.302,0.395,17.587,70,python
0,17,27,2,46,0.37,19,0.413,2,4,0.333,3,6,29,17,8,13,25,0.174,0.283,0.543,17.587,71,python
0,20,25,5,50,0.4,25,0.5,3,5,0.375,2,2,34,16,10,14,26,0.2,0.28,0.52,17.586,72,python
0,20,21,4,45,0.444,24,0.533,1,2,0.333,2,3,25,20,12,15,18,0.267,0.333,0.4,17.585,73,python
0,22,20,4,46,0.478,26,0.565,1,1,0.5,4,1,29,17,10,14,22,0.217,0.304,0.478,17.568,74,python
0,20,16,9,45,0.444,29,0.644,2,6,0.25,3,1,26,19,8,14,23,0.178,0.311,0.511,17.575,75,python
0,11,31,6,48,0.229,17,0.354,2,3,0.4,2,4,36,12,5,14,29,0.104,0.292,0.604,17.585,76,python
0,23,22,1,46,0.5,24,0.522,4,1,0.8,2,1,28,18,10,13,23,0.217,0.283,0.5,17.583,77,python
0,15,29,1,45,0.333,16,0.356,2,4,0.333,2,1,26,19,4,15,26,0.089,0.333,0.578,17.587,78,python
0,29,14,4,47,0.617,33,0.702,8,3,0.727,2,2,25,22,13,17,17,0.277,0.362,0.362,17.589,79,python
0,20,21,1,42,0.476,21,0.5,2,0,1.0,2,1,27,15,9,14,19,0.214,0.333,0.452,17.593,80,python
0,18,30,1,49,0.367,19,0.388,2,6,0.25,1,4,30,19,9,17,23,0.184,0.347,0.469,17.589,81,python
0,21,20,3,44,0.477,24,0.545,3,3,0.5,0,1,29,15,10,11,23,0.227,0.25,0.523,17.59,82,python
0,18,19,6,43,0.419,24,0.558,3,4,0.429,2,0,27,16,8,18,17,0.186,0.419,0.395,17.599,83,python
0,17,25,3,45,0.378,20,0.444,2,3,0.4,3,0,33,12,7,12,26,0.156,0.267,0.578,17.601,84,python
0,23,20,1,44,0.523,24,0.545,3,1,0.75,1,2,25,19,12,14,18,0.273,0.318,0.409,17.601,85,python
0,21,22,5,48,0.438,26,0.542,5,4,0.556,1,3,33,15,11,18,19,0.229,0.375,0.396,17.602,86,python
0,24,19,2,45,0.533,26,0.578,6,1,0.857,6,3,29,16,11,12,22,0.244,0.267,0.489,17.598,87,python
0,15,27,4,46,0.326,19,0.413,1,4,0.2,3,2,22,24,8,20,18,0.174,0.435,0.391,17.599,88,python
0,20,23,5,48,0.417,25,0.521,6,4,0.6,2,4,24,24,10,12,26,0.208,0.25,0.542,17.6,89,python
0,21,17,9,47,0.447,30,0.638,5,3,0.625,1,5,28,19,12,13,22,0.255,0.277,0.468,17.604,90,python
0,15,23,5,43,0.349,20,0.465,1,1,0.5,2,3,31,12,9,16,18,0.209,0.372,0.419,17.605,91,python
0,24,18,3,45,0.533,27,0.6,3,3,0.5,1,2,28,17,11,17,17,0.244,0.378,0.378,17.61,92,python
0,16,25,4,45,0.356,20,0.444,2,3,0.4,2,4,29,16,7,12,26,0.156,0.267,0.578,17.61,93,python
0,19,24,3,46,0.413,22,0.478,2,3,0.4,2,1,27,19,6,19,21,0.13,0.413,0.457,17.609,94,python
0,19,23,4,46,0.413,23,0.5,2,3,0.4,4,3,26,20,11,17,18,0.239,0.37,0.391,17.615,95,python
0,17,26,6,49,0.347,23,0.469,5,5,0.5,3,1,31,18,6,18,25,0.122,0.367,0.51,17.615,96,python
0,26,17,3,46,0.565,29,0.63,1,1,0.5,2,4,27,19,15,14,17,0.326,0.304,0.37,17.304,1,python
0,26,17,3,46,0.565,29,0.63,2,2,0.5,4,1,30,16,14,14,18,0.304,0.304,0.391,17.442,2,python
0,24,18,2,44,0.545,26,0.591,1,1,0.5,2,1,26,18,12,15,17,0.273,0.341,0.386,17.663,3,python
0,16,28,5,49,0.327,21,0.429,4,2,0.667,3,2,25,24,8,16,25,0.163,0.327,0.51,17.532,4,python
0,21,18,9,48,0.438,30,0.625,1,2,0.333,4,0,32,16,9,19,20,0.188,0.396,0.417,17.578,5,python
0,19,20,5,44,0.432,24,0.545,2,2,0.5,1,1,31,13,11,17,16,0.25,0.386,0.364,17.611,6,python
0,27,13,5,45,0.6,32,0.711,5,2,0.714,0,0,31,14,12,9,24,0.267,0.2,0.533,17.534,7,python
0,18,25,5,48,0.375,23,0.479,1,7,0.125,1,2,29,19,11,17,20,0.229,0.354,0.417,17.508,8,python
0,20,23,2,45,0.444,22,0.489,1,1,0.5,3,3,30,15,6,14,25,0.133,0.311,0.556,17.58,9,python
0,15,24,5,44,0.341,20,0.455,1,3,0.25,2,2,24,20,10,14,20,0.227,0.318,0.455,17.598,10,python
0,21,22,2,45,0.467,23,0.511,1,3,0.25,3,2,27,18,12,12,21,0.267,0.267,0.467,17.612,11,python
0,17,26,2,45,0.378,19,0.422,5,1,0.833,3,1,25,20,10,16,19,0.222,0.356,0.422,17.573,12,python
0,16,24,5,45,0.356,21,0.467,2,2,0.5,1,1,26,19,8,20,17,0.178,0.444,0.378,17.621,13,python
0,26,16,3,45,0.578,29,0.644,4,1,0.8,2,0,26,19,17,10,18,0.378,0.222,0.4,17.652,14,python
0,24,20,2,46,0.522,26,0.565,3,1,0.75,2,0,27,19,15,14,17,0.326,0.304,0.37,17.646,15,python
0,21,22,3,46,0.457,24,0.522,5,1,0.833,2,2,29,17,12,12,22,0.261,0.261,0.478,17.626,16,python
0,26,15,4,45,0.578,30,0.667,2,0,1.0,0,4,24,21,18,10,17,0.4,0.222,0.378,17.645,17,python
0,17,22,5,44,0.386,22,0.5,3,2,0.6,3,0,25,19,10,17,17,0.227,0.386,0.386,17.651,18,python
0,23,19,1,43,0.535,24,0.558,4,2,0.667,1,3,26,17,11,15,17,0.256,0.349,0.395,17.645,19,python
0,17,24,6,47,0.362,23,0.489,3,2,0.6,1,3,23,24,11,18,18,0.234,0.383,0.383,17.648,20,python
0,19,25,4,48,0.396,23,0.479,3,6,0.333,2,0,27,21,8,19,21,0.167,0.396,0.438,17.604,21,python
0,21,20,5,46,0.457,26,0.565,4,1,0.8,3,2,28,18,8,15,23,0.174,0.326,0.5,17.573,22,python
0,20,19,6,45,0.444,26,0.578,1,1,0.5,4,2,25,20,11,13,21,0.244,0.289,0.467,17.578,23,python
0,21,23,3,47,0.447,24,0.511,3,2,0.6,1,1,28,19,14,11,22,0.298,0.234,0.468,17.594,24,python
0,24,23,1,48,0.5,25,0.521,3,1,0.75,2,4,32,16,11,14,23,0.229,0.292,0.479,17.591,25,python
0,28,19,1,48,0.583,29,0.604,6,2,0.75,2,2,26,22,19,9,20,0.396,0.188,0.417,17.58,26,python
0,17,22,5,44,0.386,22,0.5,3,2,0.6,1,1,32,12,9,13,22,0.205,0.295,0.5,17.568,27,python
0,20,19,4,43,0.465,24,0.558,5,2,0.714,0,1,24,19,14,14,15,0.326,0.326,0.349,17.596,28,python
0,21,20,4,45,0.467,25,0.556,3,2,0.6,5,2,31,14,11,14,20,0.244,0.311,0.444,17.575,29,python
0,23,20,1,44,0.523,24,0.545,4,2,0.667,3,1,22,22,14,13,17,0.318,0.295,0.386,17.581,30,python
0,21,21,3,45,0.467,24,0.533,3,0,1.0,1,1,26,19,13,12,20,0.289,0.267,0.444,17.57,31,python
0,20,25,1,46,0.435,21,0.457,2,5,0.286,4,2,28,18,9,14,23,0.196,0.304,0.5,17.549,32,python
0,20,26,2,48,0.417,22,0.458,0,3,0.0,3,2,27,21,13,13,22,0.271,0.271,0.458,17.546,33,python
0,16,24,6,46,0.348,22,0.478,4,1,0.8,3,5,35,11,7,12,27,0.152,0.261,0.587,17.551,34,python
0,25,21,0,46,0.543,25,0.543,4,0,1.0,5,0,28,18,11,17,18,0.239,0.37,0.391,17.541,35,python
0,18,24,4,46,0.391,22,0.478,3,2,0.6,1,2,30,16,12,13,21,0.261,0.283,0.457,17.548,36,python
0,21,20,3,44,0.477,24,0.545,2,2,0.5,1,1,23,21,11,18,15,0.25,0.409,0.341,17.572,37,python
0,23,20,4,47,0.489,27,0.574,4,2,0.667,2,3,26,21,14,14,19,0.298,0.298,0.404,17.572,38,python
0,21,22,1,44,0.477,22,0.5,4,1,0.8,2,4,32,12,6,13,25,0.136,0.295,0.568,17.575,39,python
0,19,19,6,44,0.432,25,0.568,2,3,0.4,3,0,27,17,9,16,19,0.205,0.364,0.432,17.578,40,python
0,16,25,2,43,0.372,18,0.419,3,2,0.6,3,2,29,14,9,11,23,0.209,0.256,0.535,17.574,41,python
0,21,23,2,46,0.457,23,0.5,5,1,0.833,2,5,32,14,9,11,26,0.196,0.239,0.565,17.582,42,python
0,17,20,8,45,0.378,25,0.556,3,2,0.6,1,5,30,15,9,14,22,0.2,0.311,0.489,17.59,43,python
0,16,28,2,46,0.348,18,0.391,2,6,0.25,4,1,27,19,7,16,23,0.152,0.348,0.5,17.606,44,python
0,27,18,1,46,0.587,28,0.609,5,1,0.833,2,3,27,19,16,8,22,0.348,0.174,0.478,17.595,45,python
0,25,21,1,47,0.532,26,0.553,3,1,0.75,5,4,33,14,9,11,27,0.191,0.234,0.574,17.584,46,python
0,24,17,4,45,0.533,28,0.622,6,2,0.75,5,1,28,17,9,18,18,0.2,0.4,0.4,17.572,47,python
0,22,21,5,48,0.458,27,0.562,0,4,0.0,4,4,34,14,11,16,21,0.229,0.333,0.438,17.576,48,python
0,23,16,4,43,0.535,27,0.628,3,1,0.75,0,1,23,20,13,12,18,0.302,0.279,0.419,17.593,49,python
0,16,27,3,46,0.348,19,0.413,2,1,0.667,1,4,27,19,9,16,21,0.196,0.348,0.457,17.578,50,python
0,20,21,6,47,0.426,26,0.553,2,1,0.667,1,3,28,19,11,14,22,0.234,0.298,0.468,17.577,51,python
0,16,24,3,43,0.372,19,0.442,5,4,0.556,1,3,28,15,9,14,20,0.209,0.326,0.465,17.582,52,python
0,22,19,5,46,0.478,27,0.587,4,1,0.8,1,4,30,16,11,16,19,0.239,0.348,0.413,17.587,53,python
0,19,20,5,44,0.432,24,0.545,5,1,0.833,2,3,23,21,13,9,22,0.295,0.205,0.5,17.585,54,python
0,20,20,4,44,0.455,24,0.545,3,0,1.0,1,2,31,13,7,14,23,0.159,0.318,0.523,17.596,55,python
0,22,19,5,46,0.478,27,0.587,2,1,0.667,2,2,25,21,10,22,14,0.217,0.478,0.304,17.607,56,python
0,21,23,3,47,0.447,24,0.511,6,3,0.667,2,5,30,17,12,11,24,0.255,0.234,0.511,17.604,57,python
0,23,20,2,45,0.511,25,0.556,4,1,0.8,2,3,25,20,15,9,21,0.333,0.2,0.467,17.599,58,python
0,24,21,3,48,0.5,27,0.562,2,3,0.4,1,1,30,18,11,15,22,0.229,0.312,0.458,17.603,59,python
0,24,16,6,46,0.522,30,0.652,4,1,0.8,5,2,22,24,15,11,20,0.326,0.239,0.435,17.592,60,python
0,23,21,1,45,0.511,24,0.533,4,4,0.5,4,2,25,20,13,12,20,0.289,0.267,0.444,17.58,61,python
0,29,13,3,45,0.644,32,0.711,4,1,0.8,8,1,29,16,10,10,25,0.222,0.222,0.556,17.569,62,python
0,21,25,3,49,0.429,24,0.49,4,2,0.667,1,1,26,23,12,19,18,0.245,0.388,0.367,17.582,63,python
0,24,20,4,48,0.5,28,0.583,2,3,0.4,2,3,28,20,14,14,20,0.292,0.292,0.417,17.591,64,python
0,22,15,8,45,0.489,30,0.667,4,4,0.5,4,0,31,14,14,10,21,0.311,0.222,0.467,17.598,65,python
0,18,23,2,43,0.419,20,0.465,1,2,0.333,1,4,29,14,6,14,23,0.14,0.326,0.535,17.6,66,python
0,23,22,2,47,0.489,25,0.532,4,1,0.8,2,0,31,16,7,12,28,0.149,0.255,0.596,17.601,67,python
0,22,20,4,46,0.478,26,0.565,5,1,0.833,4,2,23,23,16,10,20,0.348,0.217,0.435,17.591,68,python
0,20,25,1,46,0.435,21,0.457,2,2,0.5,2,3,24,22,11,15,20,0.239,0.326,0.435,17.587,69,python
0,14,23,6,43,0.326,20,0.465,2,2,0.5,1,2,26,17,6,16,21,0.14,0.372,0.488,17.589,70,python
0,23,21,1,45,0.511,24,0.533,6,4,0.6,3,3,25,20,9,11,25,0.2,0.244,0.556,17.584,71,python
0,18,24,4,46,0.391,22,0.478,2,2,0.5,2,1,30,16,11,17,18,0.239,0.37,0.391,17.586,72,python
0,23,17,3,43,0.535,26,0.605,5,0,1.0,2,1,25,18,16,12,15,0.372,0.279,0.349,17.591,73,python
0,20,25,3,48,0.417,23,0.479,2,1,0.667,3,3,30,18,6,15,27,0.125,0.312,0.562,17.577,74,python
0,16,27,4,47,0.34,20,0.426,6,1,0.857,0,3,30,17,11,15,21,0.234,0.319,0.447,17.577,75,python
0,23,16,7,46,0.5,30,0.652,3,0,1.0,3,2,20,26,13,17,16,0.283,0.37,0.348,17.585,76,python
0,15,25,5,45,0.333,20,0.444,2,3,0.4,2,3,27,18,8,19,18,0.178,0.422,0.4,17.591,77,python
0,20,24,2,46,0.435,22,0.478,2,2,0.5,2,0,21,25,10,14,22,0.217,0.304,0.478,17.591,78,python
0,19,23,3,45,0.422,22,0.489,1,2,0.333,1,2,31,14,12,14,19,0.267,0.311,0.422,17.591,79,python
0,16,23,6,45,0.356,22,0.489,1,2,0.333,4,0,27,18,8,13,24,0.178,0.289,0.533,17.594,80,python
0,18,25,4,47,0.383,22,0.468,3,0,1.0,1,3,35,12,8,16,23,0.17,0.34,0.489,17.602,81,python
0,18,25,5,48,0.375,23,0.479,2,2,0.5,1,1,31,17,8,17,23,0.167,0.354,0.479,17.603,82,python
0,21,19,4,44,0.477,25,0.568,3,2,0.6,3,3,24,20,9,20,15,0.205,0.455,0.341,17.605,83,python
0,19,21,3,43,0.442,22,0.512,2,4,0.333,1,1,26,17,10,14,19,0.233,0.326,0.442,17.606,84,python
0,26,16,3,45,0.578,29,0.644,3,0,1.0,4,2,29,16,16,7,22,0.356,0.156,0.489,17.61,85,python
0,18,24,4,46,0.391,22,0.478,3,0,1.0,0,2,28,18,9,19,18,0.196,0.413,0.391,17.617,86,python
0,20,19,5,44,0.455,25,0.568,4,2,0.667,4,1,27,17,11,12,21,0.25,0.273,0.477,17.62,87,python
0,21,23,1,45,0.467,22,0.489,3,5,0.375,3,3,29,16,11,12,22,0.244,0.267,0.489,17.623,88,python
0,17,27,1,45,0.378,18,0.4,2,2,0.5,1,2,24,21,11,12,22,0.244,0.267,0.489,17.622,89,python
0,13,25,10,48,0.271,23,0.479,0,2,0.0,1,2,28,20,7,18,23,0.146,0.375,0.479,17.63,90,python
0,25,19,4,48,0.521,29,0.604,4,0,1.0,1,2,32,16,12,15,21,0.25,0.312,0.438,17.629,91,python
0,18,21,5,44,0.409,23,0.523,1,1,0.5,1,4,28,16,11,13,20,0.25,0.295,0.455,17.624,92,python
0,24,21,5,50,0.48,29,0.58,1,2,0.333,2,6,27,23,12,14,24,0.24,0.28,0.48,17.623,93,python
0,16,23,6,45,0.356,22,0.489,4,7,0.364,2,1,23,22,8,17,20,0.178,0.378,0.444,17.625,94,python
0,21,21,2,44,0.477,23,0.523,3,3,0.5,2,1,27,17,11,13,20,0.25,0.295,0.455,17.626,95,python
0,26,14,3,43,0.605,29,0.674,3,2,0.6,2,0,23,20,15,14,14,0.349,0.326,0.326,17.626,96,python
0,13,26,6,45,0.289,19,0.422,5,2,0.714,1,5,27,18,6,16,23,0.133,0.356,0.511,18.586,1,python
0,17,20,7,44,0.386,24,0.545,3,3,0.5,3,0,27,17,6,16,22,0.136,0.364,0.5,17.742,2,python
0,19,24,3,46,0.413,22,0.478,4,2,0.667,4,1,29,17,7,19,20,0.152,0.413,0.435,17.818,3,python
0,20,21,4,45,0.444,24,0.533,4,3,0.571,1,3,27,18,14,13,18,0.311,0.289,0.4,17.762,4,python
0,17,27,2,46,0.37,19,0.413,3,5,0.375,1,2,24,22,11,15,20,0.239,0.326,0.435,17.94,5,python
0,13,28,3,44,0.295,16,0.364,2,5,0.286,0,0,25,19,9,18,17,0.205,0.409,0.386,18.065,6,python
0,25,17,3,45,0.556,28,0.622,6,1,0.857,4,0,28,17,11,12,22,0.244,0.267,0.489,17.972,7,python
0,18,25,3,46,0.391,21,0.457,1,0,1.0,2,0,26,20,10,20,16,0.217,0.435,0.348,17.921,8,python
0,18,24,3,45,0.4,21,0.467,2,4,0.333,1,3,25,20,10,15,20,0.222,0.333,0.444,17.926,9,python
0,21,23,2,46,0.457,23,0.5,2,2,0.5,2,1,29,17,17,11,18,0.37,0.239,0.391,17.824,10,python
0,23,21,3,47,0.489,26,0.553,3,1,0.75,1,1,25,22,13,17,17,0.277,0.362,0.362,17.83,11,python
0,19,21,3,43,0.442,22,0.512,3,3,0.5,1,1,26,17,13,11,19,0.302,0.256,0.442,17.806,12,python
0,21,17,6,44,0.477,27,0.614,3,3,0.5,2,2,29,15,13,12,19,0.295,0.273,0.432,17.828,13,python
0,15,27,2,44,0.341,17,0.386,2,5,0.286,1,1,27,17,8,17,19,0.182,0.386,0.432,17.814,14,python
0,25,18,4,47,0.532,29,0.617,4,2,0.667,1,3,26,21,14,17,16,0.298,0.362,0.34,17.835,15,python
0,16,23,5,44,0.364,21,0.477,4,1,0.8,0,3,25,19,12,15,17,0.273,0.341,0.386,17.851,16,python
0,16,29,1,46,0.348,17,0.37,1,3,0.25,2,3,29,17,7,15,24,0.152,0.326,0.522,17.845,17,python
0,20,25,2,47,0.426,22,0.468,5,3,0.625,5,3,24,23,10,13,24,0.213,0.277,0.511,17.814,18,python
0,19,18,7,44,0.432,26,0.591,2,2,0.5,1,3,30,14,9,14,21,0.205,0.318,0.477,17.78,19,python
0,15,24,6,45,0.333,21,0.467,2,2,0.5,1,4,28,17,8,16,21,0.178,0.356,0.467,17.791,20,python
0,15,27,4,46,0.326,19,0.413,0,2,0.0,5,0,28,18,3,20,23,0.065,0.435,0.5,17.792,21,python
0,23,23,2,48,0.479,25,0.521,2,3,0.4,3,4,28,20,15,14,19,0.312,0.292,0.396,17.788,22,python
0,21,21,3,45,0.467,24,0.533,6,1,0.857,1,2,25,20,9,17,19,0.2,0.378,0.422,17.801,23,python
0,22,20,4,46,0.478,26,0.565,1,1,0.5,3,2,24,22,10,16,20,0.217,0.348,0.435,17.758,24,python
0,14,27,1,42,0.333,15,0.357,2,2,0.5,1,3,34,8,6,17,19,0.143,0.405,0.452,17.767,25,python
0,22,25,0,47,0.468,22,0.468,5,4,0.556,3,1,27,20,13,16,18,0.277,0.34,0.383,17.77,26,python
0,18,23,4,45,0.4,22,0.489,3,3,0.5,4,1,31,14,9,16,20,0.2,0.356,0.444,17.772,27,python
0,18,20,6,44,0.409,24,0.545,3,3,0.5,2,1,26,18,11,12,21,0.25,0.273,0.477,17.767,28,python
0,17,25,6,48,0.354,23,0.479,4,2,0.667,1,1,34,14,9,15,24,0.188,0.312,0.5,17.773,29,python
0,19,23,2,44,0.432,21,0.477,2,3,0.4,1,3,26,18,11,14,19,0.25,0.318,0.432,17.784,30,python
0,23,18,3,44,0.523,26,0.591,4,3,0.571,3,0,29,15,9,14,21,0.205,0.318,0.477,17.758,31,python
0,18,23,6,47,0.383,24,0.511,3,3,0.5,2,2,29,18,9,17,21,0.191,0.362,0.447,17.748,32,python
0,19,19,6,44,0.432,25,0.568,3,5,0.375,2,1,26,18,11,15,18,0.25,0.341,0.409,17.752,33,python
0,14,22,8,44,0.318,22,0.5,3,2,0.6,1,2,30,14,8,13,23,0.182,0.295,0.523,17.747,34,python
0,13,34,2,49,0.265,15,0.306,5,1,0.833,1,3,26,23,7,19,23,0.143,0.388,0.469,17.741,35,python
0,20,18,5,43,0.465,25,0.581,3,1,0.75,1,1,23,20,14,14,15,0.326,0.326,0.349,17.737,36,python
0,22,22,3,47,0.468,25,0.532,4,0,1.0,1,2,30,17,9,16,22,0.191,0.34,0.468,17.755,37,python
0,20,18,5,43,0.465,25,0.581,2,1,0.667,3,3,25,18,14,11,18,0.326,0.256,0.419,17.742,38,python
0,21,21,4,46,0.457,25,0.543,4,4,0.5,7,0,27,19,12,13,21,0.261,0.283,0.457,17.716,39,python
0,22,23,3,48,0.458,25,0.521,2,1,0.667,2,1,28,20,14,16,18,0.292,0.333,0.375,17.706,40,python
0,27,15,5,47,0.574,32,0.681,3,3,0.5,3,4,21,26,19,7,21,0.404,0.149,0.447,17.679,41,python
0,19,22,3,44,0.432,22,0.5,6,1,0.857,1,2,25,19,12,13,19,0.273,0.295,0.432,17.652,42,python
0,22,20,3,45,0.489,25,0.556,2,2,0.5,2,3,31,14,10,14,21,0.222,0.311,0.467,17.669,43,python
0,25,19,3,47,0.532,28,0.596,2,1,0.667,2,3,28,19,19,9,19,0.404,0.191,0.404,17.677,44,python
0,25,19,3,47,0.532,28,0.596,7,1,0.875,2,3,29,18,13,13,21,0.277,0.277,0.447,17.681,45,python
0,19,22,6,47,0.404,25,0.532,1,1,0.5,1,3,30,17,10,16,21,0.213,0.34,0.447,17.682,46,python
0,22,19,4,45,0.489,26,0.578,2,2,0.5,3,2,27,18,10,16,19,0.222,0.356,0.422,17.688,47,python
0,16,26,2,44,0.364,18,0.409,2,4,0.333,0,3,31,13,11,12,21,0.25,0.273,0.477,17.692,48,python
0,21,21,3,45,0.467,24,0.533,3,3,0.5,2,2,30,15,8,16,21,0.178,0.356,0.467,17.703,49,python
0,24,17,4,45,0.533,28,0.622,5,1,0.833,1,2,29,16,11,14,20,0.244,0.311,0.444,17.714,50,python
0,25,16,5,46,0.543,30,0.652,6,1,0.857,1,0,30,16,10,15,21,0.217,0.326,0.457,17.719,51,python
0,24,18,3,45,0.533,27,0.6,4,2,0.667,3,1,25,20,13,13,19,0.289,0.289,0.422,17.713,52,python
0,19,23,2,44,0.432,21,0.477,2,2,0.5,1,2,30,14,9,14,21,0.205,0.318,0.477,17.705,53,python
0,17,23,5,45,0.378,22,0.489,1,4,0.2,6,2,26,19,6,17,22,0.133,0.378,0.489,17.693,54,python
0,21,22,1,44,0.477,22,0.5,5,1,0.833,2,2,29,15,12,13,19,0.273,0.295,0.432,17.695,55,python
0,22,20,2,44,0.5,24,0.545,4,3,0.571,0,2,22,22,16,14,14,0.364,0.318,0.318,17.7,56,python
0,17,21,8,46,0.37,25,0.543,3,3,0.5,3,4,30,16,10,17,19,0.217,0.37,0.413,17.694,57,python
0,19,25,2,46,0.413,21,0.457,1,6,0.143,3,1,34,12,7,17,22,0.152,0.37,0.478,17.7,58,python
0,22,17,7,46,0.478,29,0.63,0,2,0.0,7,2,28,18,9,17,20,0.196,0.37,0.435,17.701,59,python
0,21,23,4,48,0.438,25,0.521,4,7,0.364,2,1,25,23,8,19,21,0.167,0.396,0.438,17.711,60,python
0,19,24,3,46,0.413,22,0.478,2,1,0.667,0,2,25,21,9,17,20,0.196,0.37,0.435,17.714,61,python
0,18,27,2,47,0.383,20,0.426,0,5,0.0,3,1,24,23,11,15,21,0.234,0.319,0.447,17.707,62,python
0,23,20,2,45,0.511,25,0.556,1,3,0.25,1,0,31,14,10,13,22,0.222,0.289,0.489,17.706,63,python
0,23,17,6,46,0.5,29,0.63,4,1,0.8,3,2,32,14,12,9,25,0.261,0.196,0.543,17.7,64,python
0,19,23,3,45,0.422,22,0.489,6,3,0.667,3,4,26,19,7,15,23,0.156,0.333,0.511,17.703,65,python
0,21,19,4,44,0.477,25,0.568,3,3,0.5,4,2,28,16,9,15,20,0.205,0.341,0.455,17.696,66,python
0,19,25,0,44,0.432,19,0.432,4,4,0.5,0,3,34,10,7,10,27,0.159,0.227,0.614,17.685,67,python
0,26,15,4,45,0.578,30,0.667,2,2,0.5,4,2,29,16,12,13,20,0.267,0.289,0.444,17.68,68,python
0,26,18,5,49,0.531,31,0.633,1,1,0.5,4,2,31,18,12,13,24,0.245,0.265,0.49,17.668,69,python
0,13,30,3,46,0.283,16,0.348,0,2,0.0,0,6,22,24,8,21,17,0.174,0.457,0.37,17.671,70,python
0,16,26,1,43,0.372,17,0.395,3,1,0.75,2,0,29,14,9,10,24,0.209,0.233,0.558,17.674,71,python
0,16,26,6,48,0.333,22,0.458,1,4,0.2,2,1,24,24,8,23,17,0.167,0.479,0.354,17.674,72,python
0,19,23,6,48,0.396,25,0.521,4,0,1.0,4,3,34,14,10,10,28,0.208,0.208,0.583,17.664,73,python
0,15,23,5,43,0.349,20,0.465,1,3,0.25,0,0,27,16,11,16,16,0.256,0.372,0.372,17.657,74,python
0,15,26,3,44,0.341,18,0.409,3,2,0.6,1,2,30,14,5,13,26,0.114,0.295,0.591,17.657,75,python
0,21,22,2,45,0.467,23,0.511,2,1,0.667,5,1,21,24,11,11,23,0.244,0.244,0.511,17.635,76,python
0,18,21,6,45,0.4,24,0.533,2,4,0.333,2,0,31,14,8,11,26,0.178,0.244,0.578,17.641,77,python
0,26,18,3,47,0.553,29,0.617,4,4,0.5,3,1,31,16,13,12,22,0.277,0.255,0.468,17.636,78,python
0,22,20,3,45,0.489,25,0.556,5,7,0.417,1,1,21,24,11,22,12,0.244,0.489,0.267,17.637,79,python
0,20,19,7,46,0.435,27,0.587,3,2,0.6,1,1,26,20,14,16,16,0.304,0.348,0.348,17.645,80,python
0,21,21,4,46,0.457,25,0.543,3,1,0.75,6,3,28,18,10,10,26,0.217,0.217,0.565,17.647,81,python
0,21,20,2,43,0.488,23,0.535,3,1,0.75,3,2,24,19,16,11,16,0.372,0.256,0.372,17.643,82,python
0,21,23,0,44,0.477,21,0.477,3,2,0.6,0,2,25,19,13,15,16,0.295,0.341,0.364,17.656,83,python
0,20,21,4,45,0.444,24,0.533,4,4,0.5,2,0,27,18,11,13,21,0.244,0.289,0.467,17.66,84,python
0,18,25,2,45,0.4,20,0.444,3,3,0.5,1,3,28,17,10,13,22,0.222,0.289,0.489,17.656,85,python
0,18,23,6,47,0.383,24,0.511,0,3,0.0,3,1,28,19,9,22,16,0.191,0.468,0.34,17.656,86,python
0,21,23,3,47,0.447,24,0.511,2,4,0.333,1,2,27,20,10,14,23,0.213,0.298,0.489,17.655,87,python
0,22,20,5,47,0.468,27,0.574,3,5,0.375,4,1,31,16,10,13,24,0.213,0.277,0.511,17.661,88,python
0,18,22,6,46,0.391,24,0.522,3,3,0.5,4,1,29,17,11,13,22,0.239,0.283,0.478,17.662,89,python
0,18,24,3,45,0.4,21,0.467,2,4,0.333,0,1,27,18,9,18,18,0.2,0.4,0.4,17.666,90,python
0,12,30,6,48,0.25,18,0.375,2,4,0.333,2,4,34,14,7,8,33,0.146,0.167,0.688,17.661,91,python
0,27,16,4,47,0.574,31,0.66,3,2,0.6,5,4,27,20,12,13,22,0.255,0.277,0.468,17.664,92,python
0,23,19,3,45,0.511,26,0.578,3,2,0.6,0,0,28,17,10,16,19,0.222,0.356,0.422,17.664,93,python
0,19,20,7,46,0.413,26,0.565,6,0,1.0,2,1,27,19,10,13,23,0.217,0.283,0.5,17.666,94,python
0,20,21,4,45,0.444,24,0.533,2,2,0.5,1,2,21,24,10,16,19,0.222,0.356,0.422,17.671,95,python
0,18,22,4,44,0.409,22,0.5,1,0,1.0,0,2,29,15,13,15,16,0.295,0.341,0.364,17.672,96,python
0,20,22,3,45,0.444,23,0.511,1,2,0.333,4,1,27,18,9,17,19,0.2,0.378,0.422,17.647,1,python
0,20,24,3,47,0.426,23,0.489,3,3,0.5,4,4,28,19,10,14,23,0.213,0.298,0.489,17.879,2,python
0,20,19,5,44,0.455,25,0.568,2,0,1.0,0,2,20,24,16,13,15,0.364,0.295,0.341,17.742,3,python
0,21,22,6,49,0.429,27,0.551,2,1,0.667,1,5,35,14,11,11,27,0.224,0.224,0.551,17.817,4,python
0,19,24,2,45,0.422,21,0.467,1,5,0.167,2,2,30,15,9,12,24,0.2,0.267,0.533,17.675,5,python
0,21,18,5,44,0.477,26,0.591,2,3,0.4,3,0,27,17,11,18,15,0.25,0.409,0.341,17.732,6,python
0,21,22,2,45,0.467,23,0.511,1,1,0.5,4,0,27,18,7,18,20,0.156,0.4,0.444,17.698,7,python
0,19,21,5,45,0.422,24,0.533,0,2,0.0,2,0,29,16,12,16,17,0.267,0.356,0.378,17.731,8,python
0,22,19,4,45,0.489,26,0.578,5,3,0.625,3,5,34,11,10,13,22,0.222,0.289,0.489,17.725,9,python
0,18,16,10,44,0.409,28,0.636,3,2,0.6,3,2,21,23,9,20,15,0.205,0.455,0.341,17.744,10,python
0,19,18,7,44,0.432,26,0.591,2,2,0.5,2,1,23,21,10,16,18,0.227,0.364,0.409,17.683,11,python
0,22,22,3,47,0.468,25,0.532,4,0,1.0,5,3,31,16,8,15,24,0.17,0.319,0.511,17.647,12,python
0,16,25,3,44,0.364,19,0.432,2,2,0.5,1,2,32,12,9,14,21,0.205,0.318,0.477,17.618,13,python
0,24,18,6,48,0.5,30,0.625,4,2,0.667,4,1,23,25,9,18,21,0.188,0.375,0.438,17.621,14,python
0,16,27,2,45,0.356,18,0.4,2,2,0.5,2,4,30,15,8,13,24,0.178,0.289,0.533,17.586,15,python
0,21,20,4,45,0.467,25,0.556,1,3,0.25,3,3,22,23,13,14,18,0.289,0.311,0.4,17.565,16,python
0,26,17,4,47,0.553,30,0.638,2,2,0.5,4,2,29,18,14,11,22,0.298,0.234,0.468,17.569,17,python
0,20,21,7,48,0.417,27,0.562,0,3,0.0,2,2,29,19,10,16,22,0.208,0.333,0.458,17.594,18,python
0,22,15,6,43,0.512,28,0.651,2,2,0.5,2,2,26,17,11,11,21,0.256,0.256,0.488,17.631,19,python
0,21,23,3,47,0.447,24,0.511,3,0,1.0,1,2,33,14,10,16,21,0.213,0.34,0.447,17.644,20,python
0,16,25,6,47,0.34,22,0.468,1,3,0.25,1,2,31,16,10,19,18,0.213,0.404,0.383,17.666,21,python
0,17,23,4,44,0.386,21,0.477,3,1,0.75,2,3,30,14,11,10,23,0.25,0.227,0.523,17.695,22,python
0,26,18,3,47,0.553,29,0.617,6,2,0.75,1,4,25,22,19,13,15,0.404,0.277,0.319,17.687,23,python
0,23,18,2,43,0.535,25,0.581,3,2,0.6,3,3,20,23,17,13,13,0.395,0.302,0.302,17.7,24,python
0,23,19,2,44,0.523,25,0.568,3,2,0.6,1,2,20,24,15,17,12,0.341,0.386,0.273,17.711,25,python
0,24,16,4,44,0.545,28,0.636,2,1,0.667,2,0,29,15,13,13,18,0.295,0.295,0.409,17.748,26,python
0,22,22,2,46,0.478,24,0.522,4,1,0.8,0,4,30,16,15,10,21,0.326,0.217,0.457,17.758,27,python
0,16,24,5,45,0.356,21,0.467,2,2,0.5,0,0,30,15,8,13,24,0.178,0.289,0.533,17.766,28,python
0,22,19,4,45,0.489,26,0.578,5,0,1.0,2,2,25,20,13,14,18,0.289,0.311,0.4,17.769,29,python
0,22,21,5,48,0.458,27,0.562,1,0,1.0,4,4,28,20,13,14,21,0.271,0.292,0.438,17.753,30,python
0,17,25,3,45,0.378,20,0.444,2,2,0.5,1,6,28,17,9,13,23,0.2,0.289,0.511,17.756,31,python
0,22,23,3,48,0.458,25,0.521,1,3,0.25,4,1,26,22,13,14,21,0.271,0.292,0.438,17.711,32,python
0,15,25,6,46,0.326,21,0.457,2,3,0.4,4,5,36,10,6,9,31,0.13,0.196,0.674,17.718,33,python
0,13,27,4,44,0.295,17,0.386,4,2,0.667,0,2,29,15,7,12,25,0.159,0.273,0.568,17.72,34,python
0,13,31,0,44,0.295,13,0.295,2,4,0.333,1,1,26,18,7,20,17,0.159,0.455,0.386,17.723,35,python
0,17,22,6,45,0.378,23,0.511,1,4,0.2,0,2,26,19,11,17,17,0.244,0.378,0.378,17.757,36,python
0,18,24,3,45,0.4,21,0.467,3,3,0.5,0,0,29,16,11,19,15,0.244,0.422,0.333,17.769,37,python
0,22,21,2,45,0.489,24,0.533,3,0,1.0,1,2,18,27,14,15,16,0.311,0.333,0.356,17.772,38,python
0,22,20,2,44,0.5,24,0.545,4,5,0.444,1,2,30,14,10,14,20,0.227,0.318,0.455,17.785,39,python
0,21,23,2,46,0.457,23,0.5,2,2,0.5,0,1,27,19,14,9,23,0.304,0.196,0.5,17.787,40,python
0,21,21,3,45,0.467,24,0.533,3,0,1.0,2,4,30,15,8,12,25,0.178,0.267,0.556,17.773,41,python
0,16,25,3,44,0.364,19,0.432,2,1,0.667,1,3,27,17,8,14,22,0.182,0.318,0.5,17.775,42,python
0,22,20,3,45,0.489,25,0.556,6,1,0.857,1,1,25,20,11,17,17,0.244,0.378,0.378,17.787,43,python
0,18,24,3,45,0.4,21,0.467,5,3,0.625,1,3,28,17,14,14,17,0.311,0.311,0.378,17.793,44,python
0,20,21,3,44,0.455,23,0.523,7,2,0.778,1,0,34,10,9,17,18,0.205,0.386,0.409,17.789,45,python
0,19,21,4,44,0.432,23,0.523,2,3,0.4,4,0,25,19,9,17,18,0.205,0.386,0.409,17.782,46,python
0,20,23,3,46,0.435,23,0.5,1,4,0.2,6,1,31,15,9,14,23,0.196,0.304,0.5,17.763,47,python
0,24,22,5,51,0.471,29,0.569,1,4,0.2,3,3,29,22,15,16,20,0.294,0.314,0.392,17.761,48,python
0,18,23,4,45,0.4,22,0.489,3,2,0.6,1,4,31,14,11,14,20,0.244,0.311,0.444,17.763,49,python
0,22,21,3,46,0.478,25,0.543,0,1,0.0,2,0,28,18,12,19,15,0.261,0.413,0.326,17.764,50,python
0,20,25,1,46,0.435,21,0.457,4,3,0.571,3,1,28,18,11,14,21,0.239,0.304,0.457,17.763,51,python
0,22,22,3,47,0.468,25,0.532,1,1,0.5,1,1,30,17,14,14,19,0.298,0.298,0.404,17.766,52,python
0,21,20,2,43,0.488,23,0.535,4,0,1.0,1,2,28,15,9,13,21,0.209,0.302,0.488,17.766,53,python
0,20,22,2,44,0.455,22,0.5,2,6,0.25,4,2,27,17,13,12,19,0.295,0.273,0.432,17.76,54,python
0,21,19,4,44,0.477,25,0.568,1,2,0.333,2,1,23,21,5,20,19,0.114,0.455,0.432,17.747,55,python
0,19,23,5,47,0.404,24,0.511,4,2,0.667,2,4,25,22,10,19,18,0.213,0.404,0.383,17.739,56,python
0,21,22,5,48,0.438,26,0.542,6,3,0.667,3,3,29,19,19,14,15,0.396,0.292,0.312,17.741,57,python
0,18,25,4,47,0.383,22,0.468,2,0,1.0,3,1,29,18,9,15,23,0.191,0.319,0.489,17.717,58,python
0,16,21,6,43,0.372,22,0.512,0,3,0.0,1,1,25,18,13,12,18,0.302,0.279,0.419,17.719,59,python
0,15,28,3,46,0.326,18,0.391,1,2,0.333,0,3,31,15,12,10,24,0.261,0.217,0.522,17.713,60,python
0,15,28,2,45,0.333,17,0.378,2,0,1.0,1,4,30,15,14,11,20,0.311,0.244,0.444,17.723,61,python
0,15,26,4,45,0.333,19,0.422,2,5,0.286,1,2,27,18,10,14,21,0.222,0.311,0.467,17.73,62,python
0,26,16,3,45,0.578,29,0.644,5,1,0.833,1,2,28,17,13,17,15,0.289,0.378,0.333,17.74,63,python
0,19,23,6,48,0.396,25,0.521,3,8,0.273,2,1,25,23,10,20,18,0.208,0.417,0.375,17.751,64,python
0,18,25,4,47,0.383,22,0.468,3,1,0.75,4,2,27,20,9,19,19,0.191,0.404,0.404,17.736,65,python
0,20,24,2,46,0.435,22,0.478,1,1,0.5,3,4,38,8,12,10,24,0.261,0.217,0.522,17.718,66,python
0,18,22,5,45,0.4,23,0.511,1,5,0.167,3,0,23,22,7,17,21,0.156,0.378,0.467,17.712,67,python
0,17,24,3,44,0.386,20,0.455,4,1,0.8,1,1,31,13,9,15,20,0.205,0.341,0.455,17.713,68,python
0,23,20,2,45,0.511,25,0.556,5,1,0.833,1,3,32,13,8,15,22,0.178,0.333,0.489,17.71,69,python
0,18,26,2,46,0.391,20,0.435,1,1,0.5,4,1,30,16,8,17,21,0.174,0.37,0.457,17.711,70,python
0,24,22,3,49,0.49,27,0.551,4,2,0.667,3,1,26,23,12,18,19,0.245,0.367,0.388,17.713,71,python
0,25,20,0,45,0.556,25,0.556,5,2,0.714,1,3,28,17,16,10,19,0.356,0.222,0.422,17.72,72,python
0,14,24,6,44,0.318,20,0.455,1,1,0.5,3,3,30,14,9,15,20,0.205,0.341,0.455,17.728,73,python
0,20,22,3,45,0.444,23,0.511,2,1,0.667,4,2,25,20,9,16,20,0.2,0.356,0.444,17.722,74,python
0,22,20,3,45,0.489,25,0.556,3,3,0.5,1,3,32,13,10,11,24,0.222,0.244,0.533,17.722,75,python
0,17,27,4,48,0.354,21,0.438,2,4,0.333,0,4,21,27,11,21,16,0.229,0.438,0.333,17.729,76,python
0,21,21,3,45,0.467,24,0.533,5,5,0.5,4,1,30,15,12,14,19,0.267,0.311,0.422,17.735,77,python
0,20,23,4,47,0.426,24,0.511,3,3,0.5,5,2,30,17,8,15,24,0.17,0.319,0.511,17.72,78,python
0,15,27,5,47,0.319,20,0.426,1,2,0.333,2,2,25,22,9,14,24,0.191,0.298,0.511,17.72,79,python
0,15,23,5,43,0.349,20,0.465,3,2,0.6,0,1,24,19,12,17,14,0.279,0.395,0.326,17.726,80,python
0,18,25,2,45,0.4,20,0.444,3,4,0.429,1,3,29,16,8,15,22,0.178,0.333,0.489,17.722,81,python
0,20,21,4,45,0.444,24,0.533,3,2,0.6,2,3,26,19,15,14,16,0.333,0.311,0.356,17.716,82,python
0,14,25,4,43,0.326,18,0.419,5,1,0.833,1,2,32,11,9,14,20,0.209,0.326,0.465,17.72,83,python
0,25,22,1,48,0.521,26,0.542,2,4,0.333,1,6,26,22,16,13,19,0.333,0.271,0.396,17.72,84,python
0,18,24,2,44,0.409,20,0.455,3,3,0.5,3,2,22,22,9,19,16,0.205,0.432,0.364,17.726,85,python
0,30,17,1,48,0.625,31,0.646,6,3,0.667,2,2,28,20,21,15,12,0.438,0.312,0.25,17.728,86,python
0,17,25,5,47,0.362,22,0.468,2,0,1.0,1,4,30,17,7,12,28,0.149,0.255,0.596,17.725,87,python
0,19,26,0,45,0.422,19,0.422,4,1,0.8,2,2,34,11,8,9,28,0.178,0.2,0.622,17.71,88,python
0,17,24,4,45,0.378,21,0.467,7,2,0.778,1,4,28,17,12,15,18,0.267,0.333,0.4,17.709,89,python
0,18,19,7,44,0.409,25,0.568,2,3,0.4,1,0,23,21,8,17,19,0.182,0.386,0.432,17.71,90,python
0,16,23,4,43,0.372,20,0.465,1,4,0.2,0,2,24,19,11,17,15,0.256,0.395,0.349,17.719,91,python
0,23,16,4,43,0.535,27,0.628,1,4,0.2,3,0,23,20,16,13,14,0.372,0.302,0.326,17.721,92,python
0,23,22,1,46,0.5,24,0.522,2,2,0.5,3,2,26,20,15,11,20,0.326,0.239,0.435,17.708,93,python
0,24,21,1,46,0.522,25,0.543,3,2,0.6,2,0,26,20,11,17,18,0.239,0.37,0.391,17.709,94,python
0,20,23,3,46,0.435,23,0.5,2,3,0.4,3,1,30,16,9,13,24,0.196,0.283,0.522,17.712,95,python
0,16,24,3,43,0.372,19,0.442,0,1,0.0,2,1,33,10,9,12,22,0.209,0.279,0.512,17.714,96,python
0,19,22,4,45,0.422,23,0.511,3,2,0.6,1,3,30,15,13,7,25,0.289,0.156,0.556,16.88,1,python
0,21,18,4,43,0.488,25,0.581,3,1,0.75,1,1,26,17,14,9,20,0.326,0.209,0.465,17.245,2,python
0,18,24,4,46,0.391,22,0.478,4,5,0.444,3,3,28,18,9,17,20,0.196,0.37,0.435,17.571,3,python
0,26,14,4,44,0.591,30,0.682,5,1,0.833,2,3,27,17,17,13,14,0.386,0.295,0.318,17.778,4,python
0,19,22,4,45,0.422,23,0.511,4,3,0.571,3,2,28,17,7,17,21,0.156,0.378,0.467,17.756,5,python
0,25,21,3,49,0.51,28,0.571,2,2,0.5,1,1,26,23,15,14,20,0.306,0.286,0.408,17.665,6,python
0,18,18,9,45,0.4,27,0.6,1,0,1.0,0,2,32,13,7,16,22,0.156,0.356,0.489,17.673,7,python
0,22,19,5,46,0.478,27,0.587,1,4,0.2,5,1,25,21,13,13,20,0.283,0.283,0.435,17.705,8,python
0,17,24,1,42,0.405,18,0.429,3,1,0.75,0,1,23,19,9,15,18,0.214,0.357,0.429,17.639,9,python
0,15,27,2,44,0.341,17,0.386,1,2,0.333,1,2,27,17,11,11,22,0.25,0.25,0.5,17.618,10,python
0,27,19,0,46,0.587,27,0.587,4,2,0.667,3,3,27,19,11,13,22,0.239,0.283,0.478,17.59,11,python
0,25,21,5,51,0.49,30,0.588,3,5,0.375,3,0,29,22,17,14,20,0.333,0.275,0.392,17.593,12,python
0,19,20,9,48,0.396,28,0.583,1,0,1.0,4,3,32,16,8,12,28,0.167,0.25,0.583,17.548,13,python
0,13,30,3,46,0.283,16,0.348,1,4,0.2,2,3,28,18,4,19,23,0.087,0.413,0.5,17.494,14,python
0,14,26,3,43,0.326,17,0.395,3,2,0.6,0,3,31,12,10,10,23,0.233,0.233,0.535,17.459,15,python
0,20,24,1,45,0.444,21,0.467,6,2,0.75,1,2,26,19,9,14,22,0.2,0.311,0.489,17.489,16,python
0,22,20,2,44,0.5,24,0.545,5,1,0.833,3,2,29,15,11,12,21,0.25,0.273,0.477,17.492,17,python
0,17,22,7,46,0.37,24,0.522,1,5,0.167,4,3,31,15,8,13,25,0.174,0.283,0.543,17.51,18,python
0,15,22,8,45,0.333,23,0.511,2,2,0.5,1,2,22,23,8,20,17,0.178,0.444,0.378,17.53,19,python
0,17,24,2,43,0.395,19,0.442,3,6,0.333,0,0,24,19,10,14,19,0.233,0.326,0.442,17.536,20,python
0,23,16,6,45,0.511,29,0.644,1,2,0.333,2,1,23,22,16,15,14,0.356,0.333,0.311,17.556,21,python
0,20,19,6,45,0.444,26,0.578,3,5,0.375,4,2,23,22,10,17,18,0.222,0.378,0.4,17.545,22,python
0,21,18,6,45,0.467,27,0.6,5,3,0.625,2,5,28,17,12,13,20,0.267,0.289,0.444,17.562,23,python
0,18,23,4,45,0.4,22,0.489,4,6,0.4,1,1,27,18,10,18,17,0.222,0.4,0.378,17.587,24,python
0,20,24,4,48,0.417,24,0.5,6,3,0.667,0,2,20,28,13,21,14,0.271,0.438,0.292,17.609,25,python
0,17,23,6,46,0.37,23,0.5,5,1,0.833,1,4,26,20,11,10,25,0.239,0.217,0.543,17.604,26,python
0,21,24,1,46,0.457,22,0.478,3,2,0.6,2,0,28,18,10,16,20,0.217,0.348,0.435,17.632,27,python
0,24,15,3,42,0.571,27,0.643,3,1,0.75,1,2,21,21,20,9,13,0.476,0.214,0.31,17.633,28,python
0,23,23,2,48,0.479,25,0.521,9,2,0.818,4,1,33,15,12,12,24,0.25,0.25,0.5,17.637,29,python
0,22,25,1,48,0.458,23,0.479,2,1,0.667,2,2,24,24,13,15,20,0.271,0.312,0.417,17.611,30,python
0,24,16,5,45,0.533,29,0.644,5,1,0.833,1,2,29,16,15,12,18,0.333,0.267,0.4,17.619,31,python
0,22,21,3,46,0.478,25,0.543,3,4,0.429,2,3,28,18,14,12,20,0.304,0.261,0.435,17.613,32,python
0,24,17,3,44,0.545,27,0.614,2,0,1.0,3,3,24,20,13,13,18,0.295,0.295,0.409,17.615,33,python
0,21,23,2,46,0.457,23,0.5,4,1,0.8,5,1,30,16,10,11,25,0.217,0.239,0.543,17.612,34,python
0,17,24,4,45,0.378,21,0.467,2,3,0.4,0,1,27,18,13,15,17,0.289,0.333,0.378,17.638,35,python
0,17,24,4,45,0.378,21,0.467,2,2,0.5,0,1,30,15,10,12,23,0.222,0.267,0.511,17.642,36,python
0,16,23,6,45,0.356,22,0.489,0,2,0.0,2,2,25,20,10,14,21,0.222,0.311,0.467,17.632,37,python
0,18,20,7,45,0.4,25,0.556,1,1,0.5,3,3,25,20,9,17,19,0.2,0.378,0.422,17.624,38,python
0,13,28,3,44,0.295,16,0.364,1,3,0.25,0,4,29,15,7,17,20,0.159,0.386,0.455,17.634,39,python
0,18,25,4,47,0.383,22,0.468,2,3,0.4,1,1,34,13,10,18,19,0.213,0.383,0.404,17.635,40,python
0,18,21,6,45,0.4,24,0.533,1,2,0.333,2,3,29,16,7,15,23,0.156,0.333,0.511,17.629,41,python
0,19,21,4,44,0.432,23,0.523,6,2,0.75,1,1,29,15,10,15,19,0.227,0.341,0.432,17.636,42,python
0,21,17,8,46,0.457,29,0.63,3,3,0.5,0,0,24,22,11,15,20,0.239,0.326,0.435,17.646,43,python
0,16,26,2,44,0.364,18,0.409,0,3,0.0,3,3,28,16,9,14,21,0.205,0.318,0.477,17.634,44,python
0,18,25,2,45,0.4,20,0.444,3,3,0.5,3,3,32,13,6,9,30,0.133,0.2,0.667,17.63,45,python
0,17,25,3,45,0.378,20,0.444,3,1,0.75,1,1,29,16,14,11,20,0.311,0.244,0.444,17.641,46,python
0,24,17,2,43,0.558,26,0.605,4,2,0.667,2,1,20,23,20,13,10,0.465,0.302,0.233,17.66,47,python
0,21,24,0,45,0.467,21,0.467,2,2,0.5,3,3,27,18,10,12,23,0.222,0.267,0.511,17.663,48,python
0,16,27,5,48,0.333,21,0.438,3,2,0.6,1,1,32,16,10,11,27,0.208,0.229,0.562,17.664,49,python
0,21,18,6,45,0.467,27,0.6,3,2,0.6,2,3,26,19,8,16,21,0.178,0.356,0.467,17.665,50,python
0,21,23,2,46,0.457,23,0.5,3,2,0.6,3,4,29,17,12,10,24,0.261,0.217,0.522,17.656,51,python
0,25,18,3,46,0.543,28,0.609,2,2,0.5,2,4,31,15,15,9,22,0.326,0.196,0.478,17.657,52,python
0,17,24,4,45,0.378,21,0.467,2,4,0.333,1,1,29,16,10,14,21,0.222,0.311,0.467,17.667,53,python
0,18,25,4,47,0.383,22,0.468,3,1,0.75,2,2,28,19,9,15,23,0.191,0.319,0.489,17.671,54,python
0,19,21,6,46,0.413,25,0.543,3,3,0.5,3,6,30,16,10,13,23,0.217,0.283,0.5,17.654,55,python
0,17,23,5,45,0.378,22,0.489,2,2,0.5,2,1,29,16,9,15,21,0.2,0.333,0.467,17.641,56,python
0,17,24,6,47,0.362,23,0.489,3,4,0.429,3,2,27,20,10,14,23,0.213,0.298,0.489,17.645,57,python
0,18,24,4,46,0.391,22,0.478,2,2,0.5,3,6,31,15,5,18,23,0.109,0.391,0.5,17.641,58,python
0,24,19,3,46,0.522,27,0.587,5,2,0.714,3,2,27,19,15,6,25,0.326,0.13,0.543,17.638,59,python
0,22,23,3,48,0.458,25,0.521,0,2,0.0,3,2,23,25,14,16,18,0.292,0.333,0.375,17.633,60,python
0,13,27,4,44,0.295,17,0.386,1,1,0.5,2,2,26,18,7,16,21,0.159,0.364,0.477,17.63,61,python
0,21,24,1,46,0.457,22,0.478,2,2,0.5,2,2,33,13,9,13,24,0.196,0.283,0.522,17.61,62,python
0,17,27,1,45,0.378,18,0.4,4,0,1.0,2,2,25,20,12,17,16,0.267,0.378,0.356,17.611,63,python
0,20,25,2,47,0.426,22,0.468,5,1,0.833,1,2,33,14,11,14,22,0.234,0.298,0.468,17.617,64,python
0,14,27,6,47,0.298,20,0.426,2,0,1.0,4,3,27,20,5,16,26,0.106,0.34,0.553,17.606,65,python
0,18,23,3,44,0.409,21,0.477,4,3,0.571,4,1,26,18,8,16,20,0.182,0.364,0.455,17.616,66,python
0,18,24,2,44,0.409,20,0.455,3,2,0.6,3,1,30,14,10,15,19,0.227,0.341,0.432,17.619,67,python
0,19,23,3,45,0.422,22,0.489,3,4,0.429,0,2,27,18,13,16,16,0.289,0.356,0.356,17.623,68,python
0,20,21,4,45,0.444,24,0.533,4,2,0.667,4,0,26,19,10,10,25,0.222,0.222,0.556,17.62,69,python
0,24,16,4,44,0.545,28,0.636,3,2,0.6,2,1,22,22,19,12,13,0.432,0.273,0.295,17.624,70,python
0,21,22,0,43,0.488,21,0.488,1,1,0.5,1,2,23,20,14,12,17,0.326,0.279,0.395,17.631,71,python
0,16,28,2,46,0.348,18,0.391,1,6,0.143,3,2,29,17,8,16,22,0.174,0.348,0.478,17.638,72,python
0,11,27,6,44,0.25,17,0.386,2,3,0.4,2,4,35,9,6,12,26,0.136,0.273,0.591,17.644,73,python
0,16,25,5,46,0.348,21,0.457,2,5,0.286,4,2,25,21,7,19,20,0.152,0.413,0.435,17.635,74,python
0,20,21,3,44,0.455,23,0.523,2,1,0.667,1,2,25,19,14,15,15,0.318,0.341,0.341,17.635,75,python
0,20,20,8,48,0.417,28,0.583,0,1,0.0,3,1,26,22,12,20,16,0.25,0.417,0.333,17.638,76,python
0,16,23,6,45,0.356,22,0.489,2,4,0.333,4,4,32,13,8,15,22,0.178,0.333,0.489,17.632,77,python
0,19,20,5,44,0.432,24,0.545,3,2,0.6,0,2,25,19,13,11,20,0.295,0.25,0.455,17.632,78,python
0,17,23,5,45,0.378,22,0.489,3,5,0.375,2,4,29,16,11,10,24,0.244,0.222,0.533,17.627,79,python
0,22,19,4,45,0.489,26,0.578,1,1,0.5,3,1,26,19,12,14,19,0.267,0.311,0.422,17.627,80,python
0,23,20,3,46,0.5,26,0.565,5,1,0.833,1,2,25,21,14,13,19,0.304,0.283,0.413,17.636,81,python
0,19,21,5,45,0.422,24,0.533,2,0,1.0,2,3,31,14,8,14,23,0.178,0.311,0.511,17.633,82,python
0,19,24,3,46,0.413,22,0.478,2,2,0.5,0,0,25,21,10,17,19,0.217,0.37,0.413,17.641,83,python
0,15,29,2,46,0.326,17,0.37,1,1,0.5,2,3,24,22,10,17,19,0.217,0.37,0.413,17.64,84,python
0,27,10,6,43,0.628,33,0.767,3,1,0.75,5,0,26,17,16,12,15,0.372,0.279,0.349,17.639,85,python
0,22,20,4,46,0.478,26,0.565,0,2,0.0,2,2,26,20,15,13,18,0.326,0.283,0.391,17.638,86,python
0,26,18,1,45,0.578,27,0.6,2,0,1.0,5,3,26,19,16,8,21,0.356,0.178,0.467,17.631,87,python
0,27,16,3,46,0.587,30,0.652,5,1,0.833,4,0,28,18,12,16,18,0.261,0.348,0.391,17.637,88,python
0,20,23,4,47,0.426,24,0.511,4,0,1.0,1,2,24,23,14,16,17,0.298,0.34,0.362,17.646,89,python
0,23,19,5,47,0.489,28,0.596,5,2,0.714,2,1,26,21,8,13,26,0.17,0.277,0.553,17.633,90,python
0,19,22,3,44,0.432,22,0.5,3,3,0.5,0,1,23,21,14,12,18,0.318,0.273,0.409,17.64,91,python
0,20,23,0,43,0.465,20,0.465,2,3,0.4,0,2,23,20,11,15,17,0.256,0.349,0.395,17.641,92,python
0,22,20,4,46,0.478,26,0.565,1,4,0.2,5,2,25,21,11,14,21,0.239,0.304,0.457,17.643,93,python
0,23,17,7,47,0.489,30,0.638,2,2,0.5,1,2,33,14,10,15,22,0.213,0.319,0.468,17.647,94,python
0,20,21,2,43,0.465,22,0.512,4,1,0.8,2,2,25,18,10,11,22,0.233,0.256,0.512,17.644,95,python
0,18,21,8,47,0.383,26,0.553,6,2,0.75,1,2,28,19,15,15,17,0.319,0.319,0.362,17.652,96,python
0,17,24,5,46,0.37,22,0.478,2,4,0.333,2,2,30,16,10,14,22,0.217,0.304,0.478,17.269,1,python
0,18,24,5,47,0.383,23,0.489,0,3,0.0,6,0,29,18,11,14,22,0.234,0.298,0.468,17.037,2,python
0,19,23,3,45,0.422,22,0.489,4,3,0.571,2,3,25,20,11,12,22,0.244,0.267,0.489,17.232,3,python
0,24,16,4,44,0.545,28,0.636,3,2,0.6,2,1,26,18,8,13,23,0.182,0.295,0.523,17.47,4,python
0,18,22,4,44,0.409,22,0.5,2,5,0.286,2,1,25,19,10,16,18,0.227,0.364,0.409,17.589,5,python
0,22,19,5,46,0.478,27,0.587,4,4,0.5,3,5,29,17,15,9,22,0.326,0.196,0.478,17.594,6,python
0,26,15,10,51,0.51,36,0.706,6,2,0.75,3,0,22,29,14,18,19,0.275,0.353,0.373,17.579,7,python
0,14,25,6,45,0.311,20,0.444,2,2,0.5,1,3,31,14,5,16,24,0.111,0.356,0.533,17.607,8,python
0,21,20,4,45,0.467,25,0.556,0,2,0.0,2,1,29,16,10,11,24,0.222,0.244,0.533,17.578,9,python
0,15,27,4,46,0.326,19,0.413,4,2,0.667,2,3,27,19,8,14,24,0.174,0.304,0.522,17.616,10,python
0,19,21,4,44,0.432,23,0.523,4,2,0.667,1,2,32,12,9,9,26,0.205,0.205,0.591,17.678,11,python
0,24,19,5,48,0.5,29,0.604,3,2,0.6,4,4,36,12,7,9,32,0.146,0.188,0.667,17.598,12,python
0,24,19,4,47,0.511,28,0.596,3,3,0.5,2,1,28,19,15,15,17,0.319,0.319,0.362,17.61,13,python
0,22,21,4,47,0.468,26,0.553,2,0,1.0,1,3,34,13,9,17,21,0.191,0.362,0.447,17.62,14,python
0,19,26,4,49,0.388,23,0.469,6,1,0.857,1,1,22,27,10,21,18,0.204,0.429,0.367,17.636,15,python
0,16,24,8,48,0.333,24,0.5,4,2,0.667,3,3,27,21,7,18,23,0.146,0.375,0.479,17.654,16,python
0,20,21,2,43,0.465,22,0.512,3,5,0.375,2,0,28,15,10,14,19,0.233,0.326,0.442,17.646,17,python
0,18,18,8,44,0.409,26,0.591,2,1,0.667,0,1,28,16,10,14,20,0.227,0.318,0.455,17.643,18,python
0,14,25,9,48,0.292,23,0.479,2,1,0.667,4,5,28,20,4,18,26,0.083,0.375,0.542,17.648,19,python
0,16,24,3,43,0.372,19,0.442,3,1,0.75,2,4,34,9,10,14,19,0.233,0.326,0.442,17.656,20,python
0,15,22,6,43,0.349,21,0.488,3,0,1.0,1,3,27,16,9,16,18,0.209,0.372,0.419,17.645,21,python
0,21,20,5,46,0.457,26,0.565,4,2,0.667,2,3,28,18,15,11,20,0.326,0.239,0.435,17.62,22,python
0,21,20,6,47,0.447,27,0.574,3,2,0.6,2,3,35,12,8,17,22,0.17,0.362,0.468,17.594,23,python
0,22,17,7,46,0.478,29,0.63,4,0,1.0,4,1,29,17,11,16,19,0.239,0.348,0.413,17.604,24,python
0,17,26,3,46,0.37,20,0.435,4,4,0.5,0,1,29,17,9,17,20,0.196,0.37,0.435,17.624,25,python
0,22,25,2,49,0.449,24,0.49,0,0,0,2,1,31,18,10,18,21,0.204,0.367,0.429,17.607,26,python
0,20,24,5,49,0.408,25,0.51,2,1,0.667,2,2,32,17,6,16,27,0.122,0.327,0.551,17.614,27,python
0,21,23,2,46,0.457,23,0.5,2,2,0.5,5,0,25,21,9,14,23,0.196,0.304,0.5,17.592,28,python
0,23,19,4,46,0.5,27,0.587,0,0,0,3,3,25,21,14,14,18,0.304,0.304,0.391,17.599,29,python
0,24,18,2,44,0.545,26,0.591,1,2,0.333,1,0,27,17,17,11,16,0.386,0.25,0.364,17.599,30,python
0,20,20,4,44,0.455,24,0.545,0,3,0.0,1,1,24,20,11,11,22,0.25,0.25,0.5,17.606,31,python
0,17,25,4,46,0.37,21,0.457,2,3,0.4,1,3,26,20,9,16,21,0.196,0.348,0.457,17.629,32,python
0,23,21,3,47,0.489,26,0.553,3,4,0.429,6,0,20,27,13,16,18,0.277,0.34,0.383,17.611,33,python
0,31,13,1,45,0.689,32,0.711,2,3,0.4,3,1,27,18,16,14,15,0.356,0.311,0.333,17.605,34,python
0,21,24,4,49,0.429,25,0.51,2,1,0.667,3,3,31,18,11,14,24,0.224,0.286,0.49,17.585,35,python
0,18,25,3,46,0.391,21,0.457,2,3,0.4,1,3,28,18,13,12,21,0.283,0.261,0.457,17.575,36,python
0,22,18,6,46,0.478,28,0.609,3,1,0.75,2,3,23,23,12,18,16,0.261,0.391,0.348,17.592,37,python
0,25,18,2,45,0.556,27,0.6,2,3,0.4,4,1,20,25,16,9,20,0.356,0.2,0.444,17.574,38,python
0,17,31,3,51,0.333,20,0.392,1,5,0.167,1,2,27,24,7,21,23,0.137,0.412,0.451,17.574,39,python
0,17,21,6,44,0.386,23,0.523,2,2,0.5,0,1,25,19,10,16,18,0.227,0.364,0.409,17.559,40,python
0,23,21,3,47,0.489,26,0.553,3,3,0.5,6,2,26,21,12,12,23,0.255,0.255,0.489,17.528,41,python
0,25,19,4,48,0.521,29,0.604,1,0,1.0,2,1,27,21,13,14,21,0.271,0.292,0.438,17.539,42,python
0,20,23,2,45,0.444,22,0.489,2,1,0.667,2,5,27,18,8,13,24,0.178,0.289,0.533,17.548,43,python
0,21,18,5,44,0.477,26,0.591,6,1,0.857,2,1,26,18,10,17,17,0.227,0.386,0.386,17.558,44,python
0,14,26,6,46,0.304,20,0.435,0,1,0.0,0,4,31,15,8,13,25,0.174,0.283,0.543,17.564,45,python
0,15,24,5,44,0.341,20,0.455,1,2,0.333,2,3,29,15,11,13,20,0.25,0.295,0.455,17.574,46,python
0,19,22,4,45,0.422,23,0.511,3,1,0.75,2,2,26,19,9,15,21,0.2,0.333,0.467,17.588,47,python
0,18,23,4,45,0.4,22,0.489,4,3,0.571,5,2,29,16,8,15,22,0.178,0.333,0.489,17.585,48,python
0,19,20,6,45,0.422,25,0.556,4,2,0.667,4,2,27,18,8,15,22,0.178,0.333,0.489,17.584,49,python
0,18,23,1,42,0.429,19,0.452,3,2,0.6,1,2,26,16,12,13,17,0.286,0.31,0.405,17.576,50,python
0,13,28,4,45,0.289,17,0.378,3,2,0.6,2,0,31,14,4,17,24,0.089,0.378,0.533,17.585,51,python
0,24,19,2,45,0.533,26,0.578,4,3,0.571,1,1,23,22,13,16,16,0.289,0.356,0.356,17.592,52,python
0,18,22,3,43,0.419,21,0.488,3,2,0.6,2,2,26,17,10,15,18,0.233,0.349,0.419,17.591,53,python
0,23,17,3,43,0.535,26,0.605,5,1,0.833,1,2,27,16,14,11,18,0.326,0.256,0.419,17.597,54,python
0,18,22,3,43,0.419,21,0.488,4,3,0.571,2,2,22,21,10,16,17,0.233,0.372,0.395,17.603,55,python
0,20,21,5,46,0.435,25,0.543,4,3,0.571,3,2,32,14,10,20,16,0.217,0.435,0.348,17.61,56,python
0,19,19,6,44,0.432,25,0.568,4,4,0.5,4,3,31,13,6,16,22,0.136,0.364,0.5,17.615,57,python
0,23,20,4,47,0.489,27,0.574,2,2,0.5,2,2,25,22,12,16,19,0.255,0.34,0.404,17.598,58,python
0,22,19,4,45,0.489,26,0.578,4,1,0.8,4,1,25,20,13,14,18,0.289,0.311,0.4,17.604,59,python
0,27,19,2,48,0.562,29,0.604,5,2,0.714,3,3,26,22,15,12,21,0.312,0.25,0.438,17.605,60,python
0,17,20,7,44,0.386,24,0.545,3,1,0.75,2,1,23,21,11,14,19,0.25,0.318,0.432,17.607,61,python
0,23,17,6,46,0.5,29,0.63,6,1,0.857,2,3,26,20,14,14,18,0.304,0.304,0.391,17.616,62,python
0,20,24,3,47,0.426,23,0.489,5,1,0.833,2,2,26,21,12,16,19,0.255,0.34,0.404,17.623,63,python
0,15,25,5,45,0.333,20,0.444,3,3,0.5,1,3,28,17,10,13,22,0.222,0.289,0.489,17.615,64,python
0,17,24,5,46,0.37,22,0.478,3,0,1.0,2,1,28,18,9,15,22,0.196,0.326,0.478,17.621,65,python
0,17,27,1,45,0.378,18,0.4,2,1,0.667,4,2,31,14,7,15,23,0.156,0.333,0.511,17.612,66,python
0,18,24,3,45,0.4,21,0.467,1,5,0.167,0,5,24,21,11,15,19,0.244,0.333,0.422,17.617,67,python
0,18,25,4,47,0.383,22,0.468,1,5,0.167,1,5,30,17,11,14,22,0.234,0.298,0.468,17.626,68,python
0,22,22,3,47,0.468,25,0.532,2,0,1.0,8,1,30,17,7,15,25,0.149,0.319,0.532,17.619,69,python
0,24,17,5,46,0.522,29,0.63,6,2,0.75,4,3,27,19,15,12,19,0.326,0.261,0.413,17.616,70,python
0,17,21,5,43,0.395,22,0.512,1,1,0.5,0,1,28,15,10,11,22,0.233,0.256,0.512,17.615,71,python
0,23,22,3,48,0.479,26,0.542,3,4,0.429,1,1,21,27,16,20,12,0.333,0.417,0.25,17.624,72,python
0,15,29,6,50,0.3,21,0.42,3,6,0.333,0,0,32,18,7,17,26,0.14,0.34,0.52,17.635,73,python
0,23,16,4,43,0.535,27,0.628,6,1,0.857,2,0,28,15,10,14,19,0.233,0.326,0.442,17.627,74,python
0,14,25,5,44,0.318,19,0.432,6,1,0.857,3,1,25,19,8,13,23,0.182,0.295,0.523,17.634,75,python
0,21,16,6,43,0.488,27,0.628,3,1,0.75,2,2,27,16,13,11,19,0.302,0.256,0.442,17.634,76,python
0,17,23,6,46,0.37,23,0.5,2,2,0.5,1,4,26,20,10,18,18,0.217,0.391,0.391,17.639,77,python
0,25,15,9,49,0.51,34,0.694,4,0,1.0,2,4,29,20,15,13,21,0.306,0.265,0.429,17.644,78,python
0,19,21,3,43,0.442,22,0.512,1,3,0.25,1,2,28,15,11,12,20,0.256,0.279,0.465,17.649,79,python
0,23,21,4,48,0.479,27,0.562,5,1,0.833,2,3,31,17,13,12,23,0.271,0.25,0.479,17.654,80,python
0,22,18,5,45,0.489,27,0.6,8,2,0.8,2,0,23,22,14,11,20,0.311,0.244,0.444,17.658,81,python
0,15,24,4,43,0.349,19,0.442,2,0,1.0,1,2,24,19,9,17,17,0.209,0.395,0.395,17.645,82,python
0,20,21,3,44,0.455,23,0.523,3,2,0.6,0,1,25,19,13,19,12,0.295,0.432,0.273,17.652,83,python
0,21,22,2,45,0.467,23,0.511,1,2,0.333,1,0,34,11,10,11,24,0.222,0.244,0.533,17.646,84,python
0,20,24,2,46,0.435,22,0.478,1,0,1.0,4,3,32,14,10,11,25,0.217,0.239,0.543,17.64,85,python
0,18,20,5,43,0.419,23,0.535,1,2,0.333,2,2,27,16,10,16,17,0.233,0.372,0.395,17.635,86,python
0,19,24,2,45,0.422,21,0.467,2,2,0.5,2,1,23,22,8,16,21,0.178,0.356,0.467,17.634,87,python
0,21,23,1,45,0.467,22,0.489,2,2,0.5,2,2,27,18,10,15,20,0.222,0.333,0.444,17.634,88,python
0,25,18,3,46,0.543,28,0.609,3,3,0.5,1,1,31,15,16,10,20,0.348,0.217,0.435,17.628,89,python
0,21,20,4,45,0.467,25,0.556,3,0,1.0,2,3,24,21,14,13,18,0.311,0.289,0.4,17.628,90,python
0,22,18,4,44,0.5,26,0.591,2,3,0.4,3,1,23,21,11,16,17,0.25,0.364,0.386,17.63,91,python
0,20,19,5,44,0.455,25,0.568,5,1,0.833,1,2,26,18,11,18,15,0.25,0.409,0.341,17.632,92,python
0,18,25,1,44,0.409,19,0.432,5,0,1.0,3,3,31,13,7,10,27,0.159,0.227,0.614,17.621,93,python
0,22,21,2,45,0.489,24,0.533,3,3,0.5,1,1,27,18,13,12,20,0.289,0.267,0.444,17.622,94,python
0,24,19,2,45,0.533,26,0.578,3,1,0.75,2,1,27,18,15,14,16,0.333,0.311,0.356,17.624,95,python
0,22,19,4,45,0.489,26,0.578,2,2,0.5,1,1,21,24,13,15,17,0.289,0.333,0.378,17.624,96,python
0,25,20,1,46,0.543,26,0.565,6,3,0.667,3,3,25,21,12,16,18,0.261,0.348,0.391,17.292,1,python
0,22,18,5,45,0.489,27,0.6,3,1,0.75,5,3,36,9,11,9,25,0.244,0.2,0.556,18.0,2,python
0,18,24,2,44,0.409,20,0.455,2,3,0.4,3,1,28,16,11,11,22,0.25,0.25,0.5,17.951,3,python
0,26,17,0,43,0.605,26,0.605,2,1,0.667,2,2,25,18,19,10,14,0.442,0.233,0.326,17.969,4,python
0,14,26,6,46,0.304,20,0.435,2,2,0.5,2,3,21,25,7,21,18,0.152,0.457,0.391,17.921,5,python
0,18,24,7,49,0.367,25,0.51,3,4,0.429,2,2,34,15,8,13,28,0.163,0.265,0.571,17.874,6,python
0,14,27,4,45,0.311,18,0.4,2,4,0.333,1,3,29,16,7,14,24,0.156,0.311,0.533,17.723,7,python
0,22,18,4,44,0.5,26,0.591,2,2,0.5,2,0,30,14,9,11,24,0.205,0.25,0.545,17.656,8,python
0,19,21,4,44,0.432,23,0.523,3,1,0.75,0,4,28,16,12,13,19,0.273,0.295,0.432,17.801,9,python
0,17,22,6,45,0.378,23,0.511,7,2,0.778,4,3,26,19,10,13,22,0.222,0.289,0.489,17.833,10,python
0,20,20,5,45,0.444,25,0.556,1,5,0.167,3,2,29,16,7,15,23,0.156,0.333,0.511,17.863,11,python
0,18,21,6,45,0.4,24,0.533,0,4,0.0,3,0,24,21,8,21,16,0.178,0.467,0.356,17.889,12,python
0,23,17,5,45,0.511,28,0.622,7,1,0.875,5,1,28,17,10,11,24,0.222,0.244,0.533,17.879,13,python
0,26,17,3,46,0.565,29,0.63,4,1,0.8,2,2,30,16,14,11,21,0.304,0.239,0.457,17.878,14,python
0,19,22,4,45,0.422,23,0.511,1,3,0.25,1,2,26,19,8,16,21,0.178,0.356,0.467,17.871,15,python
0,23,19,2,44,0.523,25,0.568,0,6,0.0,2,4,26,18,9,17,18,0.205,0.386,0.409,17.854,16,python
0,22,17,6,45,0.489,28,0.622,2,3,0.4,3,2,27,18,13,11,21,0.289,0.244,0.467,17.83,17,python
0,17,21,5,43,0.395,22,0.512,3,3,0.5,3,3,24,19,9,16,18,0.209,0.372,0.419,17.805,18,python
0,17,26,1,44,0.386,18,0.409,3,2,0.6,1,3,26,18,12,13,19,0.273,0.295,0.432,17.812,19,python
0,22,17,2,41,0.537,24,0.585,4,1,0.8,1,0,30,11,9,14,18,0.22,0.341,0.439,17.793,20,python
0,18,22,9,49,0.367,27,0.551,1,2,0.333,6,3,31,18,8,12,29,0.163,0.245,0.592,17.769,21,python
0,18,23,5,46,0.391,23,0.5,3,4,0.429,2,3,33,13,9,15,22,0.196,0.326,0.478,17.784,22,python
0,20,19,4,43,0.465,24,0.558,2,0,1.0,1,1,34,9,11,11,21,0.256,0.256,0.488,17.789,23,python
0,19,22,2,43,0.442,21,0.488,5,0,1.0,4,1,24,19,9,12,22,0.209,0.279,0.512,17.763,24,python
0,21,20,4,45,0.467,25,0.556,4,1,0.8,1,1,27,18,11,13,21,0.244,0.289,0.467,17.748,25,python
0,23,17,5,45,0.511,28,0.622,5,2,0.714,4,2,27,18,11,14,20,0.244,0.311,0.444,17.756,26,python
0,19,22,3,44,0.432,22,0.5,5,1,0.833,2,1,18,26,11,17,16,0.25,0.386,0.364,17.752,27,python
0,15,26,6,47,0.319,21,0.447,0,2,0.0,4,2,27,20,9,20,18,0.191,0.426,0.383,17.751,28,python
0,24,20,2,46,0.522,26,0.565,3,1,0.75,3,2,28,18,11,13,22,0.239,0.283,0.478,17.744,29,python
0,23,18,3,44,0.523,26,0.591,0,2,0.0,4,1,28,16,11,16,17,0.25,0.364,0.386,17.756,30,python
0,16,24,5,45,0.356,21,0.467,1,1,0.5,2,3,26,19,8,13,24,0.178,0.289,0.533,17.756,31,python
0,19,25,2,46,0.413,21,0.457,0,3,0.0,3,1,28,18,9,15,22,0.196,0.326,0.478,17.75,32,python
0,22,20,4,46,0.478,26,0.565,2,2,0.5,4,0,22,24,9,21,16,0.196,0.457,0.348,17.762,33,python
0,18,25,6,49,0.367,24,0.49,1,3,0.25,4,5,30,19,10,15,24,0.204,0.306,0.49,17.749,34,python
0,25,20,0,45,0.556,25,0.556,2,0,1.0,1,1,27,18,12,12,21,0.267,0.267,0.467,17.754,35,python
0,14,27,7,48,0.292,21,0.438,1,2,0.333,5,1,33,15,5,16,27,0.104,0.333,0.562,17.774,36,python
0,19,26,4,49,0.388,23,0.469,4,2,0.667,2,3,25,24,11,14,24,0.224,0.286,0.49,17.776,37,python
0,22,18,4,44,0.5,26,0.591,3,3,0.5,1,2,28,16,8,17,19,0.182,0.386,0.432,17.787,38,python
0,22,23,2,47,0.468,24,0.511,1,3,0.25,1,2,27,20,14,16,17,0.298,0.34,0.362,17.792,39,python
0,27,17,3,47,0.574,30,0.638,3,2,0.6,1,2,30,17,16,9,22,0.34,0.191,0.468,17.783,40,python
0,19,24,3,46,0.413,22,0.478,1,1,0.5,1,5,28,18,12,9,25,0.261,0.196,0.543,17.792,41,python
0,24,16,4,44,0.545,28,0.636,7,3,0.7,1,1,32,12,12,9,23,0.273,0.205,0.523,17.806,42,python
0,17,26,3,46,0.37,20,0.435,1,1,0.5,2,2,28,18,8,20,18,0.174,0.435,0.391,17.816,43,python
0,21,24,1,46,0.457,22,0.478,5,4,0.556,0,0,29,17,11,14,21,0.239,0.304,0.457,17.828,44,python
0,19,19,4,42,0.452,23,0.548,1,1,0.5,1,1,26,16,13,14,15,0.31,0.333,0.357,17.825,45,python
0,17,23,4,44,0.386,21,0.477,3,4,0.429,1,2,24,20,13,11,20,0.295,0.25,0.455,17.832,46,python
0,21,20,3,44,0.477,24,0.545,1,0,1.0,1,0,23,21,11,15,18,0.25,0.341,0.409,17.836,47,python
0,21,22,3,46,0.457,24,0.522,2,0,1.0,0,1,29,17,12,12,22,0.261,0.261,0.478,17.834,48,python
0,26,19,2,47,0.553,28,0.596,2,0,1.0,2,3,29,18,15,12,20,0.319,0.255,0.426,17.82,49,python
0,20,21,4,45,0.444,24,0.533,2,2,0.5,3,0,23,22,12,16,17,0.267,0.356,0.378,17.81,50,python
0,24,21,1,46,0.522,25,0.543,2,3,0.4,1,3,25,21,12,16,18,0.261,0.348,0.391,17.805,51,python
0,24,17,3,44,0.545,27,0.614,5,2,0.714,1,2,27,17,19,11,14,0.432,0.25,0.318,17.815,52,python
0,27,15,4,46,0.587,31,0.674,3,2,0.6,3,0,25,21,14,18,14,0.304,0.391,0.304,17.82,53,python
0,24,21,3,48,0.5,27,0.562,6,1,0.857,2,2,27,21,13,17,18,0.271,0.354,0.375,17.83,54,python
0,20,21,3,44,0.455,23,0.523,2,1,0.667,3,3,29,15,14,12,18,0.318,0.273,0.409,17.827,55,python
0,24,18,4,46,0.522,28,0.609,5,0,1.0,3,2,24,22,9,13,24,0.196,0.283,0.522,17.811,56,python
0,16,23,8,47,0.34,24,0.511,6,2,0.75,3,6,23,24,10,15,22,0.213,0.319,0.468,17.802,57,python
0,26,16,2,44,0.591,28,0.636,6,2,0.75,2,1,26,18,17,12,15,0.386,0.273,0.341,17.801,58,python
0,13,27,3,43,0.302,16,0.372,1,4,0.2,1,1,24,19,8,15,20,0.186,0.349,0.465,17.806,59,python
0,22,19,3,44,0.5,25,0.568,2,4,0.333,2,2,26,18,7,17,20,0.159,0.386,0.455,17.807,60,python
0,13,27,5,45,0.289,18,0.4,1,4,0.2,2,3,29,16,8,13,24,0.178,0.289,0.533,17.804,61,python
0,18,29,3,50,0.36,21,0.42,3,4,0.429,2,4,29,21,9,18,23,0.18,0.36,0.46,17.808,62,python
0,22,22,2,46,0.478,24,0.522,0,2,0.0,3,4,34,12,12,9,25,0.261,0.196,0.543,17.8,63,python
0,19,20,5,44,0.432,24,0.545,3,3,0.5,0,2,21,23,14,17,13,0.318,0.386,0.295,17.799,64,python
0,15,27,4,46,0.326,19,0.413,1,4,0.2,0,4,26,20,11,12,23,0.239,0.261,0.5,17.799,65,python
0,20,25,2,47,0.426,22,0.468,3,7,0.3,2,3,35,12,5,21,21,0.106,0.447,0.447,17.801,66,python
0,18,22,4,44,0.409,22,0.5,4,3,0.571,2,2,29,15,8,18,18,0.182,0.409,0.409,17.801,67,python
0,16,25,4,45,0.356,20,0.444,5,2,0.714,1,2,32,13,11,12,22,0.244,0.267,0.489,17.806,68,python
0,17,24,6,47,0.362,23,0.489,2,1,0.667,3,3,26,21,10,18,19,0.213,0.383,0.404,17.81,69,python
0,17,24,3,44,0.386,20,0.455,3,6,0.333,1,4,27,17,13,11,20,0.295,0.25,0.455,17.809,70,python
0,26,16,5,47,0.553,31,0.66,1,0,1.0,3,2,26,21,18,8,21,0.383,0.17,0.447,17.79,71,python
0,22,18,2,42,0.524,24,0.571,3,4,0.429,0,1,23,19,16,12,14,0.381,0.286,0.333,17.795,72,python
0,23,15,6,44,0.523,29,0.659,2,2,0.5,2,1,31,13,10,14,20,0.227,0.318,0.455,17.791,73,python
0,21,20,2,43,0.488,23,0.535,4,2,0.667,3,2,30,13,10,16,17,0.233,0.372,0.395,17.785,74,python
0,25,19,2,46,0.543,27,0.587,4,1,0.8,1,1,20,26,14,18,14,0.304,0.391,0.304,17.791,75,python
0,24,19,4,47,0.511,28,0.596,5,2,0.714,2,0,25,22,12,18,17,0.255,0.383,0.362,17.786,76,python
0,19,22,4,45,0.422,23,0.511,1,3,0.25,3,2,27,18,8,17,20,0.178,0.378,0.444,17.78,77,python
0,24,18,1,43,0.558,25,0.581,3,2,0.6,3,1,23,20,13,14,16,0.302,0.326,0.372,17.783,78,python
0,24,16,5,45,0.533,29,0.644,4,5,0.444,0,1,23,22,17,13,15,0.378,0.289,0.333,17.784,79,python
0,19,25,3,47,0.404,22,0.468,3,4,0.429,4,2,23,24,10,19,18,0.213,0.404,0.383,17.775,80,python
0,22,20,1,43,0.512,23,0.535,5,1,0.833,1,2,21,22,16,12,15,0.372,0.279,0.349,17.769,81,python
0,18,23,3,44,0.409,21,0.477,3,2,0.6,2,2,24,20,11,11,22,0.25,0.25,0.5,17.765,82,python
0,17,25,3,45,0.378,20,0.444,1,1,0.5,1,2,31,14,7,12,26,0.156,0.267,0.578,17.762,83,python
0,17,25,4,46,0.37,21,0.457,6,2,0.75,2,2,32,14,7,15,24,0.152,0.326,0.522,17.747,84,python
0,25,19,3,47,0.532,28,0.596,6,4,0.6,3,2,32,15,13,12,22,0.277,0.255,0.468,17.748,85,python
0,20,22,3,45,0.444,23,0.511,2,1,0.667,3,2,29,16,11,11,23,0.244,0.244,0.511,17.741,86,python
0,19,20,6,45,0.422,25,0.556,2,5,0.286,1,2,31,14,7,16,22,0.156,0.356,0.489,17.745,87,python
0,21,19,7,47,0.447,28,0.596,4,3,0.571,5,2,26,21,9,20,18,0.191,0.426,0.383,17.749,88,python
0,18,22,7,47,0.383,25,0.532,2,1,0.667,2,2,25,22,11,13,23,0.234,0.277,0.489,17.754,89,python
0,25,19,1,45,0.556,26,0.578,2,3,0.4,3,3,27,18,13,11,21,0.289,0.244,0.467,17.745,90,python
0,21,19,7,47,0.447,28,0.596,3,3,0.5,1,2,24,23,14,13,20,0.298,0.277,0.426,17.753,91,python
0,15,24,5,44,0.341,20,0.455,1,2,0.333,2,3,32,12,8,16,20,0.182,0.364,0.455,17.75,92,python
0,21,20,6,47,0.447,27,0.574,3,1,0.75,3,2,34,13,10,12,25,0.213,0.255,0.532,17.749,93,python
0,19,25,4,48,0.396,23,0.479,3,1,0.75,3,5,32,16,4,17,27,0.083,0.354,0.562,17.755,94,python
0,15,30,2,47,0.319,17,0.362,1,5,0.167,3,2,32,15,7,12,28,0.149,0.255,0.596,17.755,95,python
0,16,30,0,46,0.348,16,0.348,3,3,0.5,0,4,28,18,9,14,23,0.196,0.304,0.5,17.746,96,python
0,19,20,6,45,0.422,25,0.556,1,1,0.5,3,3,26,19,9,18,18,0.2,0.4,0.4,17.778,1,python
0,22,17,3,42,0.524,25,0.595,5,0,1.0,1,2,24,18,14,15,13,0.333,0.357,0.31,17.86,2,python
0,23,15,5,43,0.535,28,0.651,2,1,0.667,2,1,26,17,14,13,16,0.326,0.302,0.372,17.827,3,python
0,14,31,3,48,0.292,17,0.354,2,1,0.667,4,2,32,16,3,20,25,0.062,0.417,0.521,17.627,4,python
0,17,22,6,45,0.378,23,0.511,4,2,0.667,1,1,31,14,8,13,24,0.178,0.289,0.533,17.528,5,python
0,20,20,5,45,0.444,25,0.556,2,3,0.4,4,1,34,11,5,17,23,0.111,0.378,0.511,17.525,6,python
0,21,18,5,44,0.477,26,0.591,1,1,0.5,5,1,29,15,10,12,22,0.227,0.273,0.5,17.454,7,python
0,19,23,2,44,0.432,21,0.477,3,4,0.429,0,1,26,18,7,17,20,0.159,0.386,0.455,17.581,8,python
0,20,27,2,49,0.408,22,0.449,1,2,0.333,2,3,24,25,14,20,15,0.286,0.408,0.306,17.656,9,python
0,23,21,1,45,0.511,24,0.533,1,1,0.5,3,2,28,17,10,13,22,0.222,0.289,0.489,17.611,10,python
0,16,25,4,45,0.356,20,0.444,1,4,0.2,1,1,28,17,10,12,23,0.222,0.267,0.511,17.673,11,python
0,22,16,7,45,0.489,29,0.644,3,1,0.75,3,1,29,16,10,10,25,0.222,0.222,0.556,17.634,12,python
0,21,22,4,47,0.447,25,0.532,4,2,0.667,4,1,30,17,9,15,23,0.191,0.319,0.489,17.654,13,python
0,20,20,4,44,0.455,24,0.545,5,2,0.714,0,0,25,19,14,12,18,0.318,0.273,0.409,17.668,14,python
0,17,27,3,47,0.362,20,0.426,3,4,0.429,2,4,29,18,6,20,21,0.128,0.426,0.447,17.684,15,python
0,15,24,4,43,0.349,19,0.442,2,1,0.667,0,0,29,14,8,14,21,0.186,0.326,0.488,17.708,16,python
0,21,21,4,46,0.457,25,0.543,3,1,0.75,1,2,29,17,10,18,18,0.217,0.391,0.391,17.762,17,python
0,16,24,5,45,0.356,21,0.467,1,2,0.333,2,5,26,19,9,14,22,0.2,0.311,0.489,17.743,18,python
0,19,24,2,45,0.422,21,0.467,1,6,0.143,2,2,29,16,15,11,19,0.333,0.244,0.422,17.722,19,python
0,25,17,3,45,0.556,28,0.622,4,0,1.0,3,1,27,18,14,11,20,0.311,0.244,0.444,17.742,20,python
0,19,24,4,47,0.404,23,0.489,3,2,0.6,1,5,29,18,11,17,19,0.234,0.362,0.404,17.766,21,python
0,24,16,4,44,0.545,28,0.636,5,5,0.5,2,2,29,15,10,9,25,0.227,0.205,0.568,17.778,22,python
0,13,25,7,45,0.289,20,0.444,1,3,0.25,1,4,27,18,8,18,19,0.178,0.4,0.422,17.793,23,python
0,20,22,3,45,0.444,23,0.511,1,2,0.333,4,3,30,15,9,12,24,0.2,0.267,0.533,17.759,24,python
0,22,21,2,45,0.489,24,0.533,6,2,0.75,2,2,24,21,12,18,15,0.267,0.4,0.333,17.753,25,python
0,23,19,5,47,0.489,28,0.596,5,4,0.556,3,0,29,18,11,15,21,0.234,0.319,0.447,17.744,26,python
0,15,31,1,47,0.319,16,0.34,3,3,0.5,3,2,28,19,5,17,25,0.106,0.362,0.532,17.746,27,python
0,20,23,2,45,0.444,22,0.489,2,2,0.5,2,2,27,18,13,13,19,0.289,0.289,0.422,17.737,28,python
0,14,22,8,44,0.318,22,0.5,2,3,0.4,2,2,26,18,8,16,20,0.182,0.364,0.455,17.738,29,python
0,25,14,5,44,0.568,30,0.682,2,1,0.667,2,1,23,21,13,16,15,0.295,0.364,0.341,17.76,30,python
0,25,15,5,45,0.556,30,0.667,4,1,0.8,2,2,33,12,16,12,17,0.356,0.267,0.378,17.748,31,python
0,13,30,1,44,0.295,14,0.318,1,5,0.167,1,4,27,17,6,17,21,0.136,0.386,0.477,17.741,32,python
0,21,17,6,44,0.477,27,0.614,3,1,0.75,2,1,29,15,12,14,18,0.273,0.318,0.409,17.74,33,python
0,20,21,4,45,0.444,24,0.533,4,0,1.0,0,4,27,18,15,11,19,0.333,0.244,0.422,17.739,34,python
0,18,23,3,44,0.409,21,0.477,7,1,0.875,2,2,28,16,9,16,19,0.205,0.364,0.432,17.729,35,python
0,20,23,2,45,0.444,22,0.489,4,7,0.364,1,2,25,20,11,17,17,0.244,0.378,0.378,17.736,36,python
0,16,25,4,45,0.356,20,0.444,2,5,0.286,2,0,27,18,6,18,21,0.133,0.4,0.467,17.749,37,python
0,18,28,3,49,0.367,21,0.429,2,4,0.333,2,1,30,19,8,21,20,0.163,0.429,0.408,17.731,38,python
0,15,25,5,45,0.333,20,0.444,2,5,0.286,1,2,27,18,7,15,23,0.156,0.333,0.511,17.718,39,python
0,23,19,3,45,0.511,26,0.578,1,1,0.5,1,2,25,20,13,16,16,0.289,0.356,0.356,17.723,40,python
0,21,19,4,44,0.477,25,0.568,4,1,0.8,5,1,35,9,8,8,28,0.182,0.182,0.636,17.708,41,python
0,19,23,2,44,0.432,21,0.477,3,2,0.6,2,1,23,21,9,20,15,0.205,0.455,0.341,17.713,42,python
0,21,25,3,49,0.429,24,0.49,2,3,0.4,3,4,27,22,11,18,20,0.224,0.367,0.408,17.705,43,python
0,18,26,3,47,0.383,21,0.447,2,6,0.25,4,1,29,18,9,14,24,0.191,0.298,0.511,17.711,44,python
0,22,21,4,47,0.468,26,0.553,8,1,0.889,4,3,29,18,10,15,22,0.213,0.319,0.468,17.716,45,python
0,26,17,3,46,0.565,29,0.63,3,1,0.75,6,1,29,17,13,11,22,0.283,0.239,0.478,17.706,46,python
0,24,19,4,47,0.511,28,0.596,1,2,0.333,0,2,31,16,11,18,18,0.234,0.383,0.383,17.707,47,python
0,24,15,6,45,0.533,30,0.667,4,1,0.8,0,1,29,16,16,10,19,0.356,0.222,0.422,17.712,48,python
0,20,22,3,45,0.444,23,0.511,3,3,0.5,1,1,34,11,12,10,23,0.267,0.222,0.511,17.715,49,python
0,16,26,3,45,0.356,19,0.422,2,3,0.4,1,2,27,18,11,16,18,0.244,0.356,0.4,17.725,50,python
0,25,22,2,49,0.51,27,0.551,2,3,0.4,1,2,28,21,15,15,19,0.306,0.306,0.388,17.74,51,python
0,19,22,5,46,0.413,24,0.522,3,3,0.5,2,2,30,16,9,14,23,0.196,0.304,0.5,17.742,52,python
0,20,21,4,45,0.444,24,0.533,3,0,1.0,0,2,28,17,11,15,19,0.244,0.333,0.422,17.746,53,python
0,21,17,8,46,0.457,29,0.63,2,2,0.5,4,1,31,15,10,12,24,0.217,0.261,0.522,17.753,54,python
0,18,26,4,48,0.375,22,0.458,4,2,0.667,2,4,29,19,9,13,26,0.188,0.271,0.542,17.751,55,python
0,18,23,4,45,0.4,22,0.489,4,4,0.5,0,2,23,22,13,14,18,0.289,0.311,0.4,17.744,56,python
0,15,25,5,45,0.333,20,0.444,4,1,0.8,3,0,32,13,6,16,23,0.133,0.356,0.511,17.743,57,python
0,27,17,3,47,0.574,30,0.638,4,2,0.667,2,0,27,20,15,14,18,0.319,0.298,0.383,17.741,58,python
0,20,21,5,46,0.435,25,0.543,2,7,0.222,1,1,29,17,11,18,17,0.239,0.391,0.37,17.74,59,python
0,22,23,2,47,0.468,24,0.511,2,3,0.4,2,2,27,20,10,19,18,0.213,0.404,0.383,17.745,60,python
0,20,23,4,47,0.426,24,0.511,4,6,0.4,3,2,32,15,12,11,24,0.255,0.234,0.511,17.743,61,python
0,27,19,3,49,0.551,30,0.612,4,3,0.571,1,2,29,20,17,13,19,0.347,0.265,0.388,17.748,62,python
0,19,27,1,47,0.404,20,0.426,1,4,0.2,3,3,26,21,14,10,23,0.298,0.213,0.489,17.735,63,python
0,28,13,3,44,0.636,31,0.705,2,0,1.0,4,0,26,18,12,12,20,0.273,0.273,0.455,17.728,64,python
0,22,20,2,44,0.5,24,0.545,5,3,0.625,1,3,29,15,14,13,17,0.318,0.295,0.386,17.731,65,python
0,23,23,4,50,0.46,27,0.54,3,0,1.0,4,0,33,17,11,16,23,0.22,0.32,0.46,17.716,66,python
0,18,24,4,46,0.391,22,0.478,3,6,0.333,1,4,26,20,11,15,20,0.239,0.326,0.435,17.715,67,python
0,16,23,6,45,0.356,22,0.489,1,1,0.5,1,4,25,20,11,13,21,0.244,0.289,0.467,17.719,68,python
0,19,20,6,45,0.422,25,0.556,4,5,0.444,3,2,28,17,9,18,18,0.2,0.4,0.4,17.729,69,python
0,23,20,2,45,0.511,25,0.556,1,3,0.25,5,2,32,13,10,11,24,0.222,0.244,0.533,17.727,70,python
0,17,20,7,44,0.386,24,0.545,4,4,0.5,2,0,31,13,7,13,24,0.159,0.295,0.545,17.733,71,python
0,18,27,2,47,0.383,20,0.426,6,1,0.857,2,3,30,17,12,11,24,0.255,0.234,0.511,17.731,72,python
0,21,20,4,45,0.467,25,0.556,2,2,0.5,3,0,30,15,13,11,21,0.289,0.244,0.467,17.731,73,python
0,14,27,4,45,0.311,18,0.4,5,3,0.625,0,1,23,22,8,21,16,0.178,0.467,0.356,17.733,74,python
0,17,23,4,44,0.386,21,0.477,3,2,0.6,1,2,27,17,9,15,20,0.205,0.341,0.455,17.738,75,python
0,16,23,8,47,0.34,24,0.511,2,4,0.333,3,5,27,20,4,18,25,0.085,0.383,0.532,17.731,76,python
0,20,19,3,42,0.476,23,0.548,2,1,0.667,3,0,28,14,12,12,18,0.286,0.286,0.429,17.728,77,python
0,22,17,7,46,0.478,29,0.63,2,1,0.667,4,1,25,21,10,15,21,0.217,0.326,0.457,17.713,78,python
0,20,20,6,46,0.435,26,0.565,4,3,0.571,4,2,26,20,12,13,21,0.261,0.283,0.457,17.716,79,python
0,23,21,3,47,0.489,26,0.553,2,3,0.4,3,4,30,17,12,16,19,0.255,0.34,0.404,17.719,80,python
0,17,23,6,46,0.37,23,0.5,3,1,0.75,1,4,26,20,10,13,23,0.217,0.283,0.5,17.722,81,python
0,24,19,4,47,0.511,28,0.596,1,2,0.333,4,1,25,22,10,14,23,0.213,0.298,0.489,17.724,82,python
0,27,17,3,47,0.574,30,0.638,4,4,0.5,1,1,22,25,15,17,15,0.319,0.362,0.319,17.718,83,python
0,20,21,2,43,0.465,22,0.512,5,8,0.385,3,3,25,18,9,14,20,0.209,0.326,0.465,17.717,84,python
0,19,21,6,46,0.413,25,0.543,1,1,0.5,2,2,27,19,7,15,24,0.152,0.326,0.522,17.713,85,python
0,20,24,2,46,0.435,22,0.478,5,2,0.714,2,1,36,10,11,11,24,0.239,0.239,0.522,17.72,86,python
0,16,25,8,49,0.327,24,0.49,0,3,0.0,2,2,33,16,10,18,21,0.204,0.367,0.429,17.73,87,python
0,21,20,3,44,0.477,24,0.545,0,2,0.0,2,2,27,17,9,14,21,0.205,0.318,0.477,17.731,88,python
0,17,22,4,43,0.395,21,0.488,0,3,0.0,3,1,29,14,7,13,23,0.163,0.302,0.535,17.73,89,python
0,24,19,1,44,0.545,25,0.568,2,4,0.333,3,4,25,19,13,13,18,0.295,0.295,0.409,17.73,90,python
0,16,27,1,44,0.364,17,0.386,0,1,0.0,1,2,25,19,11,14,19,0.25,0.318,0.432,17.728,91,python
0,17,25,4,46,0.37,21,0.457,3,4,0.429,3,3,29,17,7,16,23,0.152,0.348,0.5,17.731,92,python
0,21,25,2,48,0.438,23,0.479,1,2,0.333,2,3,27,21,14,13,21,0.292,0.271,0.438,17.733,93,python
0,26,16,4,46,0.565,30,0.652,6,0,1.0,4,1,30,16,14,12,20,0.304,0.261,0.435,17.729,94,python
0,23,24,0,47,0.489,23,0.489,4,1,0.8,1,2,27,20,11,19,17,0.234,0.404,0.362,17.731,95,python
0,18,24,5,47,0.383,23,0.489,0,3,0.0,3,3,29,18,12,12,23,0.255,0.255,0.489,17.741,96,python
0,16,29,3,48,0.333,19,0.396,2,3,0.4,1,4,28,20,7,19,22,0.146,0.396,0.458,17.8,1,python
0,20,20,7,47,0.426,27,0.574,2,4,0.333,3,1,26,21,9,16,22,0.191,0.34,0.468,17.413,2,python
0,18,24,3,45,0.4,21,0.467,1,1,0.5,2,4,30,15,10,16,19,0.222,0.356,0.422,17.57,3,python
0,13,25,7,45,0.289,20,0.444,2,3,0.4,3,5,30,15,8,13,24,0.178,0.289,0.533,17.533,4,python
0,21,19,5,45,0.467,26,0.578,3,2,0.6,1,3,29,16,10,12,23,0.222,0.267,0.511,17.647,5,python
0,25,18,3,46,0.543,28,0.609,5,1,0.833,1,0,25,21,6,20,20,0.13,0.435,0.435,17.62,6,python
0,26,18,3,47,0.553,29,0.617,1,2,0.333,3,1,32,15,15,15,17,0.319,0.319,0.362,17.66,7,python
0,19,23,4,46,0.413,23,0.5,4,2,0.667,2,2,31,15,14,10,22,0.304,0.217,0.478,17.693,8,python
0,14,27,2,43,0.326,16,0.372,2,3,0.4,1,1,30,13,9,14,20,0.209,0.326,0.465,17.656,9,python
0,21,23,2,46,0.457,23,0.5,3,1,0.75,4,3,28,18,11,12,23,0.239,0.261,0.5,17.598,10,python
0,14,25,4,43,0.326,18,0.419,2,2,0.5,1,2,31,12,9,13,21,0.209,0.302,0.488,17.63,11,python
0,17,21,7,45,0.378,24,0.533,3,1,0.75,2,3,29,16,8,14,23,0.178,0.311,0.511,17.62,12,python
0,22,22,1,45,0.489,23,0.511,4,1,0.8,3,1,27,18,12,13,20,0.267,0.289,0.444,17.622,13,python
0,12,29,6,47,0.255,18,0.383,1,1,0.5,4,2,31,16,4,15,28,0.085,0.319,0.596,17.611,14,python
0,23,20,3,46,0.5,26,0.565,3,2,0.6,1,1,28,18,8,19,19,0.174,0.413,0.413,17.62,15,python
0,25,14,6,45,0.556,31,0.689,2,5,0.286,4,0,25,20,13,14,18,0.289,0.311,0.4,17.611,16,python
0,14,26,7,47,0.298,21,0.447,1,5,0.167,1,2,27,20,6,18,23,0.128,0.383,0.489,17.67,17,python
0,15,27,3,45,0.333,18,0.4,4,1,0.8,0,4,31,14,10,14,21,0.222,0.311,0.467,17.692,18,python
0,25,24,0,49,0.51,25,0.51,5,4,0.556,3,0,31,18,15,15,19,0.306,0.306,0.388,17.721,19,python
0,21,21,2,44,0.477,23,0.523,1,2,0.333,3,2,28,16,13,11,20,0.295,0.25,0.455,17.686,20,python
0,24,17,3,44,0.545,27,0.614,4,1,0.8,1,4,22,22,14,14,16,0.318,0.318,0.364,17.674,21,python
0,26,14,5,45,0.578,31,0.689,4,1,0.8,3,1,27,18,15,9,21,0.333,0.2,0.467,17.634,22,python
0,15,27,5,47,0.319,20,0.426,3,5,0.375,1,2,26,21,9,17,21,0.191,0.362,0.447,17.648,23,python
0,13,26,5,44,0.295,18,0.409,1,2,0.333,0,1,26,18,6,14,24,0.136,0.318,0.545,17.677,24,python
0,20,19,5,44,0.455,25,0.568,2,1,0.667,1,3,30,14,12,15,17,0.273,0.341,0.386,17.66,25,python
0,24,18,3,45,0.533,27,0.6,4,2,0.667,1,2,21,24,14,19,12,0.311,0.422,0.267,17.672,26,python
0,19,23,3,45,0.422,22,0.489,1,1,0.5,3,0,29,16,7,13,25,0.156,0.289,0.556,17.681,27,python
0,19,26,1,46,0.413,20,0.435,6,1,0.857,3,4,24,22,11,19,16,0.239,0.413,0.348,17.669,28,python
0,23,19,4,46,0.5,27,0.587,2,3,0.4,2,3,29,17,14,14,18,0.304,0.304,0.391,17.672,29,python
0,21,25,3,49,0.429,24,0.49,1,2,0.333,2,3,31,18,10,17,22,0.204,0.347,0.449,17.685,30,python
0,25,17,3,45,0.556,28,0.622,3,2,0.6,3,2,22,23,13,12,20,0.289,0.267,0.444,17.677,31,python
0,21,24,2,47,0.447,23,0.489,1,2,0.333,3,1,30,17,10,14,23,0.213,0.298,0.489,17.669,32,python
0,14,28,3,45,0.311,17,0.378,2,1,0.667,3,1,28,17,6,14,25,0.133,0.311,0.556,17.647,33,python
0,23,19,3,45,0.511,26,0.578,5,2,0.714,3,3,27,18,14,11,20,0.311,0.244,0.444,17.642,34,python
0,23,19,4,46,0.5,27,0.587,1,2,0.333,0,1,29,17,13,16,17,0.283,0.348,0.37,17.644,35,python
0,19,24,4,47,0.404,23,0.489,3,4,0.429,1,5,30,17,10,14,23,0.213,0.298,0.489,17.644,36,python
0,19,20,7,46,0.413,26,0.565,1,3,0.25,3,1,28,18,12,12,22,0.261,0.261,0.478,17.649,37,python
0,12,27,7,46,0.261,19,0.413,1,1,0.5,1,0,25,21,8,19,19,0.174,0.413,0.413,17.644,38,python
0,18,23,4,45,0.4,22,0.489,3,4,0.429,5,2,29,16,4,17,24,0.089,0.378,0.533,17.649,39,python
0,22,20,2,44,0.5,24,0.545,1,2,0.333,1,1,30,14,8,12,24,0.182,0.273,0.545,17.655,40,python
0,16,29,4,49,0.327,20,0.408,2,4,0.333,3,1,28,21,7,22,20,0.143,0.449,0.408,17.641,41,python
0,16,21,7,44,0.364,23,0.523,3,1,0.75,1,2,28,16,7,16,21,0.159,0.364,0.477,17.667,42,python
0,18,27,1,46,0.391,19,0.413,3,4,0.429,2,3,28,18,12,11,23,0.261,0.239,0.5,17.671,43,python
0,23,15,5,43,0.535,28,0.651,4,1,0.8,2,2,27,16,12,12,19,0.279,0.279,0.442,17.685,44,python
0,18,19,8,45,0.4,26,0.578,5,0,1.0,6,1,28,17,6,11,28,0.133,0.244,0.622,17.667,45,python
0,21,20,3,44,0.477,24,0.545,7,2,0.778,2,7,30,14,8,13,23,0.182,0.295,0.523,17.675,46,python
0,15,25,6,46,0.326,21,0.457,1,3,0.25,2,0,27,19,8,18,20,0.174,0.391,0.435,17.682,47,python
0,17,22,5,44,0.386,22,0.5,6,2,0.75,2,3,24,20,11,14,19,0.25,0.318,0.432,17.691,48,python
0,19,23,1,43,0.442,20,0.465,5,3,0.625,1,1,29,14,13,8,22,0.302,0.186,0.512,17.686,49,python
0,20,21,4,45,0.444,24,0.533,6,4,0.6,3,3,28,17,14,14,17,0.311,0.311,0.378,17.683,50,python
0,17,24,4,45,0.378,21,0.467,5,0,1.0,0,2,31,14,8,15,22,0.178,0.333,0.489,17.701,51,python
0,18,22,5,45,0.4,23,0.511,2,0,1.0,2,2,31,14,10,12,23,0.222,0.267,0.511,17.686,52,python
0,23,22,3,48,0.479,26,0.542,4,4,0.5,2,5,27,21,13,15,20,0.271,0.312,0.417,17.695,53,python
0,21,19,5,45,0.467,26,0.578,6,3,0.667,3,1,25,20,9,15,21,0.2,0.333,0.467,17.692,54,python
0,23,22,1,46,0.5,24,0.522,4,2,0.667,2,3,27,19,10,17,19,0.217,0.37,0.413,17.689,55,python
0,19,22,6,47,0.404,25,0.532,2,1,0.667,2,5,29,18,8,15,24,0.17,0.319,0.511,17.688,56,python
0,18,21,6,45,0.4,24,0.533,2,1,0.667,2,0,30,15,9,13,23,0.2,0.289,0.511,17.667,57,python
0,23,20,5,48,0.479,28,0.583,2,3,0.4,5,1,26,22,11,12,25,0.229,0.25,0.521,17.667,58,python
0,16,22,7,45,0.356,23,0.511,5,1,0.833,1,1,35,10,5,12,28,0.111,0.267,0.622,17.673,59,python
0,19,25,2,46,0.413,21,0.457,2,1,0.667,1,3,30,16,10,19,17,0.217,0.413,0.37,17.673,60,python
0,22,24,1,47,0.468,23,0.489,2,2,0.5,2,1,31,16,14,14,19,0.298,0.298,0.404,17.664,61,python
0,19,23,3,45,0.422,22,0.489,2,2,0.5,1,0,31,14,8,15,22,0.178,0.333,0.489,17.672,62,python
0,19,23,1,43,0.442,20,0.465,4,2,0.667,2,1,24,19,12,15,16,0.279,0.349,0.372,17.67,63,python
0,26,16,4,46,0.565,30,0.652,1,2,0.333,4,1,26,20,11,13,22,0.239,0.283,0.478,17.658,64,python
0,17,26,1,44,0.386,18,0.409,1,4,0.2,2,1,30,14,11,15,18,0.25,0.341,0.409,17.665,65,python
0,25,19,2,46,0.543,27,0.587,5,1,0.833,6,2,29,17,13,9,24,0.283,0.196,0.522,17.668,66,python
0,17,23,3,43,0.395,20,0.465,4,7,0.364,2,0,21,22,11,19,13,0.256,0.442,0.302,17.67,67,python
0,18,20,8,46,0.391,26,0.565,2,1,0.667,2,2,25,21,8,18,20,0.174,0.391,0.435,17.681,68,python
0,18,22,5,45,0.4,23,0.511,4,2,0.667,2,3,26,19,8,13,24,0.178,0.289,0.533,17.691,69,python
0,20,20,4,44,0.455,24,0.545,3,4,0.429,1,1,27,17,13,12,19,0.295,0.273,0.432,17.686,70,python
0,23,16,7,46,0.5,30,0.652,4,2,0.667,1,2,29,17,14,16,16,0.304,0.348,0.348,17.687,71,python
0,20,25,2,47,0.426,22,0.468,3,1,0.75,1,4,25,22,11,16,20,0.234,0.34,0.426,17.695,72,python
0,18,20,7,45,0.4,25,0.556,2,2,0.5,3,3,29,16,8,12,25,0.178,0.267,0.556,17.693,73,python
0,20,22,3,45,0.444,23,0.511,2,2,0.5,3,3,23,22,11,15,19,0.244,0.333,0.422,17.695,74,python
0,19,21,4,44,0.432,23,0.523,5,3,0.625,2,1,33,11,10,10,24,0.227,0.227,0.545,17.685,75,python
0,17,25,3,45,0.378,20,0.444,1,2,0.333,2,3,25,20,10,14,21,0.222,0.311,0.467,17.688,76,python
0,27,18,3,48,0.562,30,0.625,2,4,0.333,3,1,24,24,17,16,15,0.354,0.333,0.312,17.672,77,python
0,15,23,5,43,0.349,20,0.465,0,2,0.0,1,2,28,15,8,15,20,0.186,0.349,0.465,17.676,78,python
0,19,22,4,45,0.422,23,0.511,1,1,0.5,2,1,26,19,11,13,21,0.244,0.289,0.467,17.677,79,python
0,14,27,4,45,0.311,18,0.4,4,0,1.0,0,2,32,13,10,12,23,0.222,0.267,0.511,17.68,80,python
0,20,20,4,44,0.455,24,0.545,6,0,1.0,4,0,26,18,10,10,24,0.227,0.227,0.545,17.685,81,python
0,17,24,5,46,0.37,22,0.478,4,1,0.8,1,2,23,23,12,13,21,0.261,0.283,0.457,17.687,82,python
0,19,21,4,44,0.432,23,0.523,6,1,0.857,1,3,29,15,10,11,23,0.227,0.25,0.523,17.686,83,python
0,17,27,3,47,0.362,20,0.426,5,5,0.5,0,2,23,24,10,17,20,0.213,0.362,0.426,17.696,84,python
0,25,16,6,47,0.532,31,0.66,5,2,0.714,1,1,25,22,16,12,19,0.34,0.255,0.404,17.693,85,python
0,21,19,5,45,0.467,26,0.578,3,1,0.75,1,2,25,20,9,19,17,0.2,0.422,0.378,17.699,86,python
0,20,20,5,45,0.444,25,0.556,0,1,0.0,1,2,26,19,11,14,20,0.244,0.311,0.444,17.705,87,python
0,23,19,4,46,0.5,27,0.587,4,4,0.5,2,2,30,16,15,15,16,0.326,0.326,0.348,17.706,88,python
0,16,27,1,44,0.364,17,0.386,0,4,0.0,1,0,26,18,9,16,19,0.205,0.364,0.432,17.703,89,python
0,19,23,3,45,0.422,22,0.489,2,1,0.667,2,3,29,16,12,14,19,0.267,0.311,0.422,17.702,90,python
0,19,21,5,45,0.422,24,0.533,1,2,0.333,2,3,27,18,8,16,21,0.178,0.356,0.467,17.699,91,python
0,22,17,5,44,0.5,27,0.614,2,2,0.5,2,2,22,22,17,12,15,0.386,0.273,0.341,17.695,92,python
0,23,18,3,44,0.523,26,0.591,1,0,1.0,0,1,29,15,14,11,19,0.318,0.25,0.432,17.701,93,python
0,22,20,2,44,0.5,24,0.545,4,2,0.667,2,2,24,20,13,12,19,0.295,0.273,0.432,17.699,94,python
0,22,17,6,45,0.489,28,0.622,0,2,0.0,1,2,29,16,9,10,26,0.2,0.222,0.578,17.689,95,python
0,22,17,5,44,0.5,27,0.614,3,3,0.5,3,1,22,22,14,13,17,0.318,0.295,0.386,17.697,96,python
0,23,16,6,45,0.511,29,0.644,3,2,0.6,1,1,28,17,16,8,21,0.356,0.178,0.467,17.0,1,python
0,18,24,2,44,0.409,20,0.455,3,1,0.75,2,3,26,18,12,15,17,0.273,0.341,0.386,17.462,2,python
0,24,18,5,47,0.511,29,0.617,4,1,0.8,6,1,30,17,6,16,25,0.128,0.34,0.532,17.356,3,python
0,17,28,6,51,0.333,23,0.451,4,5,0.444,0,2,33,18,9,20,22,0.176,0.392,0.431,17.619,4,python
0,22,23,4,49,0.449,26,0.531,0,3,0.0,2,3,26,23,11,20,18,0.224,0.408,0.367,17.562,5,python
0,18,21,5,44,0.409,23,0.523,4,2,0.667,2,3,26,18,11,12,21,0.25,0.273,0.477,17.72,6,python
0,19,20,5,44,0.432,24,0.545,4,0,1.0,3,1,25,19,12,12,20,0.273,0.273,0.455,17.657,7,python
0,14,26,7,47,0.298,21,0.447,1,6,0.143,4,5,29,18,5,19,23,0.106,0.404,0.489,17.654,8,python
0,23,17,4,44,0.523,27,0.614,2,2,0.5,2,3,24,20,12,13,19,0.273,0.295,0.432,17.659,9,python
0,15,26,4,45,0.333,19,0.422,1,1,0.5,3,3,28,17,8,18,19,0.178,0.4,0.422,17.695,10,python
0,23,19,4,46,0.5,27,0.587,4,4,0.5,1,2,31,15,16,11,19,0.348,0.239,0.413,17.734,11,python
0,22,20,3,45,0.489,25,0.556,3,3,0.5,3,1,27,18,10,20,15,0.222,0.444,0.333,17.725,12,python
0,24,18,3,45,0.533,27,0.6,0,2,0.0,5,3,21,24,17,12,16,0.378,0.267,0.356,17.672,13,python
0,24,16,5,45,0.533,29,0.644,2,3,0.4,2,2,27,18,10,12,23,0.222,0.267,0.511,17.642,14,python
0,18,27,1,46,0.391,19,0.413,2,3,0.4,2,3,31,15,8,14,24,0.174,0.304,0.522,17.597,15,python
0,23,19,6,48,0.479,29,0.604,0,2,0.0,3,3,26,22,13,13,22,0.271,0.271,0.458,17.624,16,python
0,18,26,4,48,0.375,22,0.458,1,4,0.2,3,3,26,22,9,14,25,0.188,0.292,0.521,17.635,17,python
0,21,24,3,48,0.438,24,0.5,3,2,0.6,2,0,22,26,14,15,19,0.292,0.312,0.396,17.661,18,python
0,18,22,7,47,0.383,25,0.532,2,0,1.0,3,1,29,18,7,17,23,0.149,0.362,0.489,17.655,19,python
0,25,23,1,49,0.51,26,0.531,2,2,0.5,4,2,25,24,13,18,18,0.265,0.367,0.367,17.666,20,python
0,21,20,4,45,0.467,25,0.556,2,4,0.333,3,0,26,19,7,17,21,0.156,0.378,0.467,17.669,21,python
0,25,20,2,47,0.532,27,0.574,0,2,0.0,2,4,30,17,11,13,23,0.234,0.277,0.489,17.622,22,python
0,24,17,4,45,0.533,28,0.622,2,0,1.0,2,3,31,14,15,8,22,0.333,0.178,0.489,17.591,23,python
0,18,19,8,45,0.4,26,0.578,2,2,0.5,1,3,33,12,10,8,27,0.222,0.178,0.6,17.576,24,python
0,18,21,8,47,0.383,26,0.553,3,3,0.5,4,2,25,22,6,19,22,0.128,0.404,0.468,17.59,25,python
0,18,21,7,46,0.391,25,0.543,1,4,0.2,2,2,29,17,8,16,22,0.174,0.348,0.478,17.578,26,python
0,19,25,2,46,0.413,21,0.457,3,2,0.6,1,2,25,21,13,14,19,0.283,0.304,0.413,17.605,27,python
0,19,19,7,45,0.422,26,0.578,1,1,0.5,2,0,31,14,9,17,19,0.2,0.378,0.422,17.621,28,python
0,22,22,5,49,0.449,27,0.551,3,2,0.6,1,3,28,21,14,18,17,0.286,0.367,0.347,17.637,29,python
0,20,26,1,47,0.426,21,0.447,5,1,0.833,3,3,30,17,9,14,24,0.191,0.298,0.511,17.637,30,python
0,19,24,4,47,0.404,23,0.489,4,1,0.8,1,2,33,14,9,18,20,0.191,0.383,0.426,17.644,31,python
0,20,20,5,45,0.444,25,0.556,3,0,1.0,4,2,28,17,8,17,20,0.178,0.378,0.444,17.654,32,python
0,20,21,3,44,0.455,23,0.523,3,3,0.5,2,1,27,17,9,18,17,0.205,0.409,0.386,17.672,33,python
0,21,19,4,44,0.477,25,0.568,3,1,0.75,2,2,25,19,13,11,20,0.295,0.25,0.455,17.678,34,python
0,17,27,3,47,0.362,20,0.426,0,1,0.0,3,2,26,21,6,19,22,0.128,0.404,0.468,17.657,35,python
0,16,26,4,46,0.348,20,0.435,2,5,0.286,3,4,24,22,11,13,22,0.239,0.283,0.478,17.635,36,python
0,20,22,4,46,0.435,24,0.522,2,4,0.333,1,3,24,22,10,17,19,0.217,0.37,0.413,17.632,37,python
0,20,20,5,45,0.444,25,0.556,4,3,0.571,2,3,32,13,12,12,21,0.267,0.267,0.467,17.63,38,python
0,19,23,2,44,0.432,21,0.477,3,2,0.6,1,1,37,7,9,7,28,0.205,0.159,0.636,17.625,39,python
0,22,22,3,47,0.468,25,0.532,4,2,0.667,1,1,25,22,10,20,17,0.213,0.426,0.362,17.641,40,python
0,21,24,0,45,0.467,21,0.467,4,1,0.8,1,3,28,17,11,10,24,0.244,0.222,0.533,17.624,41,python
0,18,22,5,45,0.4,23,0.511,4,2,0.667,1,2,28,17,14,14,17,0.311,0.311,0.378,17.623,42,python
0,19,25,1,45,0.422,20,0.444,3,2,0.6,3,3,34,11,11,9,25,0.244,0.2,0.556,17.632,43,python
0,14,26,6,46,0.304,20,0.435,2,1,0.667,4,3,32,14,6,13,27,0.13,0.283,0.587,17.642,44,python
0,20,21,4,45,0.444,24,0.533,3,2,0.6,3,1,29,16,8,17,20,0.178,0.378,0.444,17.635,45,python
0,15,20,8,43,0.349,23,0.535,3,3,0.5,0,3,28,15,10,17,16,0.233,0.395,0.372,17.646,46,python
0,16,26,3,45,0.356,19,0.422,3,2,0.6,6,2,29,16,5,14,26,0.111,0.311,0.578,17.645,47,python
0,18,25,2,45,0.4,20,0.444,1,3,0.25,2,1,21,24,10,16,19,0.222,0.356,0.422,17.64,48,python
0,17,29,3,49,0.347,20,0.408,3,5,0.375,3,2,27,22,8,19,22,0.163,0.388,0.449,17.647,49,python
0,20,21,2,43,0.465,22,0.512,2,1,0.667,2,2,30,13,7,14,22,0.163,0.326,0.512,17.65,50,python
0,19,23,3,45,0.422,22,0.489,5,2,0.714,4,2,29,16,13,8,24,0.289,0.178,0.533,17.634,51,python
0,20,23,1,44,0.455,21,0.477,4,4,0.5,1,2,24,20,11,14,19,0.25,0.318,0.432,17.627,52,python
0,23,21,5,49,0.469,28,0.571,7,1,0.875,2,3,25,24,13,17,19,0.265,0.347,0.388,17.63,53,python
0,22,17,3,42,0.524,25,0.595,3,1,0.75,0,2,28,14,9,14,19,0.214,0.333,0.452,17.638,54,python
0,26,16,5,47,0.553,31,0.66,9,2,0.818,4,1,24,23,14,14,19,0.298,0.298,0.404,17.636,55,python
0,22,25,3,50,0.44,25,0.5,4,5,0.444,3,1,28,22,11,17,22,0.22,0.34,0.44,17.64,56,python
0,16,25,5,46,0.348,21,0.457,3,1,0.75,0,2,33,13,8,10,28,0.174,0.217,0.609,17.652,57,python
0,22,19,5,46,0.478,27,0.587,2,1,0.667,2,4,26,20,12,18,16,0.261,0.391,0.348,17.657,58,python
0,26,17,3,46,0.565,29,0.63,3,4,0.429,4,0,25,21,14,12,20,0.304,0.261,0.435,17.644,59,python
0,15,27,4,46,0.326,19,0.413,3,2,0.6,0,5,33,13,6,16,24,0.13,0.348,0.522,17.648,60,python
0,15,29,1,45,0.333,16,0.356,2,4,0.333,1,5,24,21,8,18,19,0.178,0.4,0.422,17.649,61,python
0,19,21,5,45,0.422,24,0.533,2,4,0.333,1,1,27,18,11,16,18,0.244,0.356,0.4,17.646,62,python
0,15,27,3,45,0.333,18,0.4,0,2,0.0,3,2,29,16,9,17,19,0.2,0.378,0.422,17.652,63,python
0,27,17,0,44,0.614,27,0.614,5,1,0.833,5,2,27,17,15,12,17,0.341,0.273,0.386,17.648,64,python
0,18,26,5,49,0.367,23,0.469,0,2,0.0,4,3,27,22,7,16,26,0.143,0.327,0.531,17.644,65,python
0,17,24,4,45,0.378,21,0.467,4,2,0.667,4,2,27,18,5,17,23,0.111,0.378,0.511,17.64,66,python
0,20,23,3,46,0.435,23,0.5,4,2,0.667,1,2,27,19,9,16,21,0.196,0.348,0.457,17.641,67,python
0,26,18,3,47,0.553,29,0.617,6,4,0.6,5,1,28,19,12,13,22,0.255,0.277,0.468,17.645,68,python
0,19,18,7,44,0.432,26,0.591,2,4,0.333,1,2,29,15,17,10,17,0.386,0.227,0.386,17.635,69,python
0,19,20,5,44,0.432,24,0.545,2,2,0.5,1,4,26,18,10,15,19,0.227,0.341,0.432,17.635,70,python
0,25,20,3,48,0.521,28,0.583,3,1,0.75,6,2,28,20,12,13,23,0.25,0.271,0.479,17.625,71,python
0,21,20,4,45,0.467,25,0.556,3,2,0.6,4,1,32,13,11,16,18,0.244,0.356,0.4,17.629,72,python
0,17,24,4,45,0.378,21,0.467,4,4,0.5,1,1,25,20,9,18,18,0.2,0.4,0.4,17.629,73,python
0,21,25,2,48,0.438,23,0.479,4,4,0.5,2,4,31,17,10,14,24,0.208,0.292,0.5,17.628,74,python
0,20,20,3,43,0.465,23,0.535,1,2,0.333,2,2,30,13,9,12,22,0.209,0.279,0.512,17.637,75,python
0,20,22,2,44,0.455,22,0.5,3,0,1.0,0,1,30,14,8,14,22,0.182,0.318,0.5,17.638,76,python
0,20,19,6,45,0.444,26,0.578,5,3,0.625,3,2,28,17,10,14,21,0.222,0.311,0.467,17.635,77,python
0,14,25,7,46,0.304,21,0.457,2,4,0.333,0,1,36,10,10,13,23,0.217,0.283,0.5,17.638,78,python
0,14,27,3,44,0.318,17,0.386,2,3,0.4,1,4,26,18,7,16,21,0.159,0.364,0.477,17.65,79,python
0,19,17,7,43,0.442,26,0.605,4,0,1.0,1,0,24,19,13,15,15,0.302,0.349,0.349,17.653,80,python
0,18,20,6,44,0.409,24,0.545,3,2,0.6,2,1,26,18,10,12,22,0.227,0.273,0.5,17.652,81,python
0,24,16,7,47,0.511,31,0.66,5,1,0.833,3,0,25,22,10,17,20,0.213,0.362,0.426,17.648,82,python
0,22,19,6,47,0.468,28,0.596,2,2,0.5,2,0,26,21,15,13,19,0.319,0.277,0.404,17.645,83,python
0,19,25,1,45,0.422,20,0.444,2,1,0.667,2,2,27,18,10,15,20,0.222,0.333,0.444,17.642,84,python
0,22,19,4,45,0.489,26,0.578,4,4,0.5,4,1,21,24,12,18,15,0.267,0.4,0.333,17.637,85,python
0,23,20,2,45,0.511,25,0.556,4,4,0.5,4,1,29,16,12,14,19,0.267,0.311,0.422,17.643,86,python
0,25,20,3,48,0.521,28,0.583,4,3,0.571,3,4,31,17,16,13,19,0.333,0.271,0.396,17.639,87,python
0,17,23,5,45,0.378,22,0.489,3,3,0.5,3,4,30,15,5,14,26,0.111,0.311,0.578,17.64,88,python
0,18,26,3,47,0.383,21,0.447,1,6,0.143,4,2,27,20,11,16,20,0.234,0.34,0.426,17.644,89,python
0,21,23,2,46,0.457,23,0.5,4,1,0.8,1,2,33,13,7,14,25,0.152,0.304,0.543,17.645,90,python
0,20,23,3,46,0.435,23,0.5,3,1,0.75,1,4,26,20,11,15,20,0.239,0.326,0.435,17.646,91,python
0,20,21,3,44,0.455,23,0.523,3,2,0.6,1,1,28,16,6,19,19,0.136,0.432,0.432,17.646,92,python
0,25,18,3,46,0.543,28,0.609,6,2,0.75,2,2,31,15,16,7,23,0.348,0.152,0.5,17.652,93,python
0,17,22,5,44,0.386,22,0.5,0,2,0.0,2,3,30,14,6,18,20,0.136,0.409,0.455,17.656,94,python
0,19,29,3,51,0.373,22,0.431,6,3,0.667,1,5,30,21,10,18,23,0.196,0.353,0.451,17.656,95,python
0,19,27,2,48,0.396,21,0.438,4,4,0.5,2,3,26,22,8,20,20,0.167,0.417,0.417,17.655,96,python
0,20,25,3,48,0.417,23,0.479,2,1,0.667,4,4,30,18,10,12,26,0.208,0.25,0.542,16.821,1,python
0,24,19,2,45,0.533,26,0.578,5,1,0.833,1,4,27,18,10,15,20,0.222,0.333,0.444,17.375,2,python
0,22,20,4,46,0.478,26,0.565,6,2,0.75,1,1,26,20,14,13,19,0.304,0.283,0.413,17.548,3,python
0,21,24,1,46,0.457,22,0.478,3,2,0.6,0,2,27,19,10,16,20,0.217,0.348,0.435,17.719,4,python
0,20,26,3,49,0.408,23,0.469,3,1,0.75,2,4,42,7,10,9,30,0.204,0.184,0.612,17.855,5,python
0,17,23,4,44,0.386,21,0.477,2,5,0.286,1,2,29,15,11,16,17,0.25,0.364,0.386,17.867,6,python
0,21,22,2,45,0.467,23,0.511,2,1,0.667,5,3,26,19,7,11,27,0.156,0.244,0.6,17.702,7,python
0,22,22,6,50,0.44,28,0.56,4,6,0.4,3,3,25,25,12,15,23,0.24,0.3,0.46,17.718,8,python
0,20,22,6,48,0.417,26,0.542,1,0,1.0,1,2,26,22,13,18,17,0.271,0.375,0.354,17.713,9,python
0,18,22,4,44,0.409,22,0.5,4,3,0.571,3,1,25,19,13,13,18,0.295,0.295,0.409,17.722,10,python
0,17,25,3,45,0.378,20,0.444,2,1,0.667,1,4,32,13,10,8,27,0.222,0.178,0.6,17.706,11,python
0,17,26,3,46,0.37,20,0.435,2,0,1.0,1,1,29,17,5,18,23,0.109,0.391,0.5,17.746,12,python
0,24,23,2,49,0.49,26,0.531,0,1,0.0,1,4,25,24,14,14,21,0.286,0.286,0.429,17.707,13,python
0,20,22,4,46,0.435,24,0.522,2,1,0.667,1,2,27,19,11,14,21,0.239,0.304,0.457,17.718,14,python
0,22,21,2,45,0.489,24,0.533,2,4,0.333,3,3,33,12,11,16,18,0.244,0.356,0.4,17.697,15,python
0,19,22,6,47,0.404,25,0.532,6,3,0.667,3,1,25,22,8,16,23,0.17,0.34,0.489,17.731,16,python
0,20,20,4,44,0.455,24,0.545,6,3,0.667,1,3,30,14,9,15,20,0.205,0.341,0.455,17.759,17,python
0,16,26,5,47,0.34,21,0.447,3,1,0.75,1,5,26,21,8,20,19,0.17,0.426,0.404,17.734,18,python
0,27,18,3,48,0.562,30,0.625,4,1,0.8,6,1,30,18,15,11,22,0.312,0.229,0.458,17.702,19,python
0,21,23,1,45,0.467,22,0.489,5,1,0.833,1,3,30,15,15,11,19,0.333,0.244,0.422,17.703,20,python
0,15,28,2,45,0.333,17,0.378,1,4,0.2,3,4,25,20,9,16,20,0.2,0.356,0.444,17.695,21,python
0,15,26,6,47,0.319,21,0.447,2,4,0.333,1,2,25,22,10,19,18,0.213,0.404,0.383,17.699,22,python
0,20,19,5,44,0.455,25,0.568,2,1,0.667,2,1,27,17,10,19,15,0.227,0.432,0.341,17.725,23,python
0,18,23,5,46,0.391,23,0.5,4,0,1.0,1,3,28,18,9,16,21,0.196,0.348,0.457,17.752,24,python
0,27,16,1,44,0.614,28,0.636,2,0,1.0,2,0,23,21,19,10,15,0.432,0.227,0.341,17.731,25,python
0,20,22,2,44,0.455,22,0.5,3,3,0.5,1,2,31,13,12,15,17,0.273,0.341,0.386,17.767,26,python
0,17,29,3,49,0.347,20,0.408,1,2,0.333,0,1,30,19,8,17,24,0.163,0.347,0.49,17.77,27,python
0,16,27,2,45,0.356,18,0.4,3,4,0.429,5,2,29,16,5,15,25,0.111,0.333,0.556,17.74,28,python
0,25,14,4,43,0.581,29,0.674,5,0,1.0,4,1,21,22,14,15,14,0.326,0.349,0.326,17.733,29,python
0,20,20,4,44,0.455,24,0.545,5,2,0.714,1,0,24,20,12,16,16,0.273,0.364,0.364,17.726,30,python
0,25,15,5,45,0.556,30,0.667,4,0,1.0,6,1,27,18,13,13,19,0.289,0.289,0.422,17.721,31,python
0,18,24,2,44,0.409,20,0.455,3,4,0.429,2,1,22,22,8,21,15,0.182,0.477,0.341,17.697,32,python
0,16,22,7,45,0.356,23,0.511,1,2,0.333,3,1,34,11,7,11,27,0.156,0.244,0.6,17.675,33,python
0,13,28,4,45,0.289,17,0.378,4,4,0.5,0,4,28,17,7,14,24,0.156,0.311,0.533,17.676,34,python
0,16,25,5,46,0.348,21,0.457,1,2,0.333,1,2,28,18,10,14,22,0.217,0.304,0.478,17.68,35,python
0,16,25,3,44,0.364,19,0.432,0,3,0.0,3,1,32,12,7,15,22,0.159,0.341,0.5,17.69,36,python
0,19,20,4,43,0.442,23,0.535,3,2,0.6,1,0,25,18,10,14,19,0.233,0.326,0.442,17.702,37,python
0,26,16,4,46,0.565,30,0.652,4,1,0.8,4,3,27,19,13,14,19,0.283,0.304,0.413,17.707,38,python
0,23,24,3,50,0.46,26,0.52,2,2,0.5,7,2,35,15,10,17,23,0.2,0.34,0.46,17.685,39,python
0,21,20,6,47,0.447,27,0.574,2,1,0.667,4,3,26,21,12,14,21,0.255,0.298,0.447,17.684,40,python
0,19,25,4,48,0.396,23,0.479,2,4,0.333,4,5,28,20,9,16,23,0.188,0.333,0.479,17.686,41,python
0,26,18,4,48,0.542,30,0.625,3,3,0.5,3,1,26,22,17,18,13,0.354,0.375,0.271,17.677,42,python
0,22,19,3,44,0.5,25,0.568,2,0,1.0,3,1,27,17,13,10,21,0.295,0.227,0.477,17.66,43,python
0,17,23,6,46,0.37,23,0.5,3,5,0.375,0,3,27,19,11,16,19,0.239,0.348,0.413,17.666,44,python
0,25,20,4,49,0.51,29,0.592,4,1,0.8,3,2,29,20,12,15,22,0.245,0.306,0.449,17.661,45,python
0,25,21,1,47,0.532,26,0.553,5,3,0.625,3,2,24,23,13,16,18,0.277,0.34,0.383,17.646,46,python
0,18,22,3,43,0.419,21,0.488,6,0,1.0,1,2,25,18,11,16,16,0.256,0.372,0.372,17.652,47,python
0,20,19,4,43,0.465,24,0.558,3,1,0.75,2,3,31,12,11,8,24,0.256,0.186,0.558,17.655,48,python
0,19,22,4,45,0.422,23,0.511,1,3,0.25,2,2,22,23,12,18,15,0.267,0.4,0.333,17.661,49,python
0,20,19,6,45,0.444,26,0.578,2,2,0.5,3,2,31,14,10,12,23,0.222,0.267,0.511,17.655,50,python
0,19,20,4,43,0.442,23,0.535,4,1,0.8,1,1,27,16,7,18,18,0.163,0.419,0.419,17.644,51,python
0,21,19,4,44,0.477,25,0.568,5,1,0.833,2,2,27,17,10,11,23,0.227,0.25,0.523,17.64,52,python
0,15,30,2,47,0.319,17,0.362,2,0,1.0,2,4,29,18,9,19,19,0.191,0.404,0.404,17.642,53,python
0,18,22,7,47,0.383,25,0.532,3,3,0.5,0,1,31,16,10,17,20,0.213,0.362,0.426,17.654,54,python
0,16,22,8,46,0.348,24,0.522,0,1,0.0,0,3,34,12,2,20,24,0.043,0.435,0.522,17.663,55,python
0,20,22,2,44,0.455,22,0.5,4,2,0.667,1,3,24,20,7,18,19,0.159,0.409,0.432,17.672,56,python
0,22,21,2,45,0.489,24,0.533,5,3,0.625,1,1,25,20,14,16,15,0.311,0.356,0.333,17.665,57,python
0,21,19,5,45,0.467,26,0.578,1,1,0.5,5,0,23,22,12,15,18,0.267,0.333,0.4,17.67,58,python
0,20,21,4,45,0.444,24,0.533,3,1,0.75,2,5,30,15,13,9,23,0.289,0.2,0.511,17.659,59,python
0,25,17,2,44,0.568,27,0.614,3,1,0.75,2,2,28,16,12,10,22,0.273,0.227,0.5,17.652,60,python
0,28,14,4,46,0.609,32,0.696,7,1,0.875,3,5,25,21,18,14,14,0.391,0.304,0.304,17.661,61,python
0,22,20,3,45,0.489,25,0.556,3,3,0.5,2,4,26,19,13,15,17,0.289,0.333,0.378,17.657,62,python
0,18,24,3,45,0.4,21,0.467,3,5,0.375,2,4,30,15,7,13,25,0.156,0.289,0.556,17.668,63,python
0,21,20,4,45,0.467,25,0.556,4,6,0.4,4,3,26,19,7,17,21,0.156,0.378,0.467,17.661,64,python
0,22,22,2,46,0.478,24,0.522,2,1,0.667,2,2,28,18,14,12,20,0.304,0.261,0.435,17.671,65,python
0,21,20,4,45,0.467,25,0.556,3,1,0.75,3,1,31,14,13,8,24,0.289,0.178,0.533,17.662,66,python
0,14,24,7,45,0.311,21,0.467,0,1,0.0,2,3,31,14,6,16,23,0.133,0.356,0.511,17.672,67,python
0,22,16,6,44,0.5,28,0.636,5,2,0.714,3,2,21,23,13,12,19,0.295,0.273,0.432,17.672,68,python
0,19,28,2,49,0.388,21,0.429,4,2,0.667,1,4,27,22,12,16,21,0.245,0.327,0.429,17.661,69,python
0,16,25,5,46,0.348,21,0.457,2,5,0.286,3,1,22,24,10,17,19,0.217,0.37,0.413,17.658,70,python
0,14,25,3,42,0.333,17,0.405,3,2,0.6,1,2,28,14,11,13,18,0.262,0.31,0.429,17.653,71,python
0,13,28,5,46,0.283,18,0.391,3,2,0.6,0,3,31,15,8,16,22,0.174,0.348,0.478,17.652,72,python
0,22,19,4,45,0.489,26,0.578,3,3,0.5,2,2,26,19,11,11,23,0.244,0.244,0.511,17.642,73,python
0,19,24,1,44,0.432,20,0.455,2,2,0.5,3,1,29,15,7,17,20,0.159,0.386,0.455,17.651,74,python
0,20,22,4,46,0.435,24,0.522,3,2,0.6,4,3,25,21,9,16,21,0.196,0.348,0.457,17.651,75,python
0,22,18,4,44,0.5,26,0.591,1,3,0.25,3,1,25,19,10,15,19,0.227,0.341,0.432,17.651,76,python
0,21,18,6,45,0.467,27,0.6,2,1,0.667,5,1,31,14,11,11,23,0.244,0.244,0.511,17.651,77,python
0,20,24,3,47,0.426,23,0.489,3,5,0.375,5,2,31,16,6,17,24,0.128,0.362,0.511,17.664,78,python
0,24,20,6,50,0.48,30,0.6,2,1,0.667,2,4,28,22,11,13,26,0.22,0.26,0.52,17.663,79,python
0,22,23,5,50,0.44,27,0.54,1,3,0.25,2,0,31,19,11,14,25,0.22,0.28,0.5,17.666,80,python
0,25,16,3,44,0.568,28,0.636,7,1,0.875,1,0,27,17,15,14,15,0.341,0.318,0.341,17.668,81,python
0,13,29,4,46,0.283,17,0.37,2,1,0.667,4,3,28,18,8,14,24,0.174,0.304,0.522,17.668,82,python
0,22,19,3,44,0.5,25,0.568,3,1,0.75,2,0,28,16,9,11,24,0.205,0.25,0.545,17.657,83,python
0,20,20,6,46,0.435,26,0.565,2,1,0.667,2,4,32,14,11,11,24,0.239,0.239,0.522,17.656,84,python
0,17,21,7,45,0.378,24,0.533,5,3,0.625,2,3,30,15,5,14,26,0.111,0.311,0.578,17.649,85,python
0,21,24,6,51,0.412,27,0.529,3,5,0.375,4,1,36,15,12,20,19,0.235,0.392,0.373,17.659,86,python
0,20,23,2,45,0.444,22,0.489,1,1,0.5,1,3,31,14,9,13,23,0.2,0.289,0.511,17.655,87,python
0,15,30,3,48,0.312,18,0.375,3,5,0.375,1,2,39,9,9,12,27,0.188,0.25,0.562,17.646,88,python
0,25,18,5,48,0.521,30,0.625,2,2,0.5,2,1,26,22,17,14,17,0.354,0.292,0.354,17.649,89,python
0,20,24,2,46,0.435,22,0.478,3,2,0.6,2,2,29,17,8,12,26,0.174,0.261,0.565,17.647,90,python
0,12,24,7,43,0.279,19,0.442,2,2,0.5,0,2,29,14,6,17,20,0.14,0.395,0.465,17.657,91,python
0,18,25,1,44,0.409,19,0.432,2,2,0.5,2,3,30,14,13,14,17,0.295,0.318,0.386,17.659,92,python
0,17,25,4,46,0.37,21,0.457,2,3,0.4,0,2,30,16,8,18,20,0.174,0.391,0.435,17.662,93,python
0,23,18,3,44,0.523,26,0.591,6,2,0.75,1,2,22,22,14,15,15,0.318,0.341,0.341,17.663,94,python
0,18,25,2,45,0.4,20,0.444,1,2,0.333,3,2,24,21,9,18,18,0.2,0.4,0.4,17.651,95,python
0,12,28,5,45,0.267,17,0.378,1,2,0.333,3,4,33,12,7,14,24,0.156,0.311,0.533,17.652,96,python
0,18,20,5,43,0.419,23,0.535,4,5,0.444,1,1,26,17,9,13,21,0.209,0.302,0.488,17.323,1,python
0,19,22,4,45,0.422,23,0.511,2,3,0.4,1,4,25,20,13,15,17,0.289,0.333,0.378,17.545,2,python
0,21,19,4,44,0.477,25,0.568,7,3,0.7,1,1,25,19,14,16,14,0.318,0.364,0.318,17.819,3,python
0,23,21,1,45,0.511,24,0.533,6,4,0.6,3,2,27,18,13,12,20,0.289,0.267,0.444,17.809,4,python
0,20,23,2,45,0.444,22,0.489,2,3,0.4,1,2,29,16,10,13,22,0.222,0.289,0.489,17.819,5,python
0,22,18,2,42,0.524,24,0.571,5,3,0.625,2,0,28,14,14,11,17,0.333,0.262,0.405,17.915,6,python
0,23,20,1,44,0.523,24,0.545,5,0,1.0,3,2,25,19,13,12,19,0.295,0.273,0.432,17.854,7,python
0,17,24,3,44,0.386,20,0.455,6,4,0.6,1,3,31,13,8,14,22,0.182,0.318,0.5,17.851,8,python
0,18,26,2,46,0.391,20,0.435,5,2,0.714,3,2,31,15,6,17,23,0.13,0.37,0.5,17.758,9,python
0,17,22,5,44,0.386,22,0.5,3,6,0.333,0,2,26,18,8,16,20,0.182,0.364,0.455,17.723,10,python
0,16,22,4,42,0.381,20,0.476,3,2,0.6,0,1,28,14,12,11,19,0.286,0.262,0.452,17.712,11,python
0,18,25,3,46,0.391,21,0.457,3,2,0.6,3,2,30,16,8,17,21,0.174,0.37,0.457,17.725,12,python
0,22,21,4,47,0.468,26,0.553,2,2,0.5,4,2,30,17,12,15,20,0.255,0.319,0.426,17.692,13,python
0,18,26,2,46,0.391,20,0.435,4,5,0.444,3,2,25,21,10,12,24,0.217,0.261,0.522,17.721,14,python
0,22,22,2,46,0.478,24,0.522,1,4,0.2,3,2,28,18,10,15,21,0.217,0.326,0.457,17.644,15,python
0,22,20,4,46,0.478,26,0.565,3,4,0.429,2,2,30,16,12,10,24,0.261,0.217,0.522,17.706,16,python
0,17,23,3,43,0.395,20,0.465,0,4,0.0,3,1,26,17,6,17,20,0.14,0.395,0.465,17.735,17,python
0,23,21,3,47,0.489,26,0.553,3,1,0.75,2,2,29,18,14,8,25,0.298,0.17,0.532,17.669,18,python
0,21,21,2,44,0.477,23,0.523,3,3,0.5,1,1,27,17,14,14,16,0.318,0.318,0.364,17.684,19,python
0,19,24,4,47,0.404,23,0.489,3,6,0.333,2,4,27,20,11,18,18,0.234,0.383,0.383,17.69,20,python
0,18,22,4,44,0.409,22,0.5,6,1,0.857,3,3,23,21,11,13,20,0.25,0.295,0.455,17.671,21,python
0,28,22,0,50,0.56,28,0.56,5,0,1.0,1,4,32,18,11,7,32,0.22,0.14,0.64,17.657,22,python
0,19,20,8,47,0.404,27,0.574,3,0,1.0,3,1,34,13,9,12,26,0.191,0.255,0.553,17.644,23,python
0,17,25,5,47,0.362,22,0.468,1,3,0.25,1,3,28,19,5,19,23,0.106,0.404,0.489,17.664,24,python
0,24,16,3,43,0.558,27,0.628,9,4,0.692,1,0,29,14,13,11,19,0.302,0.256,0.442,17.668,25,python
0,17,27,3,47,0.362,20,0.426,2,3,0.4,4,0,27,20,11,19,17,0.234,0.404,0.362,17.679,26,python
0,20,18,5,43,0.465,25,0.581,1,1,0.5,1,2,29,14,11,10,22,0.256,0.233,0.512,17.691,27,python
0,15,26,4,45,0.333,19,0.422,2,2,0.5,1,1,32,13,9,15,21,0.2,0.333,0.467,17.706,28,python
0,13,26,5,44,0.295,18,0.409,0,3,0.0,1,3,33,11,7,14,23,0.159,0.318,0.523,17.712,29,python
0,18,24,3,45,0.4,21,0.467,1,3,0.25,3,1,27,18,9,16,20,0.2,0.356,0.444,17.669,30,python
0,21,21,5,47,0.447,26,0.553,3,0,1.0,3,0,27,20,10,18,19,0.213,0.383,0.404,17.693,31,python
0,18,22,4,44,0.409,22,0.5,5,3,0.625,1,0,25,19,13,14,17,0.295,0.318,0.386,17.7,32,python
0,21,23,1,45,0.467,22,0.489,4,3,0.571,2,6,30,15,9,15,21,0.2,0.333,0.467,17.714,33,python
0,24,18,3,45,0.533,27,0.6,4,3,0.571,4,3,24,21,12,13,20,0.267,0.289,0.444,17.69,34,python
0,15,29,1,45,0.333,16,0.356,4,6,0.4,1,3,30,15,10,16,19,0.222,0.356,0.422,17.709,35,python
0,20,16,7,43,0.465,27,0.628,4,0,1.0,1,1,28,15,15,9,19,0.349,0.209,0.442,17.725,36,python
0,18,23,4,45,0.4,22,0.489,3,3,0.5,0,1,23,22,14,17,14,0.311,0.378,0.311,17.737,37,python
0,17,23,4,44,0.386,21,0.477,5,0,1.0,1,4,27,17,7,18,19,0.159,0.409,0.432,17.744,38,python
0,18,22,6,46,0.391,24,0.522,2,5,0.286,1,0,28,18,12,17,17,0.261,0.37,0.37,17.759,39,python
0,23,21,3,47,0.489,26,0.553,2,1,0.667,5,1,25,22,11,16,20,0.234,0.34,0.426,17.741,40,python
0,24,18,2,44,0.545,26,0.591,5,2,0.714,0,2,28,16,12,12,20,0.273,0.273,0.455,17.728,41,python
0,23,21,1,45,0.511,24,0.533,3,1,0.75,2,2,24,21,12,13,20,0.267,0.289,0.444,17.709,42,python
0,19,16,9,44,0.432,28,0.636,1,4,0.2,2,2,27,17,15,14,15,0.341,0.318,0.341,17.716,43,python
0,20,18,5,43,0.465,25,0.581,4,0,1.0,3,3,25,18,12,17,14,0.279,0.395,0.326,17.709,44,python
0,23,23,0,46,0.5,23,0.5,5,0,1.0,3,3,30,16,11,14,21,0.239,0.304,0.457,17.71,45,python
0,19,21,5,45,0.422,24,0.533,2,2,0.5,2,2,29,16,9,17,19,0.2,0.378,0.422,17.727,46,python
0,21,19,4,44,0.477,25,0.568,4,3,0.571,1,1,27,17,12,17,15,0.273,0.386,0.341,17.729,47,python
0,15,28,2,45,0.333,17,0.378,4,2,0.667,2,4,31,14,4,19,22,0.089,0.422,0.489,17.73,48,python
0,21,22,4,47,0.447,25,0.532,3,1,0.75,3,1,28,19,9,15,23,0.191,0.319,0.489,17.725,49,python
0,24,20,2,46,0.522,26,0.565,4,5,0.444,3,5,25,21,12,13,21,0.261,0.283,0.457,17.721,50,python
0,23,19,2,44,0.523,25,0.568,3,2,0.6,1,4,21,23,17,10,17,0.386,0.227,0.386,17.719,51,python
0,19,23,5,47,0.404,24,0.511,2,1,0.667,6,1,28,19,8,16,23,0.17,0.34,0.489,17.708,52,python
0,25,15,3,43,0.581,28,0.651,3,3,0.5,1,2,24,19,15,16,12,0.349,0.372,0.279,17.716,53,python
0,21,21,3,45,0.467,24,0.533,4,1,0.8,0,2,23,22,15,11,19,0.333,0.244,0.422,17.726,54,python
0,24,16,4,44,0.545,28,0.636,4,0,1.0,3,4,29,15,12,14,18,0.273,0.318,0.409,17.721,55,python
0,20,22,2,44,0.455,22,0.5,6,3,0.667,2,4,28,16,11,12,21,0.25,0.273,0.477,17.719,56,python
0,19,21,3,43,0.442,22,0.512,5,5,0.5,2,2,29,14,8,16,19,0.186,0.372,0.442,17.71,57,python
0,18,23,1,42,0.429,19,0.452,1,3,0.25,1,1,25,17,12,12,18,0.286,0.286,0.429,17.718,58,python
0,23,16,6,45,0.511,29,0.644,5,3,0.625,2,0,24,21,8,20,17,0.178,0.444,0.378,17.721,59,python
0,25,17,2,44,0.568,27,0.614,5,3,0.625,1,0,21,23,16,16,12,0.364,0.364,0.273,17.723,60,python
0,22,16,6,44,0.5,28,0.636,5,2,0.714,3,3,25,19,12,15,17,0.273,0.341,0.386,17.714,61,python
0,21,22,2,45,0.467,23,0.511,5,4,0.556,2,4,27,18,11,13,21,0.244,0.289,0.467,17.697,62,python
0,18,25,6,49,0.367,24,0.49,2,2,0.5,3,2,37,12,9,11,29,0.184,0.224,0.592,17.699,63,python
0,15,27,5,47,0.319,20,0.426,2,3,0.4,2,2,30,17,6,16,25,0.128,0.34,0.532,17.696,64,python
0,22,25,2,49,0.449,24,0.49,0,2,0.0,2,4,33,16,13,13,23,0.265,0.265,0.469,17.692,65,python
0,25,21,2,48,0.521,27,0.562,1,3,0.25,2,2,27,21,13,18,17,0.271,0.375,0.354,17.689,66,python
0,20,23,1,44,0.455,21,0.477,4,3,0.571,0,3,26,18,15,12,17,0.341,0.273,0.386,17.689,67,python
0,20,22,4,46,0.435,24,0.522,3,1,0.75,3,3,28,18,10,14,22,0.217,0.304,0.478,17.692,68,python
0,23,21,3,47,0.489,26,0.553,2,1,0.667,1,2,27,20,10,14,23,0.213,0.298,0.489,17.694,69,python
0,18,21,4,43,0.419,22,0.512,4,2,0.667,1,3,28,15,10,16,17,0.233,0.372,0.395,17.699,70,python
0,20,24,3,47,0.426,23,0.489,2,2,0.5,2,1,29,18,9,15,23,0.191,0.319,0.489,17.7,71,python
0,21,20,4,45,0.467,25,0.556,2,4,0.333,2,4,31,14,9,15,21,0.2,0.333,0.467,17.702,72,python
0,21,23,1,45,0.467,22,0.489,2,2,0.5,1,2,28,17,10,13,22,0.222,0.289,0.489,17.695,73,python
0,19,24,2,45,0.422,21,0.467,3,1,0.75,2,2,28,17,11,14,20,0.244,0.311,0.444,17.695,74,python
0,22,20,4,46,0.478,26,0.565,2,3,0.4,4,1,30,16,7,17,22,0.152,0.37,0.478,17.685,75,python
0,17,26,3,46,0.37,20,0.435,3,2,0.6,3,1,29,17,8,18,20,0.174,0.391,0.435,17.681,76,python
0,20,23,4,47,0.426,24,0.511,5,5,0.5,2,4,35,12,12,13,22,0.255,0.277,0.468,17.683,77,python
0,20,23,1,44,0.455,21,0.477,3,2,0.6,1,4,29,15,12,15,17,0.273,0.341,0.386,17.679,78,python
0,15,21,7,43,0.349,22,0.512,3,3,0.5,1,1,26,17,9,17,17,0.209,0.395,0.395,17.687,79,python
0,18,20,6,44,0.409,24,0.545,6,0,1.0,0,2,27,17,8,17,19,0.182,0.386,0.432,17.687,80,python
0,22,19,5,46,0.478,27,0.587,3,2,0.6,3,2,24,22,9,17,20,0.196,0.37,0.435,17.684,81,python
0,20,22,2,44,0.455,22,0.5,4,3,0.571,4,1,28,16,13,12,19,0.295,0.273,0.432,17.683,82,python
0,22,19,4,45,0.489,26,0.578,4,2,0.667,0,3,24,21,18,14,13,0.4,0.311,0.289,17.687,83,python
0,18,23,3,44,0.409,21,0.477,1,4,0.2,2,2,29,15,10,12,22,0.227,0.273,0.5,17.68,84,python
0,18,23,3,44,0.409,21,0.477,1,4,0.2,0,3,25,19,13,12,19,0.295,0.273,0.432,17.672,85,python
0,29,16,4,49,0.592,33,0.673,7,2,0.778,2,3,27,22,18,15,16,0.367,0.306,0.327,17.675,86,python
0,14,26,7,47,0.298,21,0.447,4,3,0.571,4,3,31,16,8,15,24,0.17,0.319,0.511,17.676,87,python
0,23,21,4,48,0.479,27,0.562,2,0,1.0,2,3,23,25,15,16,17,0.312,0.333,0.354,17.672,88,python
0,20,21,3,44,0.455,23,0.523,3,1,0.75,2,1,23,21,12,15,17,0.273,0.341,0.386,17.671,89,python
0,15,25,4,44,0.341,19,0.432,4,5,0.444,1,1,19,25,9,19,16,0.205,0.432,0.364,17.675,90,python
0,23,23,0,46,0.5,23,0.5,2,2,0.5,3,3,29,17,8,17,21,0.174,0.37,0.457,17.667,91,python
0,18,21,4,43,0.419,22,0.512,1,5,0.167,0,1,27,16,12,12,19,0.279,0.279,0.442,17.677,92,python
0,26,13,6,45,0.578,32,0.711,4,2,0.667,3,1,25,20,15,9,21,0.333,0.2,0.467,17.674,93,python
0,20,24,2,46,0.435,22,0.478,4,4,0.5,1,0,30,16,11,13,22,0.239,0.283,0.478,17.676,94,python
0,19,23,4,46,0.413,23,0.5,4,2,0.667,3,2,25,21,10,18,18,0.217,0.391,0.391,17.673,95,python
0,16,25,3,44,0.364,19,0.432,3,1,0.75,1,1,24,20,12,12,20,0.273,0.273,0.455,17.663,96,python
0,23,16,4,43,0.535,27,0.628,4,1,0.8,2,2,30,13,12,8,23,0.279,0.186,0.535,17.704,1,python
0,22,20,2,44,0.5,24,0.545,0,4,0.0,2,1,23,21,12,10,22,0.273,0.227,0.5,17.755,2,python
0,19,20,5,44,0.432,24,0.545,3,3,0.5,2,0,23,21,10,14,20,0.227,0.318,0.455,17.75,3,python
0,19,26,4,49,0.388,23,0.469,0,2,0.0,1,3,34,15,14,15,20,0.286,0.306,0.408,17.565,4,python
0,17,22,3,42,0.405,20,0.476,6,2,0.75,0,0,24,18,12,15,15,0.286,0.357,0.357,17.657,5,python
0,24,21,3,48,0.5,27,0.562,8,1,0.889,3,2,24,24,13,13,22,0.271,0.271,0.458,17.539,6,python
0,24,19,5,48,0.5,29,0.604,4,2,0.667,1,5,27,21,17,14,17,0.354,0.292,0.354,17.603,7,python
0,20,22,5,47,0.426,25,0.532,3,0,1.0,4,3,31,16,10,12,25,0.213,0.255,0.532,17.443,8,python
0,16,26,3,45,0.356,19,0.422,1,4,0.2,4,2,27,18,7,15,23,0.156,0.333,0.511,17.472,9,python
0,16,25,4,45,0.356,20,0.444,4,2,0.667,2,1,22,23,8,15,22,0.178,0.333,0.489,17.446,10,python
0,21,19,5,45,0.467,26,0.578,6,3,0.667,2,2,32,13,10,12,23,0.222,0.267,0.511,17.475,11,python
0,16,24,4,44,0.364,20,0.455,2,1,0.667,0,2,25,19,9,16,19,0.205,0.364,0.432,17.57,12,python
0,25,14,5,44,0.568,30,0.682,6,3,0.667,1,1,27,17,17,10,17,0.386,0.227,0.386,17.626,13,python
0,18,23,6,47,0.383,24,0.511,2,2,0.5,4,4,30,17,7,12,28,0.149,0.255,0.596,17.633,14,python
0,20,22,3,45,0.444,23,0.511,4,1,0.8,3,4,28,17,11,10,24,0.244,0.222,0.533,17.612,15,python
0,19,23,5,47,0.404,24,0.511,5,2,0.714,0,2,27,20,11,14,22,0.234,0.298,0.468,17.606,16,python
0,20,20,5,45,0.444,25,0.556,1,6,0.143,1,2,27,18,8,17,20,0.178,0.378,0.444,17.639,17,python
0,27,17,0,44,0.614,27,0.614,2,3,0.4,4,1,27,17,12,9,23,0.273,0.205,0.523,17.572,18,python
0,16,23,3,42,0.381,19,0.452,2,2,0.5,2,0,33,9,8,14,20,0.19,0.333,0.476,17.593,19,python
0,20,21,5,46,0.435,25,0.543,1,3,0.25,2,0,26,20,7,16,23,0.152,0.348,0.5,17.615,20,python
0,14,30,3,47,0.298,17,0.362,0,5,0.0,2,2,31,16,5,20,22,0.106,0.426,0.468,17.601,21,python
0,15,25,2,42,0.357,17,0.405,2,3,0.4,2,1,26,16,10,16,16,0.238,0.381,0.381,17.629,22,python
0,19,21,6,46,0.413,25,0.543,4,3,0.571,2,1,26,20,10,21,15,0.217,0.457,0.326,17.636,23,python
0,25,17,4,46,0.543,29,0.63,0,3,0.0,4,2,18,28,14,20,12,0.304,0.435,0.261,17.643,24,python
0,17,26,2,45,0.378,19,0.422,1,3,0.25,4,2,30,15,8,15,22,0.178,0.333,0.489,17.606,25,python
0,18,25,1,44,0.409,19,0.432,5,1,0.833,1,0,32,12,11,15,18,0.25,0.341,0.409,17.6,26,python
0,23,18,3,44,0.523,26,0.591,4,0,1.0,0,1,26,18,18,10,16,0.409,0.227,0.364,17.597,27,python
0,22,21,3,46,0.478,25,0.543,5,0,1.0,0,4,26,20,11,15,20,0.239,0.326,0.435,17.605,28,python
0,22,19,3,44,0.5,25,0.568,2,2,0.5,3,1,25,19,12,11,21,0.273,0.25,0.477,17.571,29,python
0,20,23,3,46,0.435,23,0.5,3,4,0.429,4,0,25,21,8,17,21,0.174,0.37,0.457,17.515,30,python
0,16,28,5,49,0.327,21,0.429,0,2,0.0,4,3,31,18,7,14,28,0.143,0.286,0.571,17.502,31,python
0,17,25,2,44,0.386,19,0.432,2,2,0.5,1,2,25,19,14,12,18,0.318,0.273,0.409,17.492,32,python
0,18,23,4,45,0.4,22,0.489,4,2,0.667,3,1,24,21,9,15,21,0.2,0.333,0.467,17.505,33,python
0,15,26,6,47,0.319,21,0.447,1,1,0.5,0,4,30,17,8,17,22,0.17,0.362,0.468,17.511,34,python
0,19,24,6,49,0.388,25,0.51,4,2,0.667,2,3,27,22,9,21,19,0.184,0.429,0.388,17.508,35,python
0,18,22,5,45,0.4,23,0.511,2,2,0.5,4,1,28,17,8,12,25,0.178,0.267,0.556,17.502,36,python
0,19,24,4,47,0.404,23,0.489,2,1,0.667,3,2,32,15,8,12,27,0.17,0.255,0.574,17.52,37,python
0,25,21,3,49,0.51,28,0.571,2,2,0.5,1,2,27,22,14,15,20,0.286,0.306,0.408,17.525,38,python
0,13,29,2,44,0.295,15,0.341,1,2,0.333,1,2,27,17,8,15,21,0.182,0.341,0.477,17.529,39,python
0,21,19,4,44,0.477,25,0.568,2,2,0.5,1,2,28,16,12,14,18,0.273,0.318,0.409,17.531,40,python
0,17,20,9,46,0.37,26,0.565,2,0,1.0,1,2,26,20,9,16,21,0.196,0.348,0.457,17.558,41,python
0,23,20,3,46,0.5,26,0.565,2,0,1.0,6,1,26,20,14,13,19,0.304,0.283,0.413,17.567,42,python
0,21,20,6,47,0.447,27,0.574,0,0,0,3,2,31,16,13,15,19,0.277,0.319,0.404,17.556,43,python
0,21,15,10,46,0.457,31,0.674,3,2,0.6,3,2,32,14,12,13,21,0.261,0.283,0.457,17.556,44,python
0,22,18,4,44,0.5,26,0.591,5,1,0.833,1,3,29,15,13,12,19,0.295,0.273,0.432,17.562,45,python
0,16,25,5,46,0.348,21,0.457,1,5,0.167,0,1,26,20,10,20,16,0.217,0.435,0.348,17.566,46,python
0,17,24,1,42,0.405,18,0.429,5,1,0.833,0,0,26,16,10,12,20,0.238,0.286,0.476,17.576,47,python
0,17,24,4,45,0.378,21,0.467,1,0,1.0,1,3,26,19,9,17,19,0.2,0.378,0.422,17.572,48,python
0,16,26,3,45,0.356,19,0.422,2,5,0.286,2,1,30,15,6,17,22,0.133,0.378,0.489,17.585,49,python
0,18,21,3,42,0.429,21,0.5,3,4,0.429,1,1,27,15,12,8,22,0.286,0.19,0.524,17.569,50,python
0,20,21,5,46,0.435,25,0.543,4,1,0.8,4,2,26,20,9,13,24,0.196,0.283,0.522,17.573,51,python
0,25,17,3,45,0.556,28,0.622,1,1,0.5,1,0,21,24,18,14,13,0.4,0.311,0.289,17.576,52,python
0,21,20,3,44,0.477,24,0.545,3,2,0.6,1,1,32,12,13,12,19,0.295,0.273,0.432,17.581,53,python
0,19,18,7,44,0.432,26,0.591,1,5,0.167,2,0,31,13,12,14,18,0.273,0.318,0.409,17.59,54,python
0,22,22,2,46,0.478,24,0.522,6,2,0.75,4,2,31,15,8,17,21,0.174,0.37,0.457,17.588,55,python
0,17,22,6,45,0.378,23,0.511,0,2,0.0,2,1,27,18,10,19,16,0.222,0.422,0.356,17.593,56,python
0,19,19,7,45,0.422,26,0.578,2,1,0.667,1,4,26,19,14,14,17,0.311,0.311,0.378,17.593,57,python
0,21,24,3,48,0.438,24,0.5,3,3,0.5,5,1,30,18,11,12,25,0.229,0.25,0.521,17.571,58,python
0,18,22,5,45,0.4,23,0.511,3,2,0.6,1,4,26,19,12,15,18,0.267,0.333,0.4,17.571,59,python
0,16,24,4,44,0.364,20,0.455,1,1,0.5,1,1,26,18,9,16,19,0.205,0.364,0.432,17.572,60,python
0,20,21,3,44,0.455,23,0.523,2,1,0.667,0,2,30,14,14,13,17,0.318,0.295,0.386,17.582,61,python
0,15,25,4,44,0.341,19,0.432,3,3,0.5,1,2,26,18,9,12,23,0.205,0.273,0.523,17.581,62,python
0,25,16,5,46,0.543,30,0.652,2,3,0.4,3,2,25,21,12,12,22,0.261,0.261,0.478,17.582,63,python
0,13,26,6,45,0.289,19,0.422,0,2,0.0,2,3,29,16,5,19,21,0.111,0.422,0.467,17.587,64,python
0,27,13,3,43,0.628,30,0.698,4,0,1.0,2,0,20,23,18,12,13,0.419,0.279,0.302,17.581,65,python
0,25,16,6,47,0.532,31,0.66,4,1,0.8,2,0,33,14,11,16,20,0.234,0.34,0.426,17.592,66,python
0,19,24,4,47,0.404,23,0.489,1,2,0.333,1,2,29,18,12,12,23,0.255,0.255,0.489,17.591,67,python
0,14,27,4,45,0.311,18,0.4,0,4,0.0,1,2,29,16,8,17,20,0.178,0.378,0.444,17.602,68,python
0,21,22,1,44,0.477,22,0.5,7,1,0.875,0,2,27,17,14,11,19,0.318,0.25,0.432,17.607,69,python
0,27,19,1,47,0.574,28,0.596,5,3,0.625,2,2,30,17,13,8,26,0.277,0.17,0.553,17.611,70,python
0,20,23,3,46,0.435,23,0.5,2,2,0.5,6,4,35,11,10,8,28,0.217,0.174,0.609,17.604,71,python
0,14,27,5,46,0.304,19,0.413,2,1,0.667,2,3,25,21,7,22,17,0.152,0.478,0.37,17.603,72,python
0,25,21,1,47,0.532,26,0.553,3,3,0.5,3,2,31,16,8,13,26,0.17,0.277,0.553,17.606,73,python
0,17,23,5,45,0.378,22,0.489,3,4,0.429,0,1,23,22,14,15,16,0.311,0.333,0.356,17.607,74,python
0,26,21,1,48,0.542,27,0.562,2,4,0.333,1,3,24,24,15,17,16,0.312,0.354,0.333,17.613,75,python
0,16,26,4,46,0.348,20,0.435,3,2,0.6,2,4,26,20,9,18,19,0.196,0.391,0.413,17.603,76,python
0,22,20,3,45,0.489,25,0.556,3,2,0.6,1,2,23,22,12,16,17,0.267,0.356,0.378,17.609,77,python
0,25,13,6,44,0.568,31,0.705,3,2,0.6,0,0,25,19,12,22,10,0.273,0.5,0.227,17.62,78,python
0,16,21,7,44,0.364,23,0.523,3,1,0.75,1,1,36,8,6,12,26,0.136,0.273,0.591,17.622,79,python
0,17,22,6,45,0.378,23,0.511,1,1,0.5,2,2,31,14,6,19,20,0.133,0.422,0.444,17.627,80,python
0,25,16,6,47,0.532,31,0.66,4,5,0.444,4,1,25,22,10,20,17,0.213,0.426,0.362,17.629,81,python
0,17,24,4,45,0.378,21,0.467,2,3,0.4,2,0,31,14,9,15,21,0.2,0.333,0.467,17.626,82,python
0,21,24,3,48,0.438,24,0.5,2,1,0.667,2,3,28,20,8,15,25,0.167,0.312,0.521,17.619,83,python
0,19,22,3,44,0.432,22,0.5,4,1,0.8,1,0,27,17,12,12,20,0.273,0.273,0.455,17.623,84,python
0,19,24,2,45,0.422,21,0.467,2,2,0.5,1,3,34,11,10,12,23,0.222,0.267,0.511,17.623,85,python
0,13,25,6,44,0.295,19,0.432,1,0,1.0,2,1,29,15,6,19,19,0.136,0.432,0.432,17.625,86,python
0,16,26,7,49,0.327,23,0.469,4,3,0.571,3,3,26,23,8,22,19,0.163,0.449,0.388,17.628,87,python
0,15,26,3,44,0.341,18,0.409,1,2,0.333,1,0,34,10,4,15,25,0.091,0.341,0.568,17.62,88,python
0,25,17,4,46,0.543,29,0.63,3,4,0.429,2,3,23,23,12,17,17,0.261,0.37,0.37,17.621,89,python
0,17,21,6,44,0.386,23,0.523,3,2,0.6,2,3,26,18,8,17,19,0.182,0.386,0.432,17.619,90,python
0,18,28,0,46,0.391,18,0.391,4,3,0.571,3,3,31,15,9,13,24,0.196,0.283,0.522,17.614,91,python
0,19,22,5,46,0.413,24,0.522,2,3,0.4,2,5,31,15,9,11,26,0.196,0.239,0.565,17.61,92,python
0,17,24,5,46,0.37,22,0.478,2,2,0.5,4,3,36,10,5,12,29,0.109,0.261,0.63,17.604,93,python
0,17,23,4,44,0.386,21,0.477,1,4,0.2,2,2,24,20,10,15,19,0.227,0.341,0.432,17.608,94,python
0,21,22,5,48,0.438,26,0.542,3,2,0.6,3,1,29,19,7,18,23,0.146,0.375,0.479,17.606,95,python
0,20,16,6,42,0.476,26,0.619,2,3,0.4,1,2,24,18,15,14,13,0.357,0.333,0.31,17.614,96,python
0,24,21,2,47,0.511,26,0.553,4,1,0.8,6,2,28,19,13,9,25,0.277,0.191,0.532,17.0,1,python
0,15,24,5,44,0.341,20,0.455,4,3,0.571,3,2,24,20,5,19,20,0.114,0.432,0.455,17.365,2,python
0,20,20,4,44,0.455,24,0.545,2,1,0.667,2,1,29,15,12,12,20,0.273,0.273,0.455,17.413,3,python
0,18,28,3,49,0.367,21,0.429,1,2,0.333,0,2,34,15,8,12,29,0.163,0.245,0.592,17.414,4,python
0,25,13,5,43,0.581,30,0.698,2,2,0.5,1,0,28,15,17,15,11,0.395,0.349,0.256,17.493,5,python
0,21,19,5,45,0.467,26,0.578,3,2,0.6,0,3,26,19,11,11,23,0.244,0.244,0.511,17.629,6,python
0,25,20,3,48,0.521,28,0.583,6,2,0.75,4,2,28,20,9,14,25,0.188,0.292,0.521,17.451,7,python
0,19,24,5,48,0.396,24,0.5,3,4,0.429,4,0,32,16,7,21,20,0.146,0.438,0.417,17.463,8,python
0,23,21,0,44,0.523,23,0.523,3,2,0.6,5,1,26,18,14,13,17,0.318,0.295,0.386,17.513,9,python
0,20,22,5,47,0.426,25,0.532,2,4,0.333,2,1,29,18,13,12,22,0.277,0.255,0.468,17.521,10,python
0,22,21,4,47,0.468,26,0.553,4,5,0.444,3,2,25,22,14,14,19,0.298,0.298,0.404,17.544,11,python
0,25,18,3,46,0.543,28,0.609,1,2,0.333,4,0,24,22,9,16,21,0.196,0.348,0.457,17.54,12,python
0,24,15,4,43,0.558,28,0.651,1,0,1.0,2,2,24,19,17,8,18,0.395,0.186,0.419,17.5,13,python
0,19,23,6,48,0.396,25,0.521,4,0,1.0,1,6,26,22,10,15,23,0.208,0.312,0.479,17.519,14,python
0,19,20,5,44,0.432,24,0.545,5,1,0.833,2,3,25,19,15,13,16,0.341,0.295,0.364,17.489,15,python
0,24,20,2,46,0.522,26,0.565,5,3,0.625,1,2,31,15,12,15,19,0.261,0.326,0.413,17.549,16,python
0,17,24,5,46,0.37,22,0.478,4,0,1.0,4,0,25,21,11,15,20,0.239,0.326,0.435,17.548,17,python
0,20,19,7,46,0.435,27,0.587,4,6,0.4,2,0,26,20,15,10,21,0.326,0.217,0.457,17.574,18,python
0,18,22,6,46,0.391,24,0.522,3,0,1.0,2,3,31,15,10,14,22,0.217,0.304,0.478,17.612,19,python
0,21,23,2,46,0.457,23,0.5,4,1,0.8,3,1,26,20,9,18,19,0.196,0.391,0.413,17.609,20,python
0,22,20,4,46,0.478,26,0.565,5,3,0.625,3,1,29,17,13,14,19,0.283,0.304,0.413,17.638,21,python
0,17,22,8,47,0.362,25,0.532,3,1,0.75,2,1,31,16,12,12,23,0.255,0.255,0.489,17.621,22,python
0,24,19,3,46,0.522,27,0.587,1,3,0.25,3,2,25,21,14,19,13,0.304,0.413,0.283,17.638,23,python
0,18,23,4,45,0.4,22,0.489,4,1,0.8,0,2,25,20,15,13,17,0.333,0.289,0.378,17.648,24,python
0,19,24,0,43,0.442,19,0.442,3,5,0.375,2,3,27,16,14,12,17,0.326,0.279,0.395,17.663,25,python
0,21,24,2,47,0.447,23,0.489,1,0,1.0,4,1,31,16,9,14,24,0.191,0.298,0.511,17.635,26,python
0,24,25,3,52,0.462,27,0.519,4,3,0.571,2,2,37,15,12,18,22,0.231,0.346,0.423,17.643,27,python
0,26,18,3,47,0.553,29,0.617,1,3,0.25,3,0,28,19,15,14,18,0.319,0.298,0.383,17.641,28,python
0,21,20,5,46,0.457,26,0.565,4,3,0.571,1,2,25,21,12,17,17,0.261,0.37,0.37,17.661,29,python
0,25,19,4,48,0.521,29,0.604,4,1,0.8,4,3,27,21,15,8,25,0.312,0.167,0.521,17.639,30,python
0,17,25,2,44,0.386,19,0.432,4,3,0.571,3,1,28,16,7,15,22,0.159,0.341,0.5,17.63,31,python
0,23,20,4,47,0.489,27,0.574,4,5,0.444,4,0,23,24,11,17,19,0.234,0.362,0.404,17.622,32,python
0,23,21,1,45,0.511,24,0.533,1,1,0.5,2,3,26,19,12,9,24,0.267,0.2,0.533,17.622,33,python
0,23,17,3,43,0.535,26,0.605,5,1,0.833,1,3,24,19,18,12,13,0.419,0.279,0.302,17.613,34,python
0,25,18,2,45,0.556,27,0.6,4,2,0.667,3,2,21,24,12,19,14,0.267,0.422,0.311,17.626,35,python
0,14,25,5,44,0.318,19,0.432,3,3,0.5,0,1,31,13,8,13,23,0.182,0.295,0.523,17.626,36,python
0,23,20,3,46,0.5,26,0.565,3,1,0.75,2,3,28,18,9,14,23,0.196,0.304,0.5,17.628,37,python
0,16,25,5,46,0.348,21,0.457,1,2,0.333,1,3,29,17,11,15,20,0.239,0.326,0.435,17.624,38,python
0,17,26,4,47,0.362,21,0.447,1,2,0.333,0,3,34,13,12,14,21,0.255,0.298,0.447,17.634,39,python
0,26,17,1,44,0.591,27,0.614,7,0,1.0,1,2,27,17,13,12,19,0.295,0.273,0.432,17.639,40,python
0,18,25,4,47,0.383,22,0.468,6,2,0.75,3,2,29,18,9,13,25,0.191,0.277,0.532,17.654,41,python
0,20,18,9,47,0.426,29,0.617,3,3,0.5,2,1,31,16,11,13,23,0.234,0.277,0.489,17.64,42,python
0,22,19,3,44,0.5,25,0.568,2,4,0.333,5,0,26,18,10,16,18,0.227,0.364,0.409,17.661,43,python
0,20,21,3,44,0.455,23,0.523,4,2,0.667,2,1,27,17,11,17,16,0.25,0.386,0.364,17.674,44,python
0,21,21,4,46,0.457,25,0.543,3,2,0.6,2,0,26,20,12,18,16,0.261,0.391,0.348,17.685,45,python
0,18,22,4,44,0.409,22,0.5,2,1,0.667,1,1,32,12,10,18,16,0.227,0.409,0.364,17.686,46,python
0,21,19,5,45,0.467,26,0.578,3,0,1.0,3,5,32,13,10,12,23,0.222,0.267,0.511,17.698,47,python
0,25,17,7,49,0.51,32,0.653,2,1,0.667,3,3,34,15,15,10,24,0.306,0.204,0.49,17.702,48,python
0,17,27,1,45,0.378,18,0.4,1,0,1.0,2,1,24,21,10,15,20,0.222,0.333,0.444,17.684,49,python
0,20,21,3,44,0.455,23,0.523,4,0,1.0,3,3,25,19,12,12,20,0.273,0.273,0.455,17.681,50,python
0,23,24,1,48,0.479,24,0.5,3,1,0.75,1,2,27,21,15,11,22,0.312,0.229,0.458,17.67,51,python
0,18,22,4,44,0.409,22,0.5,4,3,0.571,1,1,30,14,12,14,18,0.273,0.318,0.409,17.673,52,python
0,21,19,5,45,0.467,26,0.578,4,0,1.0,1,2,22,23,11,18,16,0.244,0.4,0.356,17.679,53,python
0,23,17,6,46,0.5,29,0.63,2,0,1.0,3,1,30,16,11,16,19,0.239,0.348,0.413,17.681,54,python
0,19,23,6,48,0.396,25,0.521,1,1,0.5,4,2,30,18,9,19,20,0.188,0.396,0.417,17.678,55,python
0,17,23,3,43,0.395,20,0.465,3,0,1.0,1,0,24,19,12,21,10,0.279,0.488,0.233,17.687,56,python
0,18,23,6,47,0.383,24,0.511,0,0,0,0,4,27,20,10,17,20,0.213,0.362,0.426,17.681,57,python
0,21,21,4,46,0.457,25,0.543,4,1,0.8,2,3,31,15,16,11,19,0.348,0.239,0.413,17.68,58,python
0,16,25,5,46,0.348,21,0.457,7,2,0.778,2,2,34,12,8,9,29,0.174,0.196,0.63,17.685,59,python
0,20,29,3,52,0.385,23,0.442,1,9,0.1,5,0,25,27,7,26,19,0.135,0.5,0.365,17.688,60,python
0,24,15,5,44,0.545,29,0.659,6,1,0.857,2,0,25,19,8,19,17,0.182,0.432,0.386,17.696,61,python
0,19,25,1,45,0.422,20,0.444,4,2,0.667,2,1,27,18,14,15,16,0.311,0.333,0.356,17.69,62,python
0,18,20,6,44,0.409,24,0.545,5,2,0.714,1,1,26,18,12,16,16,0.273,0.364,0.364,17.698,63,python
0,22,20,4,46,0.478,26,0.565,1,3,0.25,2,1,27,19,8,14,24,0.174,0.304,0.522,17.704,64,python
0,23,16,5,44,0.523,28,0.636,2,3,0.4,3,4,28,16,11,12,21,0.25,0.273,0.477,17.705,65,python
0,23,21,3,47,0.489,26,0.553,4,1,0.8,2,3,32,15,9,14,24,0.191,0.298,0.511,17.707,66,python
0,14,28,3,45,0.311,17,0.378,2,1,0.667,2,4,31,14,8,10,27,0.178,0.222,0.6,17.695,67,python
0,19,23,4,46,0.413,23,0.5,0,2,0.0,1,4,30,16,13,18,15,0.283,0.391,0.326,17.699,68,python
0,19,25,3,47,0.404,22,0.468,3,1,0.75,3,4,29,18,8,12,27,0.17,0.255,0.574,17.69,69,python
0,16,25,3,44,0.364,19,0.432,5,5,0.5,3,1,29,15,8,11,25,0.182,0.25,0.568,17.692,70,python
0,23,20,3,46,0.5,26,0.565,1,0,1.0,5,2,26,20,8,12,26,0.174,0.261,0.565,17.675,71,python
0,24,23,1,48,0.5,25,0.521,5,2,0.714,1,4,26,22,15,14,19,0.312,0.292,0.396,17.671,72,python
0,23,23,3,49,0.469,26,0.531,1,0,1.0,6,2,24,25,12,13,24,0.245,0.265,0.49,17.66,73,python
0,18,24,3,45,0.4,21,0.467,2,2,0.5,2,0,24,21,11,12,22,0.244,0.267,0.489,17.658,74,python
0,27,18,3,48,0.562,30,0.625,2,2,0.5,5,1,30,18,11,16,21,0.229,0.333,0.438,17.656,75,python
0,19,22,4,45,0.422,23,0.511,2,0,1.0,2,1,27,18,10,11,24,0.222,0.244,0.533,17.646,76,python
0,19,23,3,45,0.422,22,0.489,2,3,0.4,2,4,29,16,9,14,22,0.2,0.311,0.489,17.645,77,python
0,13,27,4,44,0.295,17,0.386,2,3,0.4,1,2,31,13,6,14,24,0.136,0.318,0.545,17.644,78,python
0,18,26,5,49,0.367,23,0.469,2,3,0.4,2,3,28,21,9,22,18,0.184,0.449,0.367,17.649,79,python
0,20,20,5,45,0.444,25,0.556,1,3,0.25,2,1,27,18,11,15,19,0.244,0.333,0.422,17.641,80,python
0,21,20,4,45,0.467,25,0.556,5,4,0.556,1,3,32,13,10,13,22,0.222,0.289,0.489,17.647,81,python
0,19,21,5,45,0.422,24,0.533,3,3,0.5,1,3,27,18,12,12,21,0.267,0.267,0.467,17.647,82,python
0,16,26,2,44,0.364,18,0.409,1,4,0.2,0,2,30,14,9,12,23,0.205,0.273,0.523,17.651,83,python
0,19,22,5,46,0.413,24,0.522,1,0,1.0,2,5,31,15,10,16,20,0.217,0.348,0.435,17.651,84,python
0,23,19,3,45,0.511,26,0.578,5,1,0.833,2,5,27,18,10,12,23,0.222,0.267,0.511,17.65,85,python
0,20,22,4,46,0.435,24,0.522,5,3,0.625,0,5,26,20,14,16,16,0.304,0.348,0.348,17.659,86,python
0,17,24,6,47,0.362,23,0.489,3,1,0.75,2,5,31,16,7,13,27,0.149,0.277,0.574,17.657,87,python
0,25,19,3,47,0.532,28,0.596,3,2,0.6,2,3,27,20,15,13,19,0.319,0.277,0.404,17.666,88,python
0,14,24,6,44,0.318,20,0.455,3,3,0.5,0,2,26,18,9,19,16,0.205,0.432,0.364,17.677,89,python
0,21,23,1,45,0.467,22,0.489,3,1,0.75,5,2,27,18,9,14,22,0.2,0.311,0.489,17.667,90,python
0,25,19,1,45,0.556,26,0.578,3,2,0.6,3,0,30,15,14,14,17,0.311,0.311,0.378,17.671,91,python
0,15,25,6,46,0.326,21,0.457,1,1,0.5,1,2,28,18,10,17,19,0.217,0.37,0.413,17.676,92,python
0,19,24,1,44,0.432,20,0.455,2,1,0.667,0,1,25,19,12,16,16,0.273,0.364,0.364,17.668,93,python
0,18,25,2,45,0.4,20,0.444,2,4,0.333,2,3,33,12,10,13,22,0.222,0.289,0.489,17.671,94,python
0,18,22,5,45,0.4,23,0.511,3,2,0.6,1,2,28,17,13,11,21,0.289,0.244,0.467,17.674,95,python
0,21,20,3,44,0.477,24,0.545,1,5,0.167,1,2,28,16,15,8,21,0.341,0.182,0.477,17.678,96,python
0,14,26,3,43,0.326,17,0.395,1,3,0.25,1,2,27,16,7,15,21,0.163,0.349,0.488,18.031,1,python
0,24,16,6,46,0.522,30,0.652,2,0,1.0,2,1,26,20,11,16,19,0.239,0.348,0.413,17.781,2,python
0,16,25,2,43,0.372,18,0.419,3,2,0.6,1,4,26,17,10,14,19,0.233,0.326,0.442,17.769,3,python
0,21,17,6,44,0.477,27,0.614,3,2,0.6,2,2,30,14,12,11,21,0.273,0.25,0.477,17.858,4,python
0,22,18,5,45,0.489,27,0.6,3,1,0.75,2,4,28,17,13,14,18,0.289,0.311,0.4,17.819,5,python
0,20,26,3,49,0.408,23,0.469,3,2,0.6,2,2,33,16,12,15,22,0.245,0.306,0.449,17.856,6,python
0,20,19,6,45,0.444,26,0.578,4,1,0.8,4,0,25,20,9,19,17,0.2,0.422,0.378,17.868,7,python
0,17,21,8,46,0.37,25,0.543,2,3,0.4,0,3,26,20,11,16,19,0.239,0.348,0.413,17.935,8,python
0,20,23,3,46,0.435,23,0.5,3,4,0.429,3,3,26,20,10,21,15,0.217,0.457,0.326,17.929,9,python
0,19,24,3,46,0.413,22,0.478,4,5,0.444,4,2,27,19,10,14,22,0.217,0.304,0.478,17.915,10,python
0,22,11,13,46,0.478,35,0.761,1,2,0.333,0,0,27,19,13,17,16,0.283,0.37,0.348,17.916,11,python
0,21,15,8,44,0.477,29,0.659,4,2,0.667,2,2,28,16,12,11,21,0.273,0.25,0.477,17.878,12,python
0,21,19,5,45,0.467,26,0.578,2,3,0.4,3,0,23,22,10,17,18,0.222,0.378,0.4,17.85,13,python
0,24,19,2,45,0.533,26,0.578,4,0,1.0,1,2,30,15,7,17,21,0.156,0.378,0.467,17.85,14,python
0,20,22,3,45,0.444,23,0.511,5,3,0.625,2,4,25,20,9,14,22,0.2,0.311,0.489,17.883,15,python
0,25,20,3,48,0.521,28,0.583,4,3,0.571,2,2,27,21,16,17,15,0.333,0.354,0.312,17.881,16,python
0,25,18,3,46,0.543,28,0.609,3,1,0.75,3,3,26,20,14,11,21,0.304,0.239,0.457,17.818,17,python
0,15,26,3,44,0.341,18,0.409,3,4,0.429,0,4,27,17,11,12,21,0.25,0.273,0.477,17.815,18,python
0,22,18,5,45,0.489,27,0.6,6,2,0.75,3,3,27,18,9,13,23,0.2,0.289,0.511,17.817,19,python
0,25,18,3,46,0.543,28,0.609,1,3,0.25,5,2,26,20,15,10,21,0.326,0.217,0.457,17.807,20,python
0,16,26,2,44,0.364,18,0.409,2,0,1.0,1,0,22,22,9,17,18,0.205,0.386,0.409,17.814,21,python
0,23,19,3,45,0.511,26,0.578,3,2,0.6,0,2,32,13,13,7,25,0.289,0.156,0.556,17.83,22,python
0,23,24,3,50,0.46,26,0.52,2,3,0.4,0,2,20,30,17,22,11,0.34,0.44,0.22,17.832,23,python
0,17,22,7,46,0.37,24,0.522,4,1,0.8,1,1,30,16,8,15,23,0.174,0.326,0.5,17.808,24,python
0,17,28,1,46,0.37,18,0.391,2,3,0.4,2,3,27,19,10,14,22,0.217,0.304,0.478,17.787,25,python
0,17,26,5,48,0.354,22,0.458,3,5,0.375,3,5,38,10,9,14,25,0.188,0.292,0.521,17.783,26,python
0,24,19,2,45,0.533,26,0.578,6,2,0.75,3,2,26,19,15,10,20,0.333,0.222,0.444,17.768,27,python
0,21,26,2,49,0.429,23,0.469,2,8,0.2,1,1,26,23,14,18,17,0.286,0.367,0.347,17.786,28,python
0,23,22,3,48,0.479,26,0.542,0,5,0.0,3,1,29,19,15,14,19,0.312,0.292,0.396,17.791,29,python
0,21,19,4,44,0.477,25,0.568,4,2,0.667,1,0,26,18,13,13,18,0.295,0.295,0.409,17.826,30,python
0,17,23,5,45,0.378,22,0.489,2,1,0.667,0,2,28,17,7,18,20,0.156,0.4,0.444,17.831,31,python
0,18,21,7,46,0.391,25,0.543,3,0,1.0,2,5,27,19,7,20,19,0.152,0.435,0.413,17.839,32,python
0,20,24,5,49,0.408,25,0.51,2,1,0.667,3,5,32,17,8,16,25,0.163,0.327,0.51,17.834,33,python
0,25,19,3,47,0.532,28,0.596,1,0,1.0,1,5,25,22,15,12,20,0.319,0.255,0.426,17.823,34,python
0,20,22,3,45,0.444,23,0.511,4,0,1.0,2,6,31,14,9,10,26,0.2,0.222,0.578,17.802,35,python
0,11,29,5,45,0.244,16,0.356,2,2,0.5,0,5,24,21,6,17,22,0.133,0.378,0.489,17.787,36,python
0,21,21,2,44,0.477,23,0.523,0,3,0.0,3,0,21,23,8,19,17,0.182,0.432,0.386,17.774,37,python
0,23,18,4,45,0.511,27,0.6,3,3,0.5,3,2,32,13,12,11,22,0.267,0.244,0.489,17.762,38,python
0,16,30,4,50,0.32,20,0.4,3,4,0.429,1,2,29,21,10,22,18,0.2,0.44,0.36,17.77,39,python
0,21,23,3,47,0.447,24,0.511,7,1,0.875,2,2,27,20,10,14,23,0.213,0.298,0.489,17.772,40,python
0,25,16,4,45,0.556,29,0.644,4,2,0.667,2,1,28,17,12,14,19,0.267,0.311,0.422,17.77,41,python
0,21,21,3,45,0.467,24,0.533,1,3,0.25,3,1,18,27,15,15,15,0.333,0.333,0.333,17.776,42,python
0,21,23,3,47,0.447,24,0.511,9,5,0.643,1,1,26,21,11,10,26,0.234,0.213,0.553,17.78,43,python
0,24,19,3,46,0.522,27,0.587,3,1,0.75,5,1,27,19,7,16,23,0.152,0.348,0.5,17.763,44,python
0,18,25,2,45,0.4,20,0.444,5,1,0.833,2,3,27,18,11,9,25,0.244,0.2,0.556,17.758,45,python
0,12,29,3,44,0.273,15,0.341,4,2,0.667,0,5,30,14,5,16,23,0.114,0.364,0.523,17.764,46,python
0,20,22,4,46,0.435,24,0.522,2,2,0.5,3,1,29,17,7,15,24,0.152,0.326,0.522,17.753,47,python
0,22,21,3,46,0.478,25,0.543,0,1,0.0,3,3,29,17,11,11,24,0.239,0.239,0.522,17.751,48,python
0,16,22,7,45,0.356,23,0.511,2,1,0.667,3,3,28,17,10,16,19,0.222,0.356,0.422,17.754,49,python
0,18,22,4,44,0.409,22,0.5,3,2,0.6,1,1,25,19,11,13,20,0.25,0.295,0.455,17.75,50,python
0,17,24,4,45,0.378,21,0.467,2,2,0.5,0,1,27,18,10,20,15,0.222,0.444,0.333,17.752,51,python
0,24,17,5,46,0.522,29,0.63,5,0,1.0,2,2,25,21,16,11,19,0.348,0.239,0.413,17.743,52,python
0,13,29,3,45,0.289,16,0.356,4,3,0.571,2,2,30,15,10,10,25,0.222,0.222,0.556,17.741,53,python
0,23,19,5,47,0.489,28,0.596,4,3,0.571,2,0,25,22,14,14,19,0.298,0.298,0.404,17.725,54,python
0,25,18,3,46,0.543,28,0.609,5,2,0.714,3,2,26,20,16,14,16,0.348,0.304,0.348,17.726,55,python
0,22,24,1,47,0.468,23,0.489,2,1,0.667,3,3,29,18,11,9,27,0.234,0.191,0.574,17.705,56,python
0,17,21,5,43,0.395,22,0.512,1,3,0.25,1,2,28,15,11,18,14,0.256,0.419,0.326,17.711,57,python
0,17,30,2,49,0.347,19,0.388,2,2,0.5,1,2,31,18,10,14,25,0.204,0.286,0.51,17.713,58,python
0,21,18,5,44,0.477,26,0.591,2,3,0.4,3,1,27,17,9,17,18,0.205,0.386,0.409,17.716,59,python
0,20,24,4,48,0.417,24,0.5,4,3,0.571,1,3,28,20,6,22,20,0.125,0.458,0.417,17.723,60,python
0,20,27,4,51,0.392,24,0.471,8,1,0.889,1,3,27,24,11,22,18,0.216,0.431,0.353,17.731,61,python
0,25,18,2,45,0.556,27,0.6,2,4,0.333,3,2,22,23,14,15,16,0.311,0.333,0.356,17.73,62,python
0,21,21,2,44,0.477,23,0.523,2,3,0.4,2,3,29,15,12,10,22,0.273,0.227,0.5,17.735,63,python
0,22,15,11,48,0.458,33,0.688,3,2,0.6,2,1,25,23,16,13,19,0.333,0.271,0.396,17.747,64,python
0,18,27,2,47,0.383,20,0.426,3,3,0.5,4,3,25,22,8,19,20,0.17,0.404,0.426,17.735,65,python
0,15,25,5,45,0.333,20,0.444,1,3,0.25,3,2,25,20,10,15,20,0.222,0.333,0.444,17.733,66,python
0,17,25,3,45,0.378,20,0.444,2,3,0.4,5,2,25,20,9,10,26,0.2,0.222,0.578,17.721,67,python
0,25,16,3,44,0.568,28,0.636,5,2,0.714,2,3,32,12,12,14,18,0.273,0.318,0.409,17.729,68,python
0,19,23,4,46,0.413,23,0.5,3,4,0.429,4,1,29,17,7,17,22,0.152,0.37,0.478,17.731,69,python
0,19,23,4,46,0.413,23,0.5,0,2,0.0,1,4,24,22,10,16,20,0.217,0.348,0.435,17.729,70,python
0,24,22,2,48,0.5,26,0.542,1,2,0.333,2,1,28,20,13,14,21,0.271,0.292,0.438,17.726,71,python
0,25,19,3,47,0.532,28,0.596,4,3,0.571,1,1,29,18,12,18,17,0.255,0.383,0.362,17.74,72,python
0,24,16,3,43,0.558,27,0.628,5,0,1.0,2,0,25,18,12,16,15,0.279,0.372,0.349,17.747,73,python
0,21,26,2,49,0.429,23,0.469,2,1,0.667,1,1,28,21,12,14,23,0.245,0.286,0.469,17.748,74,python
0,22,19,2,43,0.512,24,0.558,2,2,0.5,2,0,25,18,13,12,18,0.302,0.279,0.419,17.744,75,python
0,25,19,4,48,0.521,29,0.604,2,5,0.286,1,3,23,25,13,17,18,0.271,0.354,0.375,17.749,76,python
0,22,19,4,45,0.489,26,0.578,1,3,0.25,3,2,27,18,12,17,16,0.267,0.378,0.356,17.751,77,python
0,24,18,2,44,0.545,26,0.591,3,1,0.75,1,3,25,19,15,13,16,0.341,0.295,0.364,17.753,78,python
0,22,22,1,45,0.489,23,0.511,4,3,0.571,5,3,24,21,11,15,19,0.244,0.333,0.422,17.754,79,python
0,17,22,5,44,0.386,22,0.5,7,2,0.778,2,1,26,18,11,13,20,0.25,0.295,0.455,17.758,80,python
0,19,24,2,45,0.422,21,0.467,3,1,0.75,3,0,24,21,14,16,15,0.311,0.356,0.333,17.758,81,python
0,22,19,4,45,0.489,26,0.578,3,2,0.6,4,0,29,16,10,15,20,0.222,0.333,0.444,17.757,82,python
0,23,26,3,52,0.442,26,0.5,2,6,0.25,3,1,33,19,11,17,24,0.212,0.327,0.462,17.759,83,python
0,22,22,3,47,0.468,25,0.532,4,3,0.571,2,1,32,15,14,8,25,0.298,0.17,0.532,17.754,84,python
0,19,20,6,45,0.422,25,0.556,6,2,0.75,1,2,27,18,15,14,16,0.333,0.311,0.356,17.763,85,python
0,18,23,4,45,0.4,22,0.489,1,2,0.333,1,3,30,15,15,14,16,0.333,0.311,0.356,17.764,86,python
0,13,25,6,44,0.295,19,0.432,2,2,0.5,0,1,25,19,7,22,15,0.159,0.5,0.341,17.76,87,python
0,19,25,1,45,0.422,20,0.444,3,4,0.429,5,0,32,13,6,14,25,0.133,0.311,0.556,17.76,88,python
0,20,24,4,48,0.417,24,0.5,3,3,0.5,2,1,25,23,10,20,18,0.208,0.417,0.375,17.766,89,python
0,15,24,8,47,0.319,23,0.489,2,4,0.333,2,8,35,12,7,14,26,0.149,0.298,0.553,17.767,90,python
0,23,22,2,47,0.489,25,0.532,6,1,0.857,2,2,27,20,16,14,17,0.34,0.298,0.362,17.759,91,python
0,19,22,3,44,0.432,22,0.5,5,2,0.714,0,1,26,18,10,14,20,0.227,0.318,0.455,17.759,92,python
0,15,21,9,45,0.333,24,0.533,4,1,0.8,0,3,27,18,12,9,24,0.267,0.2,0.533,17.761,93,python
0,22,16,7,45,0.489,29,0.644,3,1,0.75,3,0,28,17,13,15,17,0.289,0.333,0.378,17.765,94,python
0,21,23,3,47,0.447,24,0.511,2,3,0.4,1,3,36,11,11,14,22,0.234,0.298,0.468,17.761,95,python
0,16,21,7,44,0.364,23,0.523,5,0,1.0,2,2,31,13,8,15,21,0.182,0.341,0.477,17.768,96,python
0,16,22,6,44,0.364,22,0.5,1,3,0.25,2,1,24,20,10,16,18,0.227,0.364,0.409,17.548,1,python
0,20,19,5,44,0.455,25,0.568,4,2,0.667,4,2,22,22,13,16,15,0.295,0.364,0.341,17.569,2,python
0,21,18,4,43,0.488,25,0.581,6,0,1.0,1,0,25,18,15,13,15,0.349,0.302,0.349,17.642,3,python
0,20,25,1,46,0.435,21,0.457,2,2,0.5,0,3,28,18,12,14,20,0.261,0.304,0.435,17.676,4,python
0,23,24,1,48,0.479,24,0.5,2,2,0.5,3,4,28,20,9,16,23,0.188,0.333,0.479,17.582,5,python
0,21,23,4,48,0.438,25,0.521,4,2,0.667,4,4,30,18,12,14,22,0.25,0.292,0.458,17.426,6,python
0,20,20,3,43,0.465,23,0.535,3,5,0.375,0,5,33,10,9,16,18,0.209,0.372,0.419,17.508,7,python
0,16,27,2,45,0.356,18,0.4,5,0,1.0,3,2,29,16,10,13,22,0.222,0.289,0.489,17.543,8,python
0,19,19,7,45,0.422,26,0.578,3,2,0.6,1,1,27,18,7,16,22,0.156,0.356,0.489,17.557,9,python
0,17,25,6,48,0.354,23,0.479,1,2,0.333,2,7,34,14,4,16,28,0.083,0.333,0.583,17.589,10,python
0,19,24,1,44,0.432,20,0.455,4,4,0.5,2,0,23,21,14,16,14,0.318,0.364,0.318,17.54,11,python
0,21,22,5,48,0.438,26,0.542,4,1,0.8,3,2,30,18,8,17,23,0.167,0.354,0.479,17.527,12,python
0,20,24,1,45,0.444,21,0.467,1,2,0.333,0,0,25,20,14,17,14,0.311,0.378,0.311,17.592,13,python
0,20,24,2,46,0.435,22,0.478,5,3,0.625,2,2,25,21,15,9,22,0.326,0.196,0.478,17.624,14,python
0,18,25,2,45,0.4,20,0.444,3,1,0.75,1,2,29,16,9,15,21,0.2,0.333,0.467,17.545,15,python
0,20,23,1,44,0.455,21,0.477,5,4,0.556,1,2,28,16,12,9,23,0.273,0.205,0.523,17.535,16,python
0,18,29,1,48,0.375,19,0.396,2,4,0.333,2,2,36,12,9,15,24,0.188,0.312,0.5,17.553,17,python
0,23,19,3,45,0.511,26,0.578,5,0,1.0,5,2,26,19,14,13,18,0.311,0.289,0.4,17.532,18,python
0,20,20,5,45,0.444,25,0.556,5,3,0.625,0,2,30,15,13,13,19,0.289,0.289,0.422,17.545,19,python
0,22,20,4,46,0.478,26,0.565,2,2,0.5,3,4,27,19,12,12,22,0.261,0.261,0.478,17.51,20,python
0,20,22,5,47,0.426,25,0.532,2,1,0.667,2,0,27,20,10,16,21,0.213,0.34,0.447,17.538,21,python
0,22,22,2,46,0.478,24,0.522,3,2,0.6,3,1,26,20,15,9,22,0.326,0.196,0.478,17.491,22,python
0,24,22,1,47,0.511,25,0.532,4,2,0.667,4,1,29,18,10,12,25,0.213,0.255,0.532,17.482,23,python
0,19,21,6,46,0.413,25,0.543,6,1,0.857,1,2,25,21,10,19,17,0.217,0.413,0.37,17.49,24,python
0,19,27,2,48,0.396,21,0.438,1,3,0.25,2,1,26,22,12,16,20,0.25,0.333,0.417,17.512,25,python
0,25,15,4,44,0.568,29,0.659,4,1,0.8,0,1,28,16,15,11,18,0.341,0.25,0.409,17.489,26,python
0,20,19,5,44,0.455,25,0.568,3,6,0.333,3,2,25,19,10,14,20,0.227,0.318,0.455,17.5,27,python
0,22,18,5,45,0.489,27,0.6,0,2,0.0,2,0,22,23,14,18,13,0.311,0.4,0.289,17.502,28,python
0,25,22,3,50,0.5,28,0.56,3,2,0.6,1,4,30,20,15,11,24,0.3,0.22,0.48,17.494,29,python
0,21,19,5,45,0.467,26,0.578,5,2,0.714,4,3,25,20,9,16,20,0.2,0.356,0.444,17.523,30,python
0,22,24,2,48,0.458,24,0.5,5,3,0.625,3,3,30,18,12,13,23,0.25,0.271,0.479,17.506,31,python
0,14,26,4,44,0.318,18,0.409,1,4,0.2,1,1,26,18,8,14,22,0.182,0.318,0.5,17.52,32,python
0,17,21,7,45,0.378,24,0.533,0,2,0.0,3,2,25,20,9,14,22,0.2,0.311,0.489,17.503,33,python
0,17,24,4,45,0.378,21,0.467,1,1,0.5,2,2,34,11,8,16,21,0.178,0.356,0.467,17.511,34,python
0,16,23,3,42,0.381,19,0.452,4,3,0.571,0,1,28,14,11,11,20,0.262,0.262,0.476,17.54,35,python
0,17,21,6,44,0.386,23,0.523,4,2,0.667,5,2,24,20,8,14,22,0.182,0.318,0.5,17.54,36,python
0,24,23,6,53,0.453,30,0.566,10,4,0.714,2,5,23,30,16,17,20,0.302,0.321,0.377,17.546,37,python
0,25,16,4,45,0.556,29,0.644,2,0,1.0,2,2,32,13,10,16,19,0.222,0.356,0.422,17.526,38,python
0,20,19,8,47,0.426,28,0.596,2,1,0.667,1,2,21,26,11,20,16,0.234,0.426,0.34,17.549,39,python
0,14,20,9,43,0.326,23,0.535,0,2,0.0,3,2,27,16,8,18,17,0.186,0.419,0.395,17.56,40,python
0,20,20,5,45,0.444,25,0.556,1,2,0.333,2,3,29,16,10,17,18,0.222,0.378,0.4,17.568,41,python
0,16,24,6,46,0.348,22,0.478,3,6,0.333,3,1,28,18,8,11,27,0.174,0.239,0.587,17.56,42,python
0,23,18,4,45,0.511,27,0.6,5,2,0.714,4,2,24,21,10,12,23,0.222,0.267,0.511,17.536,43,python
0,16,25,6,47,0.34,22,0.468,1,3,0.25,1,5,34,13,7,21,19,0.149,0.447,0.404,17.549,44,python
0,21,21,3,45,0.467,24,0.533,2,4,0.333,1,1,23,22,14,13,18,0.311,0.289,0.4,17.563,45,python
0,16,25,7,48,0.333,23,0.479,2,2,0.5,3,3,29,19,8,17,23,0.167,0.354,0.479,17.558,46,python
0,11,26,7,44,0.25,18,0.409,2,3,0.4,0,1,27,17,5,18,21,0.114,0.409,0.477,17.578,47,python
0,13,26,5,44,0.295,18,0.409,4,5,0.444,0,0,28,16,4,20,20,0.091,0.455,0.455,17.597,48,python
0,18,26,2,46,0.391,20,0.435,4,2,0.667,1,1,27,19,11,11,24,0.239,0.239,0.522,17.58,49,python
0,18,20,5,43,0.419,23,0.535,2,1,0.667,2,3,19,24,14,13,16,0.326,0.302,0.372,17.578,50,python
0,26,16,5,47,0.553,31,0.66,1,2,0.333,1,2,26,21,13,16,18,0.277,0.34,0.383,17.582,51,python
0,24,16,4,44,0.545,28,0.636,6,2,0.75,5,2,26,18,13,9,22,0.295,0.205,0.5,17.578,52,python
0,21,15,7,43,0.488,28,0.651,3,4,0.429,3,0,31,12,11,11,21,0.256,0.256,0.488,17.586,53,python
0,14,30,0,44,0.318,14,0.318,1,2,0.333,3,3,32,12,8,11,25,0.182,0.25,0.568,17.583,54,python
0,14,26,6,46,0.304,20,0.435,1,0,1.0,1,0,27,19,10,18,18,0.217,0.391,0.391,17.593,55,python
0,22,20,3,45,0.489,25,0.556,3,3,0.5,2,2,28,17,11,17,17,0.244,0.378,0.378,17.599,56,python
0,16,27,2,45,0.356,18,0.4,1,2,0.333,2,2,27,18,9,17,19,0.2,0.378,0.422,17.6,57,python
0,22,22,4,48,0.458,26,0.542,2,7,0.222,2,3,31,17,12,18,18,0.25,0.375,0.375,17.61,58,python
0,20,18,6,44,0.455,26,0.591,3,2,0.6,3,2,27,17,14,14,16,0.318,0.318,0.364,17.627,59,python
0,20,24,3,47,0.426,23,0.489,4,0,1.0,2,1,26,21,8,18,21,0.17,0.383,0.447,17.627,60,python
0,22,18,5,45,0.489,27,0.6,3,0,1.0,1,0,24,21,13,16,16,0.289,0.356,0.356,17.635,61,python
0,19,22,4,45,0.422,23,0.511,4,3,0.571,2,2,24,21,11,14,20,0.244,0.311,0.444,17.633,62,python
0,25,16,3,44,0.568,28,0.636,4,2,0.667,4,3,35,9,13,8,23,0.295,0.182,0.523,17.628,63,python
0,20,22,2,44,0.455,22,0.5,0,1,0.0,0,4,29,15,10,15,19,0.227,0.341,0.432,17.635,64,python
0,20,22,2,44,0.455,22,0.5,5,0,1.0,1,3,27,17,9,10,25,0.205,0.227,0.568,17.628,65,python
0,20,23,6,49,0.408,26,0.531,4,1,0.8,3,1,31,18,8,15,26,0.163,0.306,0.531,17.634,66,python
0,31,14,6,51,0.608,37,0.725,10,3,0.769,1,1,22,29,18,20,13,0.353,0.392,0.255,17.637,67,python
0,22,23,1,46,0.478,23,0.5,5,5,0.5,4,1,25,21,14,9,23,0.304,0.196,0.5,17.629,68,python
0,23,18,2,43,0.535,25,0.581,2,1,0.667,1,1,21,22,16,13,14,0.372,0.302,0.326,17.632,69,python
0,20,19,5,44,0.455,25,0.568,3,0,1.0,3,2,30,14,13,8,23,0.295,0.182,0.523,17.624,70,python
0,24,22,4,50,0.48,28,0.56,2,3,0.4,6,1,31,19,10,16,24,0.2,0.32,0.48,17.622,71,python
0,14,26,6,46,0.304,20,0.435,1,4,0.2,2,1,27,19,9,16,21,0.196,0.348,0.457,17.613,72,python
0,18,28,1,47,0.383,19,0.404,1,0,1.0,1,4,33,14,10,15,22,0.213,0.319,0.468,17.615,73,python
0,15,24,8,47,0.319,23,0.489,2,1,0.667,3,3,32,15,8,13,26,0.17,0.277,0.553,17.624,74,python
0,20,25,2,47,0.426,22,0.468,0,2,0.0,3,1,26,21,10,17,20,0.213,0.362,0.426,17.626,75,python
0,13,29,4,46,0.283,17,0.37,1,2,0.333,2,1,27,19,5,18,23,0.109,0.391,0.5,17.626,76,python
0,23,22,3,48,0.479,26,0.542,3,4,0.429,2,1,26,22,13,14,21,0.271,0.292,0.438,17.625,77,python
0,18,25,3,46,0.391,21,0.457,2,3,0.4,2,3,27,19,6,19,21,0.13,0.413,0.457,17.628,78,python
0,17,24,5,46,0.37,22,0.478,3,2,0.6,2,3,30,16,6,16,24,0.13,0.348,0.522,17.632,79,python
0,21,17,7,45,0.467,28,0.622,6,1,0.857,1,1,33,12,12,10,23,0.267,0.222,0.511,17.633,80,python
0,14,25,5,44,0.318,19,0.432,4,2,0.667,2,3,27,17,6,17,21,0.136,0.386,0.477,17.618,81,python
0,17,22,8,47,0.362,25,0.532,2,1,0.667,2,2,32,15,9,14,24,0.191,0.298,0.511,17.616,82,python
0,22,21,3,46,0.478,25,0.543,7,2,0.778,3,3,30,16,11,12,23,0.239,0.261,0.5,17.619,83,python
0,19,20,8,47,0.404,27,0.574,3,3,0.5,4,1,29,18,10,13,24,0.213,0.277,0.511,17.615,84,python
0,19,22,3,44,0.432,22,0.5,3,3,0.5,1,2,27,17,8,18,18,0.182,0.409,0.409,17.617,85,python
0,23,19,4,46,0.5,27,0.587,4,2,0.667,2,4,27,19,11,14,21,0.239,0.304,0.457,17.62,86,python
0,16,25,2,43,0.372,18,0.419,2,2,0.5,3,1,32,11,11,9,23,0.256,0.209,0.535,17.622,87,python
0,20,23,5,48,0.417,25,0.521,2,2,0.5,4,5,29,19,11,12,25,0.229,0.25,0.521,17.615,88,python
0,12,29,3,44,0.273,15,0.341,2,3,0.4,1,5,27,17,7,16,21,0.159,0.364,0.477,17.618,89,python
0,20,22,0,42,0.476,20,0.476,2,2,0.5,2,2,30,12,12,10,20,0.286,0.238,0.476,17.61,90,python
0,25,17,2,44,0.568,27,0.614,3,2,0.6,3,0,27,17,14,10,20,0.318,0.227,0.455,17.606,91,python
0,16,25,9,50,0.32,25,0.5,2,5,0.286,2,3,33,17,5,18,27,0.1,0.36,0.54,17.616,92,python
0,19,25,1,45,0.422,20,0.444,0,3,0.0,4,2,24,21,9,16,20,0.2,0.356,0.444,17.614,93,python
0,24,21,1,46,0.522,25,0.543,8,3,0.727,3,4,28,18,15,9,22,0.326,0.196,0.478,17.61,94,python
0,17,26,4,47,0.362,21,0.447,1,0,1.0,4,1,30,17,9,19,19,0.191,0.404,0.404,17.612,95,python
0,12,28,4,44,0.273,16,0.364,0,4,0.0,4,2,29,15,5,15,24,0.114,0.341,0.545,17.604,96,python
0,20,18,5,43,0.465,25,0.581,5,3,0.625,2,1,27,16,12,12,19,0.279,0.279,0.442,17.889,1,python
0,29,14,2,45,0.644,31,0.689,5,2,0.714,3,1,25,20,16,12,17,0.356,0.267,0.378,17.849,2,python
0,21,19,5,45,0.467,26,0.578,4,1,0.8,1,2,31,14,9,17,19,0.2,0.378,0.422,17.952,3,python
0,14,30,6,50,0.28,20,0.4,3,1,0.75,2,3,32,18,7,19,24,0.14,0.38,0.48,17.86,4,python
0,24,13,7,44,0.545,31,0.705,6,1,0.857,2,1,24,20,16,10,18,0.364,0.227,0.409,17.848,5,python
0,19,24,2,45,0.422,21,0.467,3,2,0.6,3,5,31,14,12,12,21,0.267,0.267,0.467,17.891,6,python
0,21,20,4,45,0.467,25,0.556,3,5,0.375,2,5,28,17,11,12,22,0.244,0.267,0.489,17.834,7,python
0,21,20,3,44,0.477,24,0.545,0,1,0.0,3,1,25,19,8,15,21,0.182,0.341,0.477,17.804,8,python
0,22,19,2,43,0.512,24,0.558,3,1,0.75,2,1,21,22,13,14,16,0.302,0.326,0.372,17.785,9,python
0,20,20,5,45,0.444,25,0.556,4,2,0.667,2,1,28,17,11,15,19,0.244,0.333,0.422,17.779,10,python
0,22,19,3,44,0.5,25,0.568,0,0,0,1,1,24,20,9,17,18,0.205,0.386,0.409,17.833,11,python
0,26,19,2,47,0.553,28,0.596,3,1,0.75,3,3,29,18,17,11,19,0.362,0.234,0.404,17.783,12,python
0,20,21,4,45,0.444,24,0.533,3,4,0.429,0,1,20,25,15,15,15,0.333,0.333,0.333,17.792,13,python
0,25,13,5,43,0.581,30,0.698,4,2,0.667,2,1,33,10,17,11,15,0.395,0.256,0.349,17.783,14,python
0,15,26,4,45,0.333,19,0.422,3,1,0.75,2,0,30,15,7,14,24,0.156,0.311,0.533,17.748,15,python
0,20,18,6,44,0.455,26,0.591,5,2,0.714,1,1,19,25,14,16,14,0.318,0.364,0.318,17.783,16,python
0,21,22,4,47,0.447,25,0.532,0,5,0.0,5,2,20,27,11,17,19,0.234,0.362,0.404,17.774,17,python
0,18,22,6,46,0.391,24,0.522,4,2,0.667,2,0,29,17,10,19,17,0.217,0.413,0.37,17.765,18,python
0,11,29,6,46,0.239,17,0.37,2,3,0.4,2,1,32,14,4,17,25,0.087,0.37,0.543,17.769,19,python
0,19,22,3,44,0.432,22,0.5,3,2,0.6,3,1,32,12,6,13,25,0.136,0.295,0.568,17.788,20,python
0,24,21,5,50,0.48,29,0.58,6,1,0.857,1,1,28,22,14,16,20,0.28,0.32,0.4,17.796,21,python
0,18,22,5,45,0.4,23,0.511,2,3,0.4,4,3,28,17,8,15,22,0.178,0.333,0.489,17.788,22,python
0,20,22,4,46,0.435,24,0.522,5,0,1.0,1,3,24,22,9,19,18,0.196,0.413,0.391,17.811,23,python
0,16,28,3,47,0.34,19,0.404,2,2,0.5,1,1,29,18,7,16,24,0.149,0.34,0.511,17.817,24,python
0,20,25,0,45,0.444,20,0.444,0,2,0.0,3,2,23,22,11,12,22,0.244,0.267,0.489,17.795,25,python
0,20,22,6,48,0.417,26,0.542,7,4,0.636,2,2,28,20,15,12,21,0.312,0.25,0.438,17.796,26,python
0,22,22,2,46,0.478,24,0.522,1,2,0.333,2,3,27,19,12,13,21,0.261,0.283,0.457,17.767,27,python
0,20,20,6,46,0.435,26,0.565,1,0,1.0,1,2,26,20,14,17,15,0.304,0.37,0.326,17.781,28,python
0,21,23,2,46,0.457,23,0.5,2,1,0.667,2,2,26,20,9,16,21,0.196,0.348,0.457,17.773,29,python
0,24,17,3,44,0.545,27,0.614,3,4,0.429,1,1,28,16,11,14,19,0.25,0.318,0.432,17.774,30,python
0,18,20,7,45,0.4,25,0.556,3,0,1.0,1,4,28,17,10,14,21,0.222,0.311,0.467,17.782,31,python
0,20,21,5,46,0.435,25,0.543,5,4,0.556,4,0,29,17,6,13,27,0.13,0.283,0.587,17.766,32,python
0,22,22,2,46,0.478,24,0.522,1,2,0.333,2,5,29,17,12,11,23,0.261,0.239,0.5,17.762,33,python
0,19,25,2,46,0.413,21,0.457,3,3,0.5,1,1,29,17,10,14,22,0.217,0.304,0.478,17.743,34,python
0,19,22,5,46,0.413,24,0.522,2,0,1.0,2,3,27,19,12,9,25,0.261,0.196,0.543,17.721,35,python
0,26,19,3,48,0.542,29,0.604,6,3,0.667,2,0,30,18,14,15,19,0.292,0.312,0.396,17.702,36,python
0,16,25,3,44,0.364,19,0.432,4,2,0.667,1,2,31,13,7,12,25,0.159,0.273,0.568,17.708,37,python
0,20,21,3,44,0.455,23,0.523,5,1,0.833,1,3,22,22,10,16,18,0.227,0.364,0.409,17.716,38,python
0,20,22,4,46,0.435,24,0.522,6,3,0.667,1,2,31,15,8,14,24,0.174,0.304,0.522,17.721,39,python
0,11,29,8,48,0.229,19,0.396,2,3,0.4,1,2,25,23,4,21,23,0.083,0.438,0.479,17.726,40,python
0,22,19,4,45,0.489,26,0.578,3,2,0.6,2,3,29,16,8,14,23,0.178,0.311,0.511,17.724,41,python
0,19,21,6,46,0.413,25,0.543,1,3,0.25,4,4,29,17,12,15,19,0.261,0.326,0.413,17.723,42,python
0,16,23,6,45,0.356,22,0.489,4,2,0.667,1,5,30,15,5,18,22,0.111,0.4,0.489,17.724,43,python
0,23,16,4,43,0.535,27,0.628,4,0,1.0,2,1,26,17,13,16,14,0.302,0.372,0.326,17.732,44,python
0,18,22,4,44,0.409,22,0.5,2,2,0.5,3,0,26,18,8,18,18,0.182,0.409,0.409,17.722,45,python
0,19,20,5,44,0.432,24,0.545,1,2,0.333,2,1,26,18,10,14,20,0.227,0.318,0.455,17.704,46,python
0,18,19,10,47,0.383,28,0.596,1,5,0.167,3,1,23,24,10,17,20,0.213,0.362,0.426,17.72,47,python
0,17,25,6,48,0.354,23,0.479,4,2,0.667,2,2,30,18,7,13,28,0.146,0.271,0.583,17.719,48,python
0,20,22,5,47,0.426,25,0.532,1,0,1.0,1,3,25,22,12,16,19,0.255,0.34,0.404,17.708,49,python
0,18,21,6,45,0.4,24,0.533,4,2,0.667,3,3,31,14,11,12,22,0.244,0.267,0.489,17.711,50,python
0,21,21,3,45,0.467,24,0.533,5,2,0.714,2,0,28,17,11,13,21,0.244,0.289,0.467,17.717,51,python
0,20,28,3,51,0.392,23,0.451,1,2,0.333,3,2,32,19,11,17,23,0.216,0.333,0.451,17.692,52,python
0,22,17,5,44,0.5,27,0.614,0,1,0.0,1,1,29,15,11,13,20,0.25,0.295,0.455,17.69,53,python
0,22,21,3,46,0.478,25,0.543,3,1,0.75,1,1,26,20,12,15,19,0.261,0.326,0.413,17.696,54,python
0,22,22,2,46,0.478,24,0.522,0,2,0.0,2,3,26,20,12,16,18,0.261,0.348,0.391,17.7,55,python
0,22,21,4,47,0.468,26,0.553,6,1,0.857,2,3,21,26,12,15,20,0.255,0.319,0.426,17.698,56,python
0,23,18,4,45,0.511,27,0.6,5,2,0.714,3,1,24,21,9,14,22,0.2,0.311,0.489,17.698,57,python
0,16,21,8,45,0.356,24,0.533,3,3,0.5,1,2,24,21,9,20,16,0.2,0.444,0.356,17.705,58,python
0,21,18,3,42,0.5,24,0.571,2,1,0.667,1,2,29,13,15,6,21,0.357,0.143,0.5,17.709,59,python
0,21,25,2,48,0.438,23,0.479,2,3,0.4,2,3,29,19,11,12,25,0.229,0.25,0.521,17.71,60,python
0,23,18,3,44,0.523,26,0.591,4,1,0.8,2,0,26,18,14,15,15,0.318,0.341,0.341,17.71,61,python
0,20,21,4,45,0.444,24,0.533,1,0,1.0,2,2,28,17,13,10,22,0.289,0.222,0.489,17.714,62,python
0,20,20,5,45,0.444,25,0.556,1,5,0.167,2,2,31,14,17,10,18,0.378,0.222,0.4,17.727,63,python
0,15,25,6,46,0.326,21,0.457,1,1,0.5,2,3,32,14,7,14,25,0.152,0.304,0.543,17.728,64,python
0,28,13,5,46,0.609,33,0.717,4,3,0.571,3,0,23,23,20,9,17,0.435,0.196,0.37,17.725,65,python
0,21,20,4,45,0.467,25,0.556,6,3,0.667,1,2,29,16,11,17,17,0.244,0.378,0.378,17.725,66,python
0,28,19,1,48,0.583,29,0.604,1,2,0.333,1,3,18,30,21,17,10,0.438,0.354,0.208,17.729,67,python
0,25,16,3,44,0.568,28,0.636,4,0,1.0,1,1,27,17,18,12,14,0.409,0.273,0.318,17.734,68,python
0,15,27,5,47,0.319,20,0.426,2,3,0.4,3,4,25,22,7,21,19,0.149,0.447,0.404,17.738,69,python
0,20,24,1,45,0.444,21,0.467,2,4,0.333,3,2,27,18,13,10,22,0.289,0.222,0.489,17.735,70,python
0,14,25,8,47,0.298,22,0.468,3,6,0.333,0,2,31,16,7,16,24,0.149,0.34,0.511,17.745,71,python
0,19,24,5,48,0.396,24,0.5,2,2,0.5,3,1,30,18,11,13,24,0.229,0.271,0.5,17.743,72,python
0,17,24,6,47,0.362,23,0.489,4,4,0.5,2,2,31,16,9,14,24,0.191,0.298,0.511,17.745,73,python
0,19,20,5,44,0.432,24,0.545,4,2,0.667,2,0,26,18,7,13,24,0.159,0.295,0.545,17.743,74,python
0,20,22,3,45,0.444,23,0.511,1,4,0.2,0,3,32,13,10,13,22,0.222,0.289,0.489,17.751,75,python
0,18,23,7,48,0.375,25,0.521,2,3,0.4,0,6,25,23,8,18,22,0.167,0.375,0.458,17.758,76,python
0,16,26,5,47,0.34,21,0.447,2,0,1.0,1,3,29,18,8,12,27,0.17,0.255,0.574,17.753,77,python
0,16,24,5,45,0.356,21,0.467,1,2,0.333,4,1,25,20,6,19,20,0.133,0.422,0.444,17.756,78,python
0,23,19,3,45,0.511,26,0.578,2,1,0.667,1,0,28,17,14,18,13,0.311,0.4,0.289,17.756,79,python
0,18,19,7,44,0.409,25,0.568,2,4,0.333,1,3,32,12,10,10,24,0.227,0.227,0.545,17.755,80,python
0,16,22,7,45,0.356,23,0.511,2,1,0.667,2,2,31,14,6,14,25,0.133,0.311,0.556,17.747,81,python
0,26,16,5,47,0.553,31,0.66,3,1,0.75,3,2,25,22,14,11,22,0.298,0.234,0.468,17.738,82,python
0,22,20,3,45,0.489,25,0.556,2,2,0.5,1,2,24,21,15,10,20,0.333,0.222,0.444,17.741,83,python
0,20,21,3,44,0.455,23,0.523,2,0,1.0,4,1,27,17,9,12,23,0.205,0.273,0.523,17.745,84,python
0,23,20,2,45,0.511,25,0.556,2,1,0.667,1,3,29,16,13,12,20,0.289,0.267,0.444,17.748,85,python
0,23,17,3,43,0.535,26,0.605,4,1,0.8,2,1,30,13,13,13,17,0.302,0.302,0.395,17.75,86,python
0,20,25,2,47,0.426,22,0.468,0,2,0.0,2,1,20,27,11,21,15,0.234,0.447,0.319,17.747,87,python
0,21,21,4,46,0.457,25,0.543,5,1,0.833,2,4,26,20,13,10,23,0.283,0.217,0.5,17.742,88,python
0,17,22,6,45,0.378,23,0.511,1,2,0.333,3,1,27,18,10,16,19,0.222,0.356,0.422,17.745,89,python
0,22,20,3,45,0.489,25,0.556,3,1,0.75,3,3,26,19,14,14,17,0.311,0.311,0.378,17.742,90,python
0,20,18,6,44,0.455,26,0.591,5,2,0.714,0,1,22,22,10,17,17,0.227,0.386,0.386,17.744,91,python
0,21,20,4,45,0.467,25,0.556,2,1,0.667,2,1,26,19,15,12,18,0.333,0.267,0.4,17.736,92,python
0,22,18,3,43,0.512,25,0.581,7,4,0.636,0,0,26,17,17,10,16,0.395,0.233,0.372,17.737,93,python
0,18,21,5,44,0.409,23,0.523,2,5,0.286,0,0,31,13,12,11,21,0.273,0.25,0.477,17.736,94,python
0,20,20,4,44,0.455,24,0.545,3,5,0.375,1,1,26,18,13,12,19,0.295,0.273,0.432,17.737,95,python
0,20,25,3,48,0.417,23,0.479,4,2,0.667,2,1,25,23,13,15,20,0.271,0.312,0.417,17.736,96,python
0,19,21,4,44,0.432,23,0.523,6,4,0.6,1,4,29,15,13,13,18,0.295,0.295,0.409,17.864,1,python
0,18,22,7,47,0.383,25,0.532,0,4,0.0,2,3,30,17,8,17,22,0.17,0.362,0.468,18.302,2,python
0,20,19,8,47,0.426,28,0.596,7,0,1.0,2,2,31,16,10,10,27,0.213,0.213,0.574,17.976,3,python
0,18,26,2,46,0.391,20,0.435,3,2,0.6,4,2,25,21,9,15,22,0.196,0.326,0.478,17.923,4,python
0,20,18,6,44,0.455,26,0.591,5,1,0.833,2,3,25,19,13,15,16,0.295,0.341,0.364,17.951,5,python
0,12,30,3,45,0.267,15,0.333,2,3,0.4,0,3,33,12,6,16,23,0.133,0.356,0.511,17.96,6,python
0,16,23,7,46,0.348,23,0.5,1,1,0.5,2,2,33,13,6,13,27,0.13,0.283,0.587,17.886,7,python
0,15,29,3,47,0.319,18,0.383,3,5,0.375,1,2,30,17,8,13,26,0.17,0.277,0.553,17.872,8,python
0,23,19,4,46,0.5,27,0.587,4,0,1.0,1,3,36,10,7,18,21,0.152,0.391,0.457,17.938,9,python
0,20,17,6,43,0.465,26,0.605,4,1,0.8,1,1,27,16,10,17,16,0.233,0.395,0.372,17.927,10,python
0,18,25,3,46,0.391,21,0.457,1,1,0.5,1,1,25,21,8,19,19,0.174,0.413,0.413,17.976,11,python
0,25,17,4,46,0.543,29,0.63,3,2,0.6,1,1,26,20,12,18,16,0.261,0.391,0.348,17.992,12,python
0,19,24,3,46,0.413,22,0.478,3,2,0.6,1,3,28,18,11,15,20,0.239,0.326,0.435,17.923,13,python
0,27,17,2,46,0.587,29,0.63,5,2,0.714,3,1,25,21,13,15,18,0.283,0.326,0.391,17.926,14,python
0,21,21,2,44,0.477,23,0.523,4,1,0.8,2,0,23,21,11,16,17,0.25,0.364,0.386,17.915,15,python
0,24,18,3,45,0.533,27,0.6,3,3,0.5,1,3,32,13,14,11,20,0.311,0.244,0.444,17.88,16,python
0,23,24,2,49,0.469,25,0.51,1,1,0.5,3,5,33,16,9,14,26,0.184,0.286,0.531,17.827,17,python
0,25,17,2,44,0.568,27,0.614,2,3,0.4,2,4,26,18,14,12,18,0.318,0.273,0.409,17.86,18,python
0,16,24,5,45,0.356,21,0.467,1,2,0.333,1,2,29,16,4,18,23,0.089,0.4,0.511,17.825,19,python
0,19,20,7,46,0.413,26,0.565,1,5,0.167,4,0,31,15,10,15,21,0.217,0.326,0.457,17.812,20,python
0,18,25,3,46,0.391,21,0.457,3,3,0.5,3,1,31,15,8,14,24,0.174,0.304,0.522,17.796,21,python
0,22,19,3,44,0.5,25,0.568,1,2,0.333,1,4,25,19,15,13,16,0.341,0.295,0.364,17.805,22,python
0,24,18,3,45,0.533,27,0.6,3,2,0.6,2,3,31,14,12,8,25,0.267,0.178,0.556,17.812,23,python
0,17,21,6,44,0.386,23,0.523,1,5,0.167,1,0,30,14,8,18,18,0.182,0.409,0.409,17.814,24,python
0,20,20,3,43,0.465,23,0.535,1,2,0.333,0,1,27,16,9,16,18,0.209,0.372,0.419,17.844,25,python
0,22,23,2,47,0.468,24,0.511,5,2,0.714,2,6,28,19,9,13,25,0.191,0.277,0.532,17.837,26,python
0,20,25,4,49,0.408,24,0.49,3,3,0.5,3,0,28,21,8,16,25,0.163,0.327,0.51,17.809,27,python
0,23,21,3,47,0.489,26,0.553,5,3,0.625,2,2,34,13,15,10,22,0.319,0.213,0.468,17.797,28,python
0,21,18,6,45,0.467,27,0.6,2,3,0.4,2,1,29,16,15,15,15,0.333,0.333,0.333,17.792,29,python
0,20,23,3,46,0.435,23,0.5,3,2,0.6,3,2,29,17,10,17,19,0.217,0.37,0.413,17.785,30,python
0,21,21,5,47,0.447,26,0.553,2,3,0.4,4,0,36,11,6,10,31,0.128,0.213,0.66,17.771,31,python
0,25,27,3,55,0.455,28,0.509,1,2,0.333,1,5,23,32,16,19,20,0.291,0.345,0.364,17.773,32,python
0,22,22,1,45,0.489,23,0.511,5,1,0.833,1,3,27,18,14,9,22,0.311,0.2,0.489,17.775,33,python
0,23,20,2,45,0.511,25,0.556,6,2,0.75,2,2,32,13,12,9,24,0.267,0.2,0.533,17.761,34,python
0,24,18,2,44,0.545,26,0.591,2,1,0.667,3,1,28,16,15,14,15,0.341,0.318,0.341,17.764,35,python
0,26,20,2,48,0.542,28,0.583,5,2,0.714,1,1,31,17,16,14,18,0.333,0.292,0.375,17.763,36,python
0,19,22,5,46,0.413,24,0.522,2,2,0.5,1,4,29,17,9,16,21,0.196,0.348,0.457,17.747,37,python
0,21,20,2,43,0.488,23,0.535,4,2,0.667,1,0,22,21,15,14,14,0.349,0.326,0.326,17.759,38,python
0,27,17,3,47,0.574,30,0.638,2,3,0.4,5,0,26,21,12,12,23,0.255,0.255,0.489,17.72,39,python
0,24,21,1,46,0.522,25,0.543,4,2,0.667,3,3,24,22,13,11,22,0.283,0.239,0.478,17.715,40,python
0,19,21,4,44,0.432,23,0.523,3,0,1.0,3,3,29,15,10,15,19,0.227,0.341,0.432,17.734,41,python
0,17,20,7,44,0.386,24,0.545,4,2,0.667,2,3,33,11,11,11,22,0.25,0.25,0.5,17.734,42,python
0,20,18,5,43,0.465,25,0.581,2,2,0.5,4,1,31,12,10,12,21,0.233,0.279,0.488,17.734,43,python
0,21,22,4,47,0.447,25,0.532,0,3,0.0,3,2,36,11,10,16,21,0.213,0.34,0.447,17.729,44,python
0,23,21,3,47,0.489,26,0.553,1,4,0.2,2,3,32,15,15,13,19,0.319,0.277,0.404,17.724,45,python
0,25,16,3,44,0.568,28,0.636,2,0,1.0,0,1,28,16,15,8,21,0.341,0.182,0.477,17.72,46,python
0,10,33,4,47,0.213,14,0.298,1,6,0.143,1,3,30,17,8,18,21,0.17,0.383,0.447,17.735,47,python
0,21,21,4,46,0.457,25,0.543,7,3,0.7,1,1,24,22,12,17,17,0.261,0.37,0.37,17.745,48,python
0,17,26,3,46,0.37,20,0.435,3,5,0.375,2,3,30,16,10,12,24,0.217,0.261,0.522,17.732,49,python
0,25,19,2,46,0.543,27,0.587,4,3,0.571,4,4,27,19,14,11,21,0.304,0.239,0.457,17.736,50,python
0,20,22,3,45,0.444,23,0.511,0,3,0.0,0,1,27,18,7,16,22,0.156,0.356,0.489,17.738,51,python
0,29,14,1,44,0.659,30,0.682,8,2,0.8,2,1,25,19,13,17,14,0.295,0.386,0.318,17.736,52,python
0,18,22,4,44,0.409,22,0.5,2,4,0.333,1,2,30,14,11,15,18,0.25,0.341,0.409,17.727,53,python
0,27,20,4,51,0.529,31,0.608,5,2,0.714,2,2,30,21,14,16,21,0.275,0.314,0.412,17.725,54,python
0,19,19,5,43,0.442,24,0.558,5,0,1.0,2,2,28,15,11,15,17,0.256,0.349,0.395,17.715,55,python
0,20,24,2,46,0.435,22,0.478,6,3,0.667,2,0,28,18,8,16,22,0.174,0.348,0.478,17.721,56,python
0,22,20,6,48,0.458,28,0.583,3,3,0.5,4,2,30,18,8,14,26,0.167,0.292,0.542,17.708,57,python
0,18,22,5,45,0.4,23,0.511,5,2,0.714,3,2,29,16,11,13,21,0.244,0.289,0.467,17.695,58,python
0,21,21,2,44,0.477,23,0.523,3,3,0.5,2,4,29,15,9,17,18,0.205,0.386,0.409,17.696,59,python
0,22,19,3,44,0.5,25,0.568,5,2,0.714,2,3,24,20,13,14,17,0.295,0.318,0.386,17.702,60,python
0,24,21,0,45,0.533,24,0.533,2,2,0.5,1,1,29,16,12,14,19,0.267,0.311,0.422,17.697,61,python
0,20,24,3,47,0.426,23,0.489,1,3,0.25,3,0,34,13,10,12,25,0.213,0.255,0.532,17.684,62,python
0,16,22,9,47,0.34,25,0.532,2,1,0.667,1,3,27,20,6,24,17,0.128,0.511,0.362,17.686,63,python
0,24,21,2,47,0.511,26,0.553,2,3,0.4,2,3,30,17,13,15,19,0.277,0.319,0.404,17.677,64,python
0,19,25,3,47,0.404,22,0.468,5,2,0.714,3,2,23,24,11,14,22,0.234,0.298,0.468,17.669,65,python
0,28,11,4,43,0.651,32,0.744,4,1,0.8,4,2,23,20,18,10,15,0.419,0.233,0.349,17.668,66,python
0,17,22,6,45,0.378,23,0.511,2,2,0.5,1,1,29,16,6,17,22,0.133,0.378,0.489,17.669,67,python
0,16,25,4,45,0.356,20,0.444,2,3,0.4,0,5,30,15,7,14,24,0.156,0.311,0.533,17.674,68,python
0,22,18,2,42,0.524,24,0.571,1,0,1.0,3,1,24,18,17,10,15,0.405,0.238,0.357,17.67,69,python
0,15,25,6,46,0.326,21,0.457,1,4,0.2,0,2,27,19,8,16,22,0.174,0.348,0.478,17.669,70,python
0,20,24,1,45,0.444,21,0.467,3,2,0.6,3,5,33,12,10,11,24,0.222,0.244,0.533,17.667,71,python
0,29,12,3,44,0.659,32,0.727,2,0,1.0,1,2,28,16,20,8,16,0.455,0.182,0.364,17.655,72,python
0,18,22,5,45,0.4,23,0.511,1,1,0.5,3,4,33,12,6,12,27,0.133,0.267,0.6,17.662,73,python
0,14,29,4,47,0.298,18,0.383,2,4,0.333,0,6,30,17,10,13,24,0.213,0.277,0.511,17.662,74,python
0,23,24,1,48,0.479,24,0.5,1,1,0.5,3,1,31,17,9,12,27,0.188,0.25,0.562,17.661,75,python
0,24,23,4,51,0.471,28,0.549,4,1,0.8,3,0,30,21,16,16,19,0.314,0.314,0.373,17.659,76,python
0,21,21,1,43,0.488,22,0.512,3,4,0.429,0,2,26,17,10,13,20,0.233,0.302,0.465,17.656,77,python
0,24,16,3,43,0.558,27,0.628,3,1,0.75,5,2,32,11,12,9,22,0.279,0.209,0.512,17.65,78,python
0,27,16,3,46,0.587,30,0.652,6,1,0.857,4,0,28,18,16,10,20,0.348,0.217,0.435,17.645,79,python
0,20,19,6,45,0.444,26,0.578,7,3,0.7,0,0,28,17,13,14,18,0.289,0.311,0.4,17.65,80,python
0,19,20,4,43,0.442,23,0.535,4,0,1.0,0,2,29,14,10,11,22,0.233,0.256,0.512,17.65,81,python
0,19,21,6,46,0.413,25,0.543,3,3,0.5,3,2,21,25,11,18,17,0.239,0.391,0.37,17.648,82,python
0,14,27,4,45,0.311,18,0.4,0,2,0.0,2,3,28,17,7,16,22,0.156,0.356,0.489,17.646,83,python
0,19,23,4,46,0.413,23,0.5,0,2,0.0,4,1,30,16,11,12,23,0.239,0.261,0.5,17.647,84,python
0,14,30,1,45,0.311,15,0.333,2,1,0.667,0,1,26,19,9,17,19,0.2,0.378,0.422,17.647,85,python
0,19,21,5,45,0.422,24,0.533,8,4,0.667,1,1,26,19,9,15,21,0.2,0.333,0.467,17.65,86,python
0,17,24,3,44,0.386,20,0.455,5,4,0.556,1,1,22,22,12,14,18,0.273,0.318,0.409,17.649,87,python
0,22,22,2,46,0.478,24,0.522,1,2,0.333,6,2,25,21,11,12,23,0.239,0.261,0.5,17.644,88,python
0,24,16,4,44,0.545,28,0.636,5,1,0.833,2,2,32,12,13,8,23,0.295,0.182,0.523,17.642,89,python
0,21,18,4,43,0.488,25,0.581,2,2,0.5,2,0,24,19,11,16,16,0.256,0.372,0.372,17.644,90,python
0,19,20,6,45,0.422,25,0.556,0,1,0.0,3,1,31,14,9,13,23,0.2,0.289,0.511,17.644,91,python
0,17,27,5,49,0.347,22,0.449,0,6,0.0,3,2,25,24,9,20,20,0.184,0.408,0.408,17.636,92,python
0,18,24,5,47,0.383,23,0.489,3,2,0.6,1,3,29,18,10,15,22,0.213,0.319,0.468,17.634,93,python
0,23,20,4,47,0.489,27,0.574,2,2,0.5,6,3,34,13,10,12,25,0.213,0.255,0.532,17.635,94,python
0,11,30,6,47,0.234,17,0.362,2,0,1.0,2,1,31,16,3,21,23,0.064,0.447,0.489,17.631,95,python
0,18,21,5,44,0.409,23,0.523,4,4,0.5,1,4,29,15,9,12,23,0.205,0.273,0.523,17.637,96,python
0,21,18,6,45,0.467,27,0.6,2,2,0.5,4,1,29,16,10,12,23,0.222,0.267,0.511,17.75,1,riffle_perfect
0,16,26,5,47,0.34,21,0.447,2,3,0.4,1,3,33,14,7,19,21,0.149,0.404,0.447,17.794,2,riffle_perfect
0,20,19,5,44,0.455,25,0.568,1,1,0.5,2,2,28,16,9,15,20,0.205,0.341,0.455,17.783,3,riffle_perfect
0,21,16,6,43,0.488,27,0.628,3,2,0.6,2,1,27,16,11,13,19,0.256,0.302,0.442,17.826,4,riffle_perfect
0,18,24,3,45,0.4,21,0.467,5,1,0.833,2,2,27,18,11,13,21,0.244,0.289,0.467,17.788,5,riffle_perfect
0,20,21,3,44,0.455,23,0.523,6,1,0.857,1,2,29,15,10,13,21,0.227,0.295,0.477,17.617,6,riffle_perfect
0,25,14,6,45,0.556,31,0.689,4,1,0.8,2,0,29,16,13,14,18,0.289,0.311,0.4,17.593,7,riffle_perfect
0,28,17,3,48,0.583,31,0.646,4,1,0.8,1,2,31,17,15,12,21,0.312,0.25,0.438,17.597,8,riffle_perfect
0,17,24,5,46,0.37,22,0.478,2,4,0.333,5,4,25,21,8,14,24,0.174,0.304,0.522,17.479,9,riffle_perfect
0,17,22,7,46,0.37,24,0.522,1,3,0.25,1,4,26,20,12,15,19,0.261,0.326,0.413,17.529,10,riffle_perfect
0,13,28,3,44,0.295,16,0.364,1,1,0.5,1,2,27,17,6,13,25,0.136,0.295,0.568,17.521,11,riffle_perfect
0,24,24,4,52,0.462,28,0.538,3,2,0.6,3,2,20,32,19,15,18,0.365,0.288,0.346,17.551,12,riffle_perfect
0,28,16,5,49,0.571,33,0.673,3,1,0.75,1,1,20,29,18,16,15,0.367,0.327,0.306,17.606,13,riffle_perfect
0,18,28,1,47,0.383,19,0.404,6,3,0.667,2,5,30,17,10,11,26,0.213,0.234,0.553,17.578,14,riffle_perfect
0,24,18,2,44,0.545,26,0.591,5,0,1.0,3,3,22,22,17,9,18,0.386,0.205,0.409,17.555,15,riffle_perfect
0,27,15,4,46,0.587,31,0.674,1,1,0.5,2,1,28,18,15,11,20,0.326,0.239,0.435,17.586,16,riffle_perfect
0,24,18,4,46,0.522,28,0.609,5,4,0.556,0,2,26,20,9,18,19,0.196,0.391,0.413,17.635,17,riffle_perfect
0,18,25,2,45,0.4,20,0.444,2,5,0.286,0,5,32,13,10,12,23,0.222,0.267,0.511,17.659,18,riffle_perfect
0,18,17,8,43,0.419,26,0.605,1,2,0.333,1,0,27,16,11,15,17,0.256,0.349,0.395,17.682,19,riffle_perfect
0,15,31,3,49,0.306,18,0.367,1,0,1.0,3,5,29,20,4,21,24,0.082,0.429,0.49,17.671,20,riffle_perfect
0,20,22,3,45,0.444,23,0.511,1,2,0.333,3,5,28,17,13,12,20,0.289,0.267,0.444,17.634,21,riffle_perfect
0,21,21,1,43,0.488,22,0.512,6,2,0.75,2,0,27,16,11,10,22,0.256,0.233,0.512,17.627,22,riffle_perfect
0,17,20,8,45,0.378,25,0.556,4,1,0.8,1,2,32,13,12,11,22,0.267,0.244,0.489,17.639,23,riffle_perfect
0,19,25,2,46,0.413,21,0.457,1,0,1.0,2,1,24,22,13,15,18,0.283,0.326,0.391,17.622,24,riffle_perfect
0,17,22,5,44,0.386,22,0.5,4,0,1.0,1,2,34,10,9,11,24,0.205,0.25,0.545,17.607,25,riffle_perfect
0,22,20,3,45,0.489,25,0.556,3,1,0.75,1,4,30,15,14,10,21,0.311,0.222,0.467,17.585,26,riffle_perfect
0,17,25,5,47,0.362,22,0.468,4,3,0.571,0,2,29,18,12,15,20,0.255,0.319,0.426,17.622,27,riffle_perfect
0,23,20,2,45,0.511,25,0.556,1,2,0.333,2,2,24,21,10,18,17,0.222,0.4,0.378,17.619,28,riffle_perfect
0,24,16,5,45,0.533,29,0.644,2,3,0.4,5,2,27,18,13,13,19,0.289,0.289,0.422,17.614,29,riffle_perfect
0,19,20,5,44,0.432,24,0.545,5,3,0.625,0,0,27,17,13,15,16,0.295,0.341,0.364,17.636,30,riffle_perfect
0,19,23,7,49,0.388,26,0.531,2,3,0.4,2,2,32,17,9,10,30,0.184,0.204,0.612,17.618,31,riffle_perfect
0,17,27,5,49,0.347,22,0.449,5,2,0.714,2,3,26,23,7,21,21,0.143,0.429,0.429,17.637,32,riffle_perfect
0,13,26,8,47,0.277,21,0.447,4,1,0.8,2,2,30,17,6,16,25,0.128,0.34,0.532,17.642,33,riffle_perfect
0,14,25,6,45,0.311,20,0.444,2,6,0.25,1,0,30,15,6,13,26,0.133,0.289,0.578,17.659,34,riffle_perfect
0,23,18,5,46,0.5,28,0.609,2,0,1.0,2,3,24,22,12,15,19,0.261,0.326,0.413,17.659,35,riffle_perfect
0,21,18,6,45,0.467,27,0.6,3,0,1.0,3,2,29,16,9,11,25,0.2,0.244,0.556,17.664,36,riffle_perfect
0,19,20,5,44,0.432,24,0.545,1,2,0.333,2,1,28,16,13,15,16,0.295,0.341,0.364,17.663,37,riffle_perfect
0,22,19,5,46,0.478,27,0.587,4,1,0.8,0,2,26,20,10,16,20,0.217,0.348,0.435,17.661,38,riffle_perfect
0,20,21,4,45,0.444,24,0.533,1,5,0.167,5,2,29,16,12,14,19,0.267,0.311,0.422,17.654,39,riffle_perfect
0,14,25,7,46,0.304,21,0.457,3,1,0.75,1,3,31,15,6,15,25,0.13,0.326,0.543,17.661,40,riffle_perfect
0,11,31,4,46,0.239,15,0.326,1,4,0.2,3,1,25,21,5,18,23,0.109,0.391,0.5,17.647,41,riffle_perfect
0,24,21,2,47,0.511,26,0.553,6,1,0.857,3,2,31,16,13,12,22,0.277,0.255,0.468,17.645,42,riffle_perfect
0,21,21,4,46,0.457,25,0.543,6,2,0.75,4,4,26,20,10,14,22,0.217,0.304,0.478,17.655,43,riffle_perfect
0,18,22,4,44,0.409,22,0.5,4,0,1.0,3,2,28,16,13,13,18,0.295,0.295,0.409,17.634,44,riffle_perfect
0,20,25,2,47,0.426,22,0.468,5,2,0.714,1,3,31,16,9,16,22,0.191,0.34,0.468,17.639,45,riffle_perfect
0,13,28,5,46,0.283,18,0.391,1,3,0.25,2,4,30,16,6,17,23,0.13,0.37,0.5,17.651,46,riffle_perfect
0,24,22,1,47,0.511,25,0.532,2,2,0.5,2,3,32,15,12,10,25,0.255,0.213,0.532,17.643,47,riffle_perfect
0,24,22,3,49,0.49,27,0.551,1,5,0.167,3,3,18,31,10,23,16,0.204,0.469,0.327,17.641,48,riffle_perfect
0,19,24,0,43,0.442,19,0.442,6,2,0.75,2,4,27,16,13,10,20,0.302,0.233,0.465,17.645,49,riffle_perfect
0,19,23,3,45,0.422,22,0.489,3,1,0.75,1,5,27,18,12,13,20,0.267,0.289,0.444,17.642,50,riffle_perfect
0,17,25,4,46,0.37,21,0.457,0,6,0.0,3,2,33,13,5,14,27,0.109,0.304,0.587,17.641,51,riffle_perfect
0,24,21,2,47,0.511,26,0.553,3,4,0.429,3,2,22,25,13,11,23,0.277,0.234,0.489,17.633,52,riffle_perfect
0,23,19,4,46,0.5,27,0.587,1,2,0.333,3,1,34,12,12,13,21,0.261,0.283,0.457,17.644,53,riffle_perfect
0,23,16,7,46,0.5,30,0.652,3,1,0.75,0,3,29,17,12,18,16,0.261,0.391,0.348,17.655,54,riffle_perfect
0,23,17,5,45,0.511,28,0.622,2,3,0.4,3,2,22,23,13,19,13,0.289,0.422,0.289,17.647,55,riffle_perfect
0,17,21,8,46,0.37,25,0.543,3,3,0.5,2,2,33,13,8,11,27,0.174,0.239,0.587,17.646,56,riffle_perfect
0,19,27,0,46,0.413,19,0.413,3,3,0.5,1,2,25,21,15,11,20,0.326,0.239,0.435,17.626,57,riffle_perfect
0,21,18,5,44,0.477,26,0.591,4,0,1.0,2,1,30,14,8,13,23,0.182,0.295,0.523,17.627,58,riffle_perfect
0,23,21,2,46,0.5,25,0.543,3,2,0.6,3,4,28,18,11,20,15,0.239,0.435,0.326,17.637,59,riffle_perfect
0,15,28,3,46,0.326,18,0.391,2,2,0.5,1,2,28,18,9,18,19,0.196,0.391,0.413,17.646,60,riffle_perfect
0,13,26,5,44,0.295,18,0.409,2,0,1.0,1,2,27,17,5,16,23,0.114,0.364,0.523,17.656,61,riffle_perfect
0,18,23,5,46,0.391,23,0.5,5,6,0.455,1,5,27,19,12,11,23,0.261,0.239,0.5,17.658,62,riffle_perfect
0,23,16,5,44,0.523,28,0.636,2,1,0.667,1,3,26,18,13,14,17,0.295,0.318,0.386,17.656,63,riffle_perfect
0,19,20,4,43,0.442,23,0.535,2,1,0.667,1,0,27,16,11,13,19,0.256,0.302,0.442,17.659,64,riffle_perfect
0,18,24,2,44,0.409,20,0.455,3,2,0.6,2,2,27,17,11,12,21,0.25,0.273,0.477,17.657,65,riffle_perfect
0,18,26,1,45,0.4,19,0.422,1,1,0.5,4,4,27,18,10,10,25,0.222,0.222,0.556,17.647,66,riffle_perfect
0,22,24,1,47,0.468,23,0.489,3,3,0.5,3,2,32,15,8,12,27,0.17,0.255,0.574,17.643,67,riffle_perfect
0,18,23,3,44,0.409,21,0.477,2,4,0.333,0,2,22,22,10,19,15,0.227,0.432,0.341,17.645,68,riffle_perfect
0,17,22,8,47,0.362,25,0.532,2,2,0.5,0,6,27,20,12,14,21,0.255,0.298,0.447,17.643,69,riffle_perfect
0,15,26,5,46,0.326,20,0.435,2,3,0.4,0,1,28,18,11,12,23,0.239,0.261,0.5,17.65,70,riffle_perfect
0,26,18,1,45,0.578,27,0.6,2,1,0.667,2,1,26,19,16,11,18,0.356,0.244,0.4,17.657,71,riffle_perfect
0,18,26,2,46,0.391,20,0.435,3,2,0.6,1,3,29,17,7,17,22,0.152,0.37,0.478,17.663,72,riffle_perfect
0,19,24,2,45,0.422,21,0.467,7,1,0.875,1,2,24,21,12,15,18,0.267,0.333,0.4,17.669,73,riffle_perfect
0,21,24,2,47,0.447,23,0.489,4,4,0.5,1,1,24,23,11,17,19,0.234,0.362,0.404,17.667,74,riffle_perfect
0,15,25,3,43,0.349,18,0.419,4,2,0.667,1,3,28,15,6,14,23,0.14,0.326,0.535,17.672,75,riffle_perfect
0,20,22,5,47,0.426,25,0.532,1,1,0.5,4,3,32,15,10,17,20,0.213,0.362,0.426,17.662,76,riffle_perfect
0,20,22,2,44,0.455,22,0.5,2,1,0.667,2,4,25,19,11,13,20,0.25,0.295,0.455,17.657,77,riffle_perfect
0,19,23,5,47,0.404,24,0.511,5,3,0.625,1,5,30,17,15,12,20,0.319,0.255,0.426,17.664,78,riffle_perfect
0,23,22,1,46,0.5,24,0.522,5,1,0.833,3,4,26,20,13,12,21,0.283,0.261,0.457,17.658,79,riffle_perfect
0,20,19,4,43,0.465,24,0.558,4,2,0.667,2,2,25,18,11,14,18,0.256,0.326,0.419,17.667,80,riffle_perfect
0,18,22,7,47,0.383,25,0.532,3,2,0.6,2,3,35,12,9,13,25,0.191,0.277,0.532,17.664,81,riffle_perfect
0,20,23,4,47,0.426,24,0.511,1,4,0.2,1,3,34,13,10,13,24,0.213,0.277,0.511,17.669,82,riffle_perfect
0,20,19,4,43,0.465,24,0.558,2,1,0.667,3,3,20,23,13,12,18,0.302,0.279,0.419,17.673,83,riffle_perfect
0,15,25,5,45,0.333,20,0.444,2,2,0.5,2,4,28,17,8,17,20,0.178,0.378,0.444,17.68,84,riffle_perfect
0,20,27,3,50,0.4,23,0.46,5,3,0.625,2,3,35,15,9,22,19,0.18,0.44,0.38,17.683,85,riffle_perfect
0,21,18,6,45,0.467,27,0.6,3,2,0.6,2,0,27,18,10,13,22,0.222,0.289,0.489,17.687,86,riffle_perfect
0,16,27,2,45,0.356,18,0.4,3,1,0.75,0,1,24,21,10,13,22,0.222,0.289,0.489,17.696,87,riffle_perfect
0,13,29,4,46,0.283,17,0.37,3,2,0.6,0,2,34,12,6,11,29,0.13,0.239,0.63,17.693,88,riffle_perfect
0,19,23,4,46,0.413,23,0.5,1,1,0.5,1,3,31,15,13,14,19,0.283,0.304,0.413,17.7,89,riffle_perfect
0,20,17,8,45,0.444,28,0.622,4,3,0.571,1,2,24,21,10,17,18,0.222,0.378,0.4,17.704,90,riffle_perfect
0,26,12,7,45,0.578,33,0.733,4,2,0.667,2,2,24,21,15,11,19,0.333,0.244,0.422,17.708,91,riffle_perfect
0,17,24,3,44,0.386,20,0.455,4,2,0.667,1,2,25,19,10,16,18,0.227,0.364,0.409,17.707,92,riffle_perfect
0,23,20,2,45,0.511,25,0.556,4,2,0.667,0,1,32,13,14,10,21,0.311,0.222,0.467,17.708,93,riffle_perfect
0,21,23,3,47,0.447,24,0.511,5,2,0.714,5,3,29,18,7,16,24,0.149,0.34,0.511,17.708,94,riffle_perfect
0,20,21,4,45,0.444,24,0.533,3,2,0.6,2,3,28,17,14,13,18,0.311,0.289,0.4,17.713,95,riffle_perfect
0,18,24,4,46,0.391,22,0.478,4,3,0.571,1,1,34,12,8,16,22,0.174,0.348,0.478,17.707,96,riffle_perfect
0,19,21,5,45,0.422,24,0.533,3,4,0.429,5,2,27,18,10,12,23,0.222,0.267,0.511,18.258,1,riffle_perfect
0,21,25,2,48,0.438,23,0.479,1,2,0.333,2,1,30,18,9,17,22,0.188,0.354,0.458,17.869,2,riffle_perfect
0,20,21,3,44,0.455,23,0.523,5,3,0.625,1,5,24,20,13,16,15,0.295,0.364,0.341,17.663,3,riffle_perfect
0,19,20,6,45,0.422,25,0.556,1,0,1.0,4,0,25,20,12,13,20,0.267,0.289,0.444,17.564,4,riffle_perfect
0,16,25,2,43,0.372,18,0.419,3,1,0.75,1,1,29,14,7,15,21,0.163,0.349,0.488,17.43,5,riffle_perfect
0,19,27,2,48,0.396,21,0.438,0,1,0.0,1,5,29,19,7,15,26,0.146,0.312,0.542,17.533,6,riffle_perfect
0,20,25,2,47,0.426,22,0.468,1,1,0.5,1,2,33,14,10,12,25,0.213,0.255,0.532,17.491,7,riffle_perfect
0,23,18,4,45,0.511,27,0.6,4,2,0.667,4,1,27,18,13,15,17,0.289,0.333,0.378,17.488,8,riffle_perfect
0,19,23,4,46,0.413,23,0.5,3,4,0.429,3,2,23,23,13,13,20,0.283,0.283,0.435,17.493,9,riffle_perfect
0,19,26,4,49,0.388,23,0.469,2,5,0.286,1,4,29,20,11,18,20,0.224,0.367,0.408,17.55,10,riffle_perfect
0,20,23,1,44,0.455,21,0.477,5,3,0.625,2,2,25,19,12,13,19,0.273,0.295,0.432,17.563,11,riffle_perfect
0,28,16,2,46,0.609,30,0.652,5,1,0.833,4,4,28,18,14,11,21,0.304,0.239,0.457,17.521,12,riffle_perfect
0,20,18,6,44,0.455,26,0.591,3,1,0.75,5,0,26,18,13,13,18,0.295,0.295,0.409,17.568,13,riffle_perfect
0,16,23,5,44,0.364,21,0.477,3,1,0.75,2,3,24,20,12,11,21,0.273,0.25,0.477,17.539,14,riffle_perfect
0,23,18,5,46,0.5,28,0.609,2,0,1.0,5,2,28,18,8,17,21,0.174,0.37,0.457,17.534,15,riffle_perfect
0,18,22,6,46,0.391,24,0.522,5,3,0.625,1,4,29,17,12,15,19,0.261,0.326,0.413,17.54,16,riffle_perfect
0,17,25,4,46,0.37,21,0.457,4,3,0.571,2,2,29,17,8,16,22,0.174,0.348,0.478,17.549,17,riffle_perfect
0,18,25,4,47,0.383,22,0.468,2,5,0.286,3,2,31,16,5,15,27,0.106,0.319,0.574,17.521,18,riffle_perfect
0,14,25,5,44,0.318,19,0.432,2,3,0.4,5,1,29,15,6,14,24,0.136,0.318,0.545,17.531,19,riffle_perfect
0,17,23,4,44,0.386,21,0.477,1,2,0.333,1,4,27,17,11,13,20,0.25,0.295,0.455,17.573,20,riffle_perfect
0,23,20,4,47,0.489,27,0.574,2,1,0.667,3,4,30,17,14,12,21,0.298,0.255,0.447,17.579,21,riffle_perfect
0,20,24,2,46,0.435,22,0.478,5,2,0.714,0,3,30,16,11,13,22,0.239,0.283,0.478,17.578,22,riffle_perfect
0,16,30,2,48,0.333,18,0.375,1,2,0.333,5,3,32,16,6,14,28,0.125,0.292,0.583,17.559,23,riffle_perfect
0,18,27,3,48,0.375,21,0.438,6,2,0.75,2,5,32,16,10,13,25,0.208,0.271,0.521,17.555,24,riffle_perfect
0,13,29,6,48,0.271,19,0.396,2,6,0.25,1,5,32,16,6,19,23,0.125,0.396,0.479,17.582,25,riffle_perfect
0,14,29,3,46,0.304,17,0.37,4,4,0.5,0,1,26,20,11,20,15,0.239,0.435,0.326,17.607,26,riffle_perfect
0,21,21,3,45,0.467,24,0.533,3,3,0.5,0,0,32,13,14,8,23,0.311,0.178,0.511,17.608,27,riffle_perfect
0,17,21,5,43,0.395,22,0.512,3,1,0.75,2,3,28,15,11,10,22,0.256,0.233,0.512,17.614,28,riffle_perfect
0,27,19,1,47,0.574,28,0.596,3,3,0.5,3,1,28,19,17,10,20,0.362,0.213,0.426,17.611,29,riffle_perfect
0,16,26,3,45,0.356,19,0.422,1,1,0.5,3,3,30,15,9,15,21,0.2,0.333,0.467,17.618,30,riffle_perfect
0,22,16,6,44,0.5,28,0.636,4,3,0.571,3,0,26,18,11,14,19,0.25,0.318,0.432,17.582,31,riffle_perfect
0,20,19,7,46,0.435,27,0.587,1,5,0.167,1,4,28,18,10,14,22,0.217,0.304,0.478,17.578,32,riffle_perfect
0,13,27,7,47,0.277,20,0.426,3,1,0.75,2,4,31,16,8,17,22,0.17,0.362,0.468,17.555,33,riffle_perfect
0,14,26,5,45,0.311,19,0.422,5,4,0.556,1,1,23,22,9,16,20,0.2,0.356,0.444,17.559,34,riffle_perfect
0,22,18,7,47,0.468,29,0.617,1,2,0.333,2,2,30,17,12,15,20,0.255,0.319,0.426,17.551,35,riffle_perfect
0,22,18,4,44,0.5,26,0.591,5,0,1.0,2,2,21,23,14,14,16,0.318,0.318,0.364,17.551,36,riffle_perfect
0,19,23,5,47,0.404,24,0.511,3,5,0.375,3,1,31,16,5,17,25,0.106,0.362,0.532,17.559,37,riffle_perfect
0,24,15,7,46,0.522,31,0.674,3,0,1.0,3,1,25,21,16,12,18,0.348,0.261,0.391,17.556,38,riffle_perfect
0,21,20,2,43,0.488,23,0.535,0,3,0.0,3,0,26,17,15,8,20,0.349,0.186,0.465,17.562,39,riffle_perfect
0,20,22,4,46,0.435,24,0.522,4,0,1.0,2,2,33,13,10,13,23,0.217,0.283,0.5,17.574,40,riffle_perfect
0,23,21,4,48,0.479,27,0.562,0,1,0.0,4,1,30,18,10,16,22,0.208,0.333,0.458,17.566,41,riffle_perfect
0,21,21,2,44,0.477,23,0.523,6,3,0.667,2,2,30,14,11,11,22,0.25,0.25,0.5,17.578,42,riffle_perfect
0,13,29,4,46,0.283,17,0.37,2,2,0.5,0,2,24,22,7,20,19,0.152,0.435,0.413,17.57,43,riffle_perfect
0,15,22,5,42,0.357,20,0.476,0,3,0.0,1,0,31,11,10,8,24,0.238,0.19,0.571,17.555,44,riffle_perfect
0,21,18,6,45,0.467,27,0.6,6,0,1.0,1,2,30,15,9,18,18,0.2,0.4,0.4,17.564,45,riffle_perfect
0,21,19,4,44,0.477,25,0.568,6,1,0.857,2,1,26,18,10,14,20,0.227,0.318,0.455,17.573,46,riffle_perfect
0,21,22,2,45,0.467,23,0.511,4,3,0.571,2,0,30,15,10,14,21,0.222,0.311,0.467,17.567,47,riffle_perfect
0,21,23,1,45,0.467,22,0.489,2,4,0.333,2,2,22,23,9,20,16,0.2,0.444,0.356,17.574,48,riffle_perfect
0,14,27,5,46,0.304,19,0.413,4,3,0.571,1,4,30,16,7,18,21,0.152,0.391,0.457,17.586,49,riffle_perfect
0,17,23,4,44,0.386,21,0.477,2,4,0.333,1,2,29,15,8,13,23,0.182,0.295,0.523,17.584,50,riffle_perfect
0,23,21,2,46,0.5,25,0.543,3,1,0.75,3,2,27,19,9,18,19,0.196,0.391,0.413,17.575,51,riffle_perfect
0,18,20,6,44,0.409,24,0.545,3,1,0.75,2,1,29,15,10,9,25,0.227,0.205,0.568,17.573,52,riffle_perfect
0,16,25,6,47,0.34,22,0.468,1,1,0.5,6,2,32,15,5,16,26,0.106,0.34,0.553,17.567,53,riffle_perfect
0,15,28,3,46,0.326,18,0.391,4,3,0.571,2,1,26,20,7,19,20,0.152,0.413,0.435,17.556,54,riffle_perfect
0,18,30,2,50,0.36,20,0.4,3,2,0.6,3,2,28,22,6,19,25,0.12,0.38,0.5,17.559,55,riffle_perfect
0,23,21,2,46,0.5,25,0.543,3,4,0.429,2,1,24,22,10,19,17,0.217,0.413,0.37,17.568,56,riffle_perfect
0,19,21,5,45,0.422,24,0.533,3,1,0.75,2,1,31,14,5,14,26,0.111,0.311,0.578,17.561,57,riffle_perfect
0,17,26,3,46,0.37,20,0.435,2,3,0.4,3,3,29,17,12,13,21,0.261,0.283,0.457,17.549,58,riffle_perfect
0,27,14,3,44,0.614,30,0.682,6,2,0.75,1,1,23,21,13,20,11,0.295,0.455,0.25,17.556,59,riffle_perfect
0,24,21,2,47,0.511,26,0.553,4,3,0.571,2,1,30,17,10,7,30,0.213,0.149,0.638,17.558,60,riffle_perfect
0,23,16,6,45,0.511,29,0.644,3,1,0.75,4,1,21,24,13,16,16,0.289,0.356,0.356,17.56,61,riffle_perfect
0,17,27,2,46,0.37,19,0.413,1,6,0.143,1,1,26,20,11,17,18,0.239,0.37,0.391,17.566,62,riffle_perfect
0,21,20,2,43,0.488,23,0.535,1,2,0.333,2,1,26,17,13,12,18,0.302,0.279,0.419,17.57,63,riffle_perfect
0,19,20,7,46,0.413,26,0.565,1,4,0.2,2,1,21,25,10,22,14,0.217,0.478,0.304,17.577,64,riffle_perfect
0,17,27,2,46,0.37,19,0.413,3,1,0.75,0,4,26,20,8,15,23,0.174,0.326,0.5,17.586,65,riffle_perfect
0,22,19,4,45,0.489,26,0.578,1,3,0.25,2,0,28,17,12,12,21,0.267,0.267,0.467,17.59,66,riffle_perfect
0,24,19,3,46,0.522,27,0.587,8,2,0.8,2,1,25,21,15,12,19,0.326,0.261,0.413,17.583,67,riffle_perfect
0,16,28,3,47,0.34,19,0.404,1,3,0.25,4,3,30,17,4,16,27,0.085,0.34,0.574,17.575,68,riffle_perfect
0,23,21,3,47,0.489,26,0.553,3,1,0.75,1,2,29,18,14,12,21,0.298,0.255,0.447,17.568,69,riffle_perfect
0,18,21,5,44,0.409,23,0.523,3,1,0.75,1,1,26,18,13,13,18,0.295,0.295,0.409,17.567,70,riffle_perfect
0,13,31,3,47,0.277,16,0.34,2,4,0.333,3,2,28,19,6,21,20,0.128,0.447,0.426,17.566,71,riffle_perfect
0,17,25,3,45,0.378,20,0.444,5,2,0.714,3,1,28,17,8,14,23,0.178,0.311,0.511,17.573,72,riffle_perfect
0,25,13,6,44,0.568,31,0.705,6,0,1.0,2,1,30,14,16,11,17,0.364,0.25,0.386,17.572,73,riffle_perfect
0,17,23,6,46,0.37,23,0.5,1,1,0.5,2,2,29,17,8,18,20,0.174,0.391,0.435,17.588,74,riffle_perfect
0,23,27,0,50,0.46,23,0.46,4,1,0.8,0,3,33,17,15,8,27,0.3,0.16,0.54,17.591,75,riffle_perfect
0,21,23,5,49,0.429,26,0.531,5,2,0.714,3,4,27,22,10,16,23,0.204,0.327,0.469,17.592,76,riffle_perfect
0,17,26,1,44,0.386,18,0.409,2,0,1.0,0,1,26,18,11,17,16,0.25,0.386,0.364,17.598,77,riffle_perfect
0,19,20,6,45,0.422,25,0.556,2,3,0.4,3,1,30,15,10,11,24,0.222,0.244,0.533,17.59,78,riffle_perfect
0,26,16,6,48,0.542,32,0.667,4,1,0.8,3,2,33,15,15,12,21,0.312,0.25,0.438,17.599,79,riffle_perfect
0,20,20,4,44,0.455,24,0.545,4,3,0.571,4,0,26,18,7,16,21,0.159,0.364,0.477,17.605,80,riffle_perfect
0,12,30,4,46,0.261,16,0.348,2,4,0.333,3,2,26,20,6,18,22,0.13,0.391,0.478,17.608,81,riffle_perfect
0,18,23,5,46,0.391,23,0.5,4,1,0.8,1,1,25,21,11,19,16,0.239,0.413,0.348,17.611,82,riffle_perfect
0,19,21,7,47,0.404,26,0.553,3,2,0.6,1,2,32,15,9,16,22,0.191,0.34,0.468,17.617,83,riffle_perfect
0,18,19,7,44,0.409,25,0.568,1,1,0.5,1,2,30,14,12,9,23,0.273,0.205,0.523,17.617,84,riffle_perfect
0,15,27,5,47,0.319,20,0.426,3,2,0.6,2,3,29,18,7,18,22,0.149,0.383,0.468,17.62,85,riffle_perfect
0,24,19,4,47,0.511,28,0.596,4,1,0.8,1,4,29,18,14,11,22,0.298,0.234,0.468,17.623,86,riffle_perfect
0,20,24,1,45,0.444,21,0.467,4,1,0.8,1,2,23,22,14,14,17,0.311,0.311,0.378,17.623,87,riffle_perfect
0,15,26,3,44,0.341,18,0.409,2,4,0.333,4,1,31,13,8,12,24,0.182,0.273,0.545,17.62,88,riffle_perfect
0,15,26,4,45,0.333,19,0.422,1,2,0.333,2,5,30,15,10,13,22,0.222,0.289,0.489,17.614,89,riffle_perfect
0,29,15,4,48,0.604,33,0.688,2,0,1.0,6,1,27,21,13,13,22,0.271,0.271,0.458,17.602,90,riffle_perfect
0,17,28,5,50,0.34,22,0.44,6,5,0.545,2,2,31,19,7,20,23,0.14,0.4,0.46,17.609,91,riffle_perfect
0,21,20,3,44,0.477,24,0.545,5,1,0.833,2,2,28,16,14,12,18,0.318,0.273,0.409,17.606,92,riffle_perfect
0,15,21,11,47,0.319,26,0.553,6,1,0.857,0,2,26,21,10,23,14,0.213,0.489,0.298,17.615,93,riffle_perfect
0,25,16,3,44,0.568,28,0.636,3,0,1.0,3,0,25,19,14,13,17,0.318,0.295,0.386,17.617,94,riffle_perfect
0,22,24,2,48,0.458,24,0.5,3,3,0.5,6,0,30,18,8,18,22,0.167,0.375,0.458,17.617,95,riffle_perfect
0,19,27,2,48,0.396,21,0.438,5,4,0.556,1,1,28,20,7,20,21,0.146,0.417,0.438,17.631,96,riffle_perfect
0,23,22,1,46,0.5,24,0.522,5,3,0.625,2,2,31,15,12,10,24,0.261,0.217,0.522,17.733,1,riffle_perfect
0,22,24,5,51,0.431,27,0.529,6,3,0.667,2,1,33,18,9,17,25,0.176,0.333,0.49,17.571,2,riffle_perfect
0,17,26,1,44,0.386,18,0.409,4,1,0.8,1,3,23,21,10,17,17,0.227,0.386,0.386,17.659,3,riffle_perfect
0,15,28,5,48,0.312,20,0.417,1,3,0.25,2,3,32,16,5,22,21,0.104,0.458,0.438,17.623,4,riffle_perfect
0,20,22,4,46,0.435,24,0.522,8,1,0.889,2,1,24,22,10,18,18,0.217,0.391,0.391,17.589,5,riffle_perfect
0,22,19,6,47,0.468,28,0.596,5,4,0.556,4,4,26,21,14,11,22,0.298,0.234,0.468,17.571,6,riffle_perfect
0,18,20,6,44,0.409,24,0.545,2,2,0.5,1,1,28,16,11,14,19,0.25,0.318,0.432,17.588,7,riffle_perfect
0,23,17,5,45,0.511,28,0.622,2,2,0.5,4,1,25,20,12,14,19,0.267,0.311,0.422,17.517,8,riffle_perfect
0,18,22,5,45,0.4,23,0.511,4,0,1.0,2,2,21,24,9,20,16,0.2,0.444,0.356,17.575,9,riffle_perfect
0,18,25,4,47,0.383,22,0.468,1,1,0.5,3,4,27,20,8,17,22,0.17,0.362,0.468,17.599,10,riffle_perfect
0,22,25,1,48,0.458,23,0.479,7,1,0.875,2,4,29,19,12,15,21,0.25,0.312,0.438,17.601,11,riffle_perfect
0,22,23,3,48,0.458,25,0.521,2,3,0.4,2,0,29,19,11,14,23,0.229,0.292,0.479,17.556,12,riffle_perfect
0,18,24,4,46,0.391,22,0.478,3,1,0.75,3,2,28,18,11,16,19,0.239,0.348,0.413,17.549,13,riffle_perfect
0,18,25,3,46,0.391,21,0.457,3,3,0.5,0,2,31,15,8,16,22,0.174,0.348,0.478,17.596,14,riffle_perfect
0,22,23,2,47,0.468,24,0.511,1,3,0.25,1,2,30,17,12,11,24,0.255,0.234,0.511,17.585,15,riffle_perfect
0,20,23,4,47,0.426,24,0.511,2,1,0.667,2,2,27,20,15,11,21,0.319,0.234,0.447,17.513,16,riffle_perfect
0,30,15,2,47,0.638,32,0.681,9,1,0.9,2,2,23,24,13,14,20,0.277,0.298,0.426,17.511,17,riffle_perfect
0,20,23,3,46,0.435,23,0.5,6,3,0.667,2,2,27,19,11,15,20,0.239,0.326,0.435,17.529,18,riffle_perfect
0,24,17,5,46,0.522,29,0.63,5,3,0.625,2,5,30,16,14,14,18,0.304,0.304,0.391,17.528,19,riffle_perfect
0,19,20,5,44,0.432,24,0.545,3,4,0.429,2,1,31,13,11,13,20,0.25,0.295,0.455,17.552,20,riffle_perfect
0,22,18,5,45,0.489,27,0.6,4,1,0.8,1,3,27,18,12,15,18,0.267,0.333,0.4,17.602,21,riffle_perfect
0,23,17,4,44,0.523,27,0.614,6,3,0.667,4,1,23,21,10,18,16,0.227,0.409,0.364,17.619,22,riffle_perfect
0,17,25,3,45,0.378,20,0.444,2,1,0.667,1,2,21,24,7,23,15,0.156,0.511,0.333,17.628,23,riffle_perfect
0,23,18,3,44,0.523,26,0.591,6,1,0.857,3,2,27,17,14,11,19,0.318,0.25,0.432,17.642,24,riffle_perfect
0,26,17,6,49,0.531,32,0.653,2,3,0.4,2,1,29,20,15,18,16,0.306,0.367,0.327,17.672,25,riffle_perfect
0,19,21,4,44,0.432,23,0.523,0,1,0.0,2,3,24,20,10,15,19,0.227,0.341,0.432,17.69,26,riffle_perfect
0,27,18,4,49,0.551,31,0.633,2,3,0.4,3,1,19,30,13,18,18,0.265,0.367,0.367,17.661,27,riffle_perfect
0,13,23,10,46,0.283,23,0.5,1,4,0.2,5,3,33,13,4,16,26,0.087,0.348,0.565,17.666,28,riffle_perfect
0,21,18,4,43,0.488,25,0.581,5,2,0.714,1,2,25,18,10,15,18,0.233,0.349,0.419,17.689,29,riffle_perfect
0,20,22,4,46,0.435,24,0.522,3,1,0.75,3,1,26,20,11,15,20,0.239,0.326,0.435,17.694,30,riffle_perfect
0,16,23,6,45,0.356,22,0.489,5,3,0.625,2,4,28,17,7,15,23,0.156,0.333,0.511,17.707,31,riffle_perfect
0,20,19,3,42,0.476,23,0.548,5,1,0.833,0,0,26,16,12,14,16,0.286,0.333,0.381,17.716,32,riffle_perfect
0,20,20,3,43,0.465,23,0.535,0,1,0.0,3,0,30,13,10,10,23,0.233,0.233,0.535,17.699,33,riffle_perfect
0,18,22,4,44,0.409,22,0.5,1,1,0.5,1,1,25,19,12,15,17,0.273,0.341,0.386,17.689,34,riffle_perfect
0,22,18,3,43,0.512,25,0.581,2,1,0.667,1,1,24,19,12,14,17,0.279,0.326,0.395,17.708,35,riffle_perfect
0,13,28,4,45,0.289,17,0.378,1,3,0.25,0,2,28,17,10,15,20,0.222,0.333,0.444,17.704,36,riffle_perfect
0,22,20,4,46,0.478,26,0.565,2,2,0.5,2,0,21,25,10,18,18,0.217,0.391,0.391,17.695,37,riffle_perfect
0,19,23,3,45,0.422,22,0.489,4,1,0.8,1,1,29,16,12,12,21,0.267,0.267,0.467,17.703,38,riffle_perfect
0,16,26,6,48,0.333,22,0.458,1,3,0.25,0,2,29,19,7,22,19,0.146,0.458,0.396,17.724,39,riffle_perfect
0,17,24,2,43,0.395,19,0.442,1,1,0.5,0,1,26,17,10,14,19,0.233,0.326,0.442,17.717,40,riffle_perfect
0,22,20,3,45,0.489,25,0.556,1,5,0.167,1,3,29,16,7,19,19,0.156,0.422,0.422,17.71,41,riffle_perfect
0,21,23,4,48,0.438,25,0.521,3,1,0.75,1,3,26,22,12,18,18,0.25,0.375,0.375,17.714,42,riffle_perfect
0,16,23,6,45,0.356,22,0.489,3,3,0.5,5,4,27,18,12,13,20,0.267,0.289,0.444,17.718,43,riffle_perfect
0,17,23,5,45,0.378,22,0.489,3,0,1.0,2,6,33,12,11,8,26,0.244,0.178,0.578,17.696,44,riffle_perfect
0,26,14,5,45,0.578,31,0.689,4,1,0.8,3,4,24,21,16,12,17,0.356,0.267,0.378,17.697,45,riffle_perfect
0,20,23,3,46,0.435,23,0.5,3,3,0.5,2,1,25,21,12,16,18,0.261,0.348,0.391,17.705,46,riffle_perfect
0,14,23,7,44,0.318,21,0.477,3,1,0.75,1,4,26,18,8,14,22,0.182,0.318,0.5,17.706,47,riffle_perfect
0,26,18,0,44,0.591,26,0.591,4,2,0.667,3,3,25,19,15,9,20,0.341,0.205,0.455,17.704,48,riffle_perfect
0,25,18,2,45,0.556,27,0.6,3,1,0.75,2,3,29,16,12,9,24,0.267,0.2,0.533,17.695,49,riffle_perfect
0,20,23,5,48,0.417,25,0.521,1,2,0.333,2,0,27,21,12,17,19,0.25,0.354,0.396,17.698,50,riffle_perfect
0,19,25,1,45,0.422,20,0.444,3,0,1.0,0,2,28,17,10,13,22,0.222,0.289,0.489,17.711,51,riffle_perfect
0,19,24,2,45,0.422,21,0.467,4,2,0.667,2,3,26,19,12,14,19,0.267,0.311,0.422,17.7,52,riffle_perfect
0,22,21,4,47,0.468,26,0.553,6,0,1.0,3,2,29,18,15,11,21,0.319,0.234,0.447,17.704,53,riffle_perfect
0,19,20,7,46,0.413,26,0.565,1,1,0.5,0,1,27,19,9,17,20,0.196,0.37,0.435,17.695,54,riffle_perfect
0,12,28,6,46,0.261,18,0.391,2,1,0.667,1,4,29,17,4,25,17,0.087,0.543,0.37,17.691,55,riffle_perfect
0,17,23,4,44,0.386,21,0.477,3,3,0.5,2,2,26,18,9,14,21,0.205,0.318,0.477,17.671,56,riffle_perfect
0,21,20,4,45,0.467,25,0.556,2,4,0.333,2,2,28,17,11,11,23,0.244,0.244,0.511,17.664,57,riffle_perfect
0,24,20,5,49,0.49,29,0.592,4,1,0.8,3,3,33,16,13,11,25,0.265,0.224,0.51,17.663,58,riffle_perfect
0,19,23,4,46,0.413,23,0.5,5,6,0.455,2,4,26,20,10,16,20,0.217,0.348,0.435,17.669,59,riffle_perfect
0,22,17,5,44,0.5,27,0.614,2,2,0.5,2,0,25,19,13,14,17,0.295,0.318,0.386,17.669,60,riffle_perfect
0,20,23,2,45,0.444,22,0.489,4,2,0.667,0,4,26,19,13,14,18,0.289,0.311,0.4,17.683,61,riffle_perfect
0,13,28,3,44,0.295,16,0.364,1,7,0.125,0,2,23,21,8,19,17,0.182,0.432,0.386,17.692,62,riffle_perfect
0,21,23,3,47,0.447,24,0.511,1,3,0.25,2,2,28,19,14,8,25,0.298,0.17,0.532,17.681,63,riffle_perfect
0,22,19,5,46,0.478,27,0.587,3,1,0.75,0,1,28,18,9,18,19,0.196,0.391,0.413,17.68,64,riffle_perfect
0,17,25,2,44,0.386,19,0.432,2,2,0.5,0,1,23,21,12,14,18,0.273,0.318,0.409,17.674,65,riffle_perfect
0,15,24,4,43,0.349,19,0.442,0,4,0.0,4,3,28,15,9,13,21,0.209,0.302,0.488,17.682,66,riffle_perfect
0,26,18,1,45,0.578,27,0.6,1,0,1.0,1,2,31,14,11,14,20,0.244,0.311,0.444,17.684,67,riffle_perfect
0,21,21,6,48,0.438,27,0.562,3,2,0.6,1,2,32,16,9,13,26,0.188,0.271,0.542,17.686,68,riffle_perfect
0,20,25,2,47,0.426,22,0.468,1,2,0.333,3,1,27,20,11,14,22,0.234,0.298,0.468,17.693,69,riffle_perfect
0,14,26,6,46,0.304,20,0.435,1,2,0.333,3,2,30,16,8,16,22,0.174,0.348,0.478,17.696,70,riffle_perfect
0,17,27,1,45,0.378,18,0.4,1,1,0.5,3,2,24,21,8,17,20,0.178,0.378,0.444,17.685,71,riffle_perfect
0,24,17,6,47,0.511,30,0.638,4,1,0.8,5,6,28,19,11,14,22,0.234,0.298,0.468,17.676,72,riffle_perfect
0,25,16,3,44,0.568,28,0.636,5,3,0.625,1,1,23,21,13,16,15,0.295,0.364,0.341,17.674,73,riffle_perfect
0,21,19,5,45,0.467,26,0.578,4,0,1.0,6,2,26,19,12,12,21,0.267,0.267,0.467,17.669,74,riffle_perfect
0,21,22,3,46,0.457,24,0.522,4,1,0.8,2,4,27,19,15,11,20,0.326,0.239,0.435,17.672,75,riffle_perfect
0,22,22,1,45,0.489,23,0.511,1,2,0.333,3,2,24,21,13,15,17,0.289,0.333,0.378,17.67,76,riffle_perfect
0,15,23,7,45,0.333,22,0.489,3,3,0.5,2,1,27,18,9,17,19,0.2,0.378,0.422,17.667,77,riffle_perfect
0,19,24,1,44,0.432,20,0.455,4,2,0.667,2,2,27,17,10,14,20,0.227,0.318,0.455,17.668,78,riffle_perfect
0,17,20,8,45,0.378,25,0.556,6,1,0.857,0,2,22,23,14,16,15,0.311,0.356,0.333,17.673,79,riffle_perfect
0,20,20,4,44,0.455,24,0.545,1,1,0.5,2,2,28,16,10,16,18,0.227,0.364,0.409,17.673,80,riffle_perfect
0,20,23,4,47,0.426,24,0.511,2,2,0.5,4,0,28,19,9,12,26,0.191,0.255,0.553,17.664,81,riffle_perfect
0,20,18,9,47,0.426,29,0.617,1,4,0.2,4,0,25,22,7,16,24,0.149,0.34,0.511,17.662,82,riffle_perfect
0,17,26,3,46,0.37,20,0.435,2,1,0.667,1,1,30,16,6,16,24,0.13,0.348,0.522,17.667,83,riffle_perfect
0,14,26,3,43,0.326,17,0.395,2,0,1.0,1,2,29,14,7,14,22,0.163,0.326,0.512,17.662,84,riffle_perfect
0,17,23,5,45,0.378,22,0.489,4,3,0.571,2,3,27,18,7,18,20,0.156,0.4,0.444,17.671,85,riffle_perfect
0,28,17,0,45,0.622,28,0.622,5,1,0.833,3,1,27,18,14,8,23,0.311,0.178,0.511,17.663,86,riffle_perfect
0,24,21,3,48,0.5,27,0.562,6,5,0.545,2,3,31,17,6,20,22,0.125,0.417,0.458,17.665,87,riffle_perfect
0,21,19,6,46,0.457,27,0.587,4,3,0.571,2,2,33,13,8,17,21,0.174,0.37,0.457,17.67,88,riffle_perfect
0,21,22,4,47,0.447,25,0.532,3,5,0.375,2,2,25,22,9,18,20,0.191,0.383,0.426,17.664,89,riffle_perfect
0,16,26,3,45,0.356,19,0.422,2,2,0.5,3,4,25,20,8,13,24,0.178,0.289,0.533,17.656,90,riffle_perfect
0,18,19,7,44,0.409,25,0.568,3,3,0.5,1,3,26,18,15,16,13,0.341,0.364,0.295,17.659,91,riffle_perfect
0,25,21,1,47,0.532,26,0.553,5,2,0.714,0,3,30,17,14,10,23,0.298,0.213,0.489,17.655,92,riffle_perfect
0,17,30,2,49,0.347,19,0.388,3,4,0.429,2,1,27,22,8,16,25,0.163,0.327,0.51,17.655,93,riffle_perfect
0,19,23,6,48,0.396,25,0.521,1,2,0.333,1,1,26,22,7,19,22,0.146,0.396,0.458,17.666,94,riffle_perfect
0,21,17,6,44,0.477,27,0.614,2,4,0.333,2,1,30,14,9,11,24,0.205,0.25,0.545,17.669,95,riffle_perfect
0,23,22,1,46,0.5,24,0.522,2,2,0.5,3,3,30,16,10,15,21,0.217,0.326,0.457,17.668,96,riffle_perfect
0,20,23,1,44,0.455,21,0.477,2,4,0.333,2,2,21,23,12,16,16,0.273,0.364,0.364,17.31,1,riffle_perfect
0,20,22,2,44,0.455,22,0.5,2,0,1.0,4,1,29,15,11,11,22,0.25,0.25,0.5,17.035,2,riffle_perfect
0,19,19,7,45,0.422,26,0.578,4,3,0.571,4,4,30,15,10,12,23,0.222,0.267,0.511,17.093,3,riffle_perfect
0,28,15,3,46,0.609,31,0.674,6,3,0.667,5,0,22,24,16,15,15,0.348,0.326,0.326,16.973,4,riffle_perfect
0,15,29,2,46,0.326,17,0.37,4,3,0.571,2,2,35,11,3,14,29,0.065,0.304,0.63,16.973,5,riffle_perfect
0,25,17,1,43,0.581,26,0.605,7,1,0.875,3,2,26,17,11,13,19,0.256,0.302,0.442,17.062,6,riffle_perfect
0,22,22,2,46,0.478,24,0.522,4,3,0.571,1,2,26,20,9,20,17,0.196,0.435,0.37,17.208,7,riffle_perfect
0,26,17,6,49,0.531,32,0.653,6,3,0.667,2,0,27,22,16,15,18,0.327,0.306,0.367,17.256,8,riffle_perfect
0,19,21,4,44,0.432,23,0.523,4,2,0.667,2,4,24,20,11,13,20,0.25,0.295,0.455,17.308,9,riffle_perfect
0,26,21,0,47,0.553,26,0.553,3,2,0.6,2,3,30,17,12,12,23,0.255,0.255,0.489,17.34,10,riffle_perfect
0,21,27,3,51,0.412,24,0.471,2,0,1.0,2,3,26,25,13,18,20,0.255,0.353,0.392,17.353,11,riffle_perfect
0,18,26,2,46,0.391,20,0.435,3,5,0.375,1,2,29,17,8,13,25,0.174,0.283,0.543,17.369,12,riffle_perfect
0,26,23,2,51,0.51,28,0.549,7,2,0.778,2,2,21,30,14,17,20,0.275,0.333,0.392,17.383,13,riffle_perfect
0,19,23,4,46,0.413,23,0.5,3,1,0.75,3,3,28,18,10,15,21,0.217,0.326,0.457,17.376,14,riffle_perfect
0,21,19,5,45,0.467,26,0.578,5,3,0.625,1,3,25,20,7,20,18,0.156,0.444,0.4,17.416,15,riffle_perfect
0,23,16,7,46,0.5,30,0.652,1,2,0.333,3,2,31,15,13,13,20,0.283,0.283,0.435,17.436,16,riffle_perfect
0,23,16,8,47,0.489,31,0.66,3,3,0.5,1,3,30,17,13,14,20,0.277,0.298,0.426,17.477,17,riffle_perfect
0,16,24,4,44,0.364,20,0.455,3,4,0.429,3,1,24,20,10,16,18,0.227,0.364,0.409,17.455,18,riffle_perfect
0,16,22,8,46,0.348,24,0.522,0,3,0.0,0,1,30,16,8,17,21,0.174,0.37,0.457,17.474,19,riffle_perfect
0,23,18,3,44,0.523,26,0.591,3,1,0.75,3,5,29,15,17,10,17,0.386,0.227,0.386,17.458,20,riffle_perfect
0,24,18,5,47,0.511,29,0.617,8,0,1.0,1,4,31,16,12,12,23,0.255,0.255,0.489,17.47,21,riffle_perfect
0,18,23,4,45,0.4,22,0.489,2,6,0.25,1,3,27,18,11,13,21,0.244,0.289,0.467,17.492,22,riffle_perfect
0,23,23,1,47,0.489,24,0.511,2,4,0.333,2,4,31,16,13,12,22,0.277,0.255,0.468,17.463,23,riffle_perfect
0,24,19,2,45,0.533,26,0.578,6,0,1.0,3,2,27,18,15,11,19,0.333,0.244,0.422,17.459,24,riffle_perfect
0,20,18,6,44,0.455,26,0.591,2,1,0.667,1,0,18,26,14,17,13,0.318,0.386,0.295,17.486,25,riffle_perfect
0,16,23,5,44,0.364,21,0.477,6,3,0.667,1,5,25,19,11,13,20,0.25,0.295,0.455,17.5,26,riffle_perfect
0,23,21,5,49,0.469,28,0.571,2,3,0.4,3,0,28,21,11,21,17,0.224,0.429,0.347,17.516,27,riffle_perfect
0,18,25,6,49,0.367,24,0.49,4,1,0.8,3,3,31,18,8,17,24,0.163,0.347,0.49,17.489,28,riffle_perfect
0,20,24,1,45,0.444,21,0.467,1,3,0.25,0,1,28,17,10,14,21,0.222,0.311,0.467,17.531,29,riffle_perfect
0,19,22,3,44,0.432,22,0.5,1,1,0.5,0,5,31,13,11,13,20,0.25,0.295,0.455,17.547,30,riffle_perfect
0,19,21,5,45,0.422,24,0.533,6,2,0.75,1,3,29,16,10,11,24,0.222,0.244,0.533,17.557,31,riffle_perfect
0,15,27,4,46,0.326,19,0.413,1,3,0.25,2,3,31,15,7,14,25,0.152,0.304,0.543,17.568,32,riffle_perfect
0,23,18,4,45,0.511,27,0.6,4,1,0.8,3,1,25,20,10,17,18,0.222,0.378,0.4,17.556,33,riffle_perfect
0,16,26,4,46,0.348,20,0.435,1,1,0.5,3,2,26,20,6,15,25,0.13,0.326,0.543,17.548,34,riffle_perfect
0,23,19,2,44,0.523,25,0.568,2,2,0.5,3,2,28,16,13,12,19,0.295,0.273,0.432,17.539,35,riffle_perfect
0,19,23,1,43,0.442,20,0.465,6,3,0.667,3,2,25,18,11,13,19,0.256,0.302,0.442,17.547,36,riffle_perfect
0,20,18,6,44,0.455,26,0.591,4,4,0.5,0,4,29,15,11,14,19,0.25,0.318,0.432,17.574,37,riffle_perfect
0,21,22,7,50,0.42,28,0.56,5,5,0.5,3,0,29,21,10,16,24,0.2,0.32,0.48,17.589,38,riffle_perfect
0,18,28,1,47,0.383,19,0.404,2,2,0.5,2,4,29,18,8,12,27,0.17,0.255,0.574,17.585,39,riffle_perfect
0,16,26,4,46,0.348,20,0.435,1,3,0.25,3,3,22,24,9,19,18,0.196,0.413,0.391,17.574,40,riffle_perfect
0,20,25,0,45,0.444,20,0.444,2,2,0.5,0,4,29,16,10,15,20,0.222,0.333,0.444,17.583,41,riffle_perfect
0,27,18,0,45,0.6,27,0.6,4,1,0.8,2,3,30,15,12,12,21,0.267,0.267,0.467,17.573,42,riffle_perfect
0,18,23,3,44,0.409,21,0.477,8,3,0.727,1,2,28,16,5,17,22,0.114,0.386,0.5,17.587,43,riffle_perfect
0,23,15,8,46,0.5,31,0.674,4,4,0.5,3,0,29,17,14,14,18,0.304,0.304,0.391,17.59,44,riffle_perfect
0,14,28,2,44,0.318,16,0.364,3,2,0.6,2,1,30,14,9,13,22,0.205,0.295,0.5,17.599,45,riffle_perfect
0,22,20,2,44,0.5,24,0.545,4,1,0.8,2,2,26,18,15,11,18,0.341,0.25,0.409,17.583,46,riffle_perfect
0,14,23,8,45,0.311,22,0.489,3,3,0.5,2,1,25,20,8,16,21,0.178,0.356,0.467,17.589,47,riffle_perfect
0,18,27,4,49,0.367,22,0.449,0,3,0.0,2,3,35,14,9,12,28,0.184,0.245,0.571,17.589,48,riffle_perfect
0,23,18,5,46,0.5,28,0.609,2,2,0.5,3,1,21,25,15,16,15,0.326,0.348,0.326,17.585,49,riffle_perfect
0,21,23,2,46,0.457,23,0.5,6,0,1.0,0,2,29,17,10,16,20,0.217,0.348,0.435,17.58,50,riffle_perfect
0,13,32,3,48,0.271,16,0.333,3,1,0.75,3,0,30,18,7,18,23,0.146,0.375,0.479,17.589,51,riffle_perfect
0,17,23,4,44,0.386,21,0.477,2,2,0.5,3,1,28,16,10,15,19,0.227,0.341,0.432,17.595,52,riffle_perfect
0,16,27,6,49,0.327,22,0.449,1,5,0.167,1,0,31,18,11,18,20,0.224,0.367,0.408,17.607,53,riffle_perfect
0,19,25,3,47,0.404,22,0.468,3,3,0.5,3,2,32,15,8,12,27,0.17,0.255,0.574,17.615,54,riffle_perfect
0,14,23,9,46,0.304,23,0.5,2,3,0.4,1,1,21,25,11,17,18,0.239,0.37,0.391,17.63,55,riffle_perfect
0,24,17,5,46,0.522,29,0.63,6,1,0.857,3,3,28,18,15,15,16,0.326,0.326,0.348,17.632,56,riffle_perfect
0,24,19,3,46,0.522,27,0.587,6,0,1.0,0,3,27,19,15,12,19,0.326,0.261,0.413,17.628,57,riffle_perfect
0,17,23,4,44,0.386,21,0.477,2,3,0.4,2,3,25,19,9,12,23,0.205,0.273,0.523,17.623,58,riffle_perfect
0,26,15,2,43,0.605,28,0.651,4,1,0.8,4,2,27,16,17,9,17,0.395,0.209,0.395,17.63,59,riffle_perfect
0,18,23,3,44,0.409,21,0.477,3,2,0.6,1,0,29,15,12,14,18,0.273,0.318,0.409,17.631,60,riffle_perfect
0,20,23,4,47,0.426,24,0.511,3,5,0.375,2,4,32,15,9,16,22,0.191,0.34,0.468,17.63,61,riffle_perfect
0,15,29,1,45,0.333,16,0.356,2,4,0.333,2,3,32,13,7,12,26,0.156,0.267,0.578,17.64,62,riffle_perfect
0,18,26,4,48,0.375,22,0.458,5,2,0.714,0,1,25,23,12,20,16,0.25,0.417,0.333,17.652,63,riffle_perfect
0,16,24,5,45,0.356,21,0.467,3,0,1.0,2,2,29,16,8,13,24,0.178,0.289,0.533,17.656,64,riffle_perfect
0,23,17,4,44,0.523,27,0.614,7,1,0.875,0,0,30,14,14,10,20,0.318,0.227,0.455,17.653,65,riffle_perfect
0,18,24,4,46,0.391,22,0.478,2,1,0.667,1,0,25,21,7,18,21,0.152,0.391,0.457,17.66,66,riffle_perfect
0,19,24,3,46,0.413,22,0.478,4,3,0.571,0,3,25,21,14,13,19,0.304,0.283,0.413,17.664,67,riffle_perfect
0,17,22,5,44,0.386,22,0.5,1,2,0.333,2,0,26,18,8,15,21,0.182,0.341,0.477,17.667,68,riffle_perfect
0,20,25,4,49,0.408,24,0.49,8,2,0.8,1,2,36,13,9,19,21,0.184,0.388,0.429,17.68,69,riffle_perfect
0,24,18,3,45,0.533,27,0.6,1,1,0.5,3,2,31,14,13,12,20,0.289,0.267,0.444,17.682,70,riffle_perfect
0,20,22,1,43,0.465,21,0.488,1,1,0.5,2,0,30,13,12,9,22,0.279,0.209,0.512,17.683,71,riffle_perfect
0,19,23,4,46,0.413,23,0.5,2,0,1.0,6,4,28,18,11,15,20,0.239,0.326,0.435,17.663,72,riffle_perfect
0,16,20,8,44,0.364,24,0.545,2,2,0.5,1,2,26,18,9,17,18,0.205,0.386,0.409,17.669,73,riffle_perfect
0,17,22,8,47,0.362,25,0.532,7,1,0.875,2,1,31,16,9,15,23,0.191,0.319,0.489,17.665,74,riffle_perfect
0,23,20,3,46,0.5,26,0.565,0,2,0.0,3,4,28,18,13,11,22,0.283,0.239,0.478,17.662,75,riffle_perfect
0,25,16,4,45,0.556,29,0.644,6,0,1.0,2,1,26,19,15,15,15,0.333,0.333,0.333,17.67,76,riffle_perfect
0,20,18,6,44,0.455,26,0.591,5,1,0.833,1,1,24,20,9,16,19,0.205,0.364,0.432,17.674,77,riffle_perfect
0,20,20,5,45,0.444,25,0.556,3,1,0.75,2,4,35,10,8,11,26,0.178,0.244,0.578,17.675,78,riffle_perfect
0,20,23,3,46,0.435,23,0.5,3,4,0.429,2,1,28,18,11,15,20,0.239,0.326,0.435,17.674,79,riffle_perfect
0,21,20,4,45,0.467,25,0.556,4,1,0.8,0,1,24,21,12,16,17,0.267,0.356,0.378,17.685,80,riffle_perfect
0,22,21,2,45,0.489,24,0.533,4,1,0.8,0,4,28,17,12,10,23,0.267,0.222,0.511,17.687,81,riffle_perfect
0,24,22,1,47,0.511,25,0.532,2,3,0.4,4,3,26,21,9,14,24,0.191,0.298,0.511,17.69,82,riffle_perfect
0,26,16,2,44,0.591,28,0.636,3,0,1.0,5,1,29,15,12,9,23,0.273,0.205,0.523,17.69,83,riffle_perfect
0,23,23,1,47,0.489,24,0.511,5,6,0.455,5,1,21,26,13,15,19,0.277,0.319,0.404,17.684,84,riffle_perfect
0,26,20,0,46,0.565,26,0.565,4,1,0.8,3,1,28,18,12,14,20,0.261,0.304,0.435,17.687,85,riffle_perfect
0,20,18,6,44,0.455,26,0.591,2,4,0.333,3,1,23,21,12,14,18,0.273,0.318,0.409,17.694,86,riffle_perfect
0,16,28,1,45,0.356,17,0.378,0,4,0.0,1,1,25,20,10,16,19,0.222,0.356,0.422,17.697,87,riffle_perfect
0,18,20,7,45,0.4,25,0.556,5,0,1.0,1,4,28,17,10,12,23,0.222,0.267,0.511,17.695,88,riffle_perfect
0,20,20,3,43,0.465,23,0.535,3,5,0.375,1,1,32,11,15,8,20,0.349,0.186,0.465,17.692,89,riffle_perfect
0,21,19,4,44,0.477,25,0.568,3,0,1.0,3,2,29,15,9,15,20,0.205,0.341,0.455,17.691,90,riffle_perfect
0,18,27,2,47,0.383,20,0.426,4,2,0.667,0,1,30,17,11,16,20,0.234,0.34,0.426,17.688,91,riffle_perfect
0,17,22,4,43,0.395,21,0.488,4,2,0.667,2,3,33,10,11,11,21,0.256,0.256,0.488,17.686,92,riffle_perfect
0,16,26,2,44,0.364,18,0.409,3,5,0.375,2,1,25,19,8,19,17,0.182,0.432,0.386,17.69,93,riffle_perfect
0,16,22,4,42,0.381,20,0.476,3,1,0.75,2,2,23,19,9,17,16,0.214,0.405,0.381,17.69,94,riffle_perfect
0,24,17,3,44,0.545,27,0.614,3,0,1.0,1,1,27,17,10,16,18,0.227,0.364,0.409,17.689,95,riffle_perfect
0,20,22,3,45,0.444,23,0.511,2,1,0.667,2,1,32,13,9,12,24,0.2,0.267,0.533,17.692,96,riffle_perfect
0,16,25,4,45,0.356,20,0.444,3,0,1.0,0,3,32,13,10,10,25,0.222,0.222,0.556,17.414,1,riffle_perfect
0,18,24,2,44,0.409,20,0.455,2,0,1.0,0,2,22,22,12,15,17,0.273,0.341,0.386,17.185,2,riffle_perfect
0,24,17,4,45,0.533,28,0.622,7,0,1.0,0,2,31,14,17,12,16,0.378,0.267,0.356,17.263,3,riffle_perfect
0,19,17,6,42,0.452,25,0.595,1,2,0.333,1,2,26,16,13,12,17,0.31,0.286,0.405,17.172,4,riffle_perfect
0,18,28,4,50,0.36,22,0.44,7,3,0.7,1,4,23,27,12,20,18,0.24,0.4,0.36,17.43,5,riffle_perfect
0,17,26,2,45,0.378,19,0.422,0,1,0.0,0,2,28,17,11,10,24,0.244,0.222,0.533,17.443,6,riffle_perfect
0,19,23,3,45,0.422,22,0.489,5,2,0.714,2,0,28,17,12,10,23,0.267,0.222,0.511,17.429,7,riffle_perfect
0,24,16,4,44,0.545,28,0.636,7,2,0.778,2,2,24,20,11,16,17,0.25,0.364,0.386,17.539,8,riffle_perfect
0,21,25,1,47,0.447,22,0.468,3,4,0.429,6,1,25,22,10,15,22,0.213,0.319,0.468,17.466,9,riffle_perfect
0,18,21,9,48,0.375,27,0.562,4,3,0.571,4,2,29,19,6,21,21,0.125,0.438,0.438,17.563,10,riffle_perfect
0,21,18,4,43,0.488,25,0.581,5,2,0.714,2,4,26,17,12,11,20,0.279,0.256,0.465,17.457,11,riffle_perfect
0,20,22,2,44,0.455,22,0.5,3,3,0.5,0,4,25,19,11,14,19,0.25,0.318,0.432,17.512,12,riffle_perfect
0,13,32,3,48,0.271,16,0.333,1,1,0.5,3,4,34,14,7,13,28,0.146,0.271,0.583,17.554,13,riffle_perfect
0,20,19,5,44,0.455,25,0.568,2,2,0.5,2,1,25,19,12,14,18,0.273,0.318,0.409,17.545,14,riffle_perfect
0,18,25,1,44,0.409,19,0.432,3,6,0.333,2,0,26,18,9,15,20,0.205,0.341,0.455,17.558,15,riffle_perfect
0,15,25,5,45,0.333,20,0.444,5,1,0.833,2,1,23,22,11,18,16,0.244,0.4,0.356,17.635,16,riffle_perfect
0,20,21,5,46,0.435,25,0.543,1,1,0.5,1,1,28,18,9,17,20,0.196,0.37,0.435,17.647,17,riffle_perfect
0,24,17,4,45,0.533,28,0.622,3,2,0.6,5,0,26,19,12,13,20,0.267,0.289,0.444,17.618,18,riffle_perfect
0,17,24,2,43,0.395,19,0.442,1,1,0.5,2,1,29,14,7,16,20,0.163,0.372,0.465,17.644,19,riffle_perfect
0,17,27,3,47,0.362,20,0.426,1,2,0.333,2,1,32,15,10,16,21,0.213,0.34,0.447,17.663,20,riffle_perfect
0,19,22,4,45,0.422,23,0.511,3,3,0.5,3,3,30,15,7,17,21,0.156,0.378,0.467,17.653,21,riffle_perfect
0,22,20,4,46,0.478,26,0.565,2,2,0.5,3,1,24,22,13,13,20,0.283,0.283,0.435,17.668,22,riffle_perfect
0,19,24,2,45,0.422,21,0.467,3,3,0.5,1,2,29,16,8,17,20,0.178,0.378,0.444,17.644,23,riffle_perfect
0,20,16,6,42,0.476,26,0.619,3,0,1.0,3,1,33,9,12,11,19,0.286,0.262,0.452,17.666,24,riffle_perfect
0,23,20,4,47,0.489,27,0.574,2,1,0.667,1,2,29,18,15,12,20,0.319,0.255,0.426,17.686,25,riffle_perfect
0,23,16,5,44,0.523,28,0.636,6,2,0.75,3,2,27,17,13,13,18,0.295,0.295,0.409,17.676,26,riffle_perfect
0,22,17,6,45,0.489,28,0.622,1,1,0.5,2,0,27,18,14,13,18,0.311,0.289,0.4,17.669,27,riffle_perfect
0,25,14,5,44,0.568,30,0.682,2,3,0.4,3,2,20,24,12,16,16,0.273,0.364,0.364,17.671,28,riffle_perfect
0,17,19,7,43,0.395,24,0.558,2,1,0.667,1,1,25,18,9,17,17,0.209,0.395,0.395,17.672,29,riffle_perfect
0,19,23,4,46,0.413,23,0.5,3,2,0.6,2,2,29,17,7,13,26,0.152,0.283,0.565,17.638,30,riffle_perfect
0,21,23,1,45,0.467,22,0.489,5,1,0.833,1,4,27,18,15,12,18,0.333,0.267,0.4,17.635,31,riffle_perfect
0,21,18,6,45,0.467,27,0.6,3,2,0.6,1,3,28,17,9,14,22,0.2,0.311,0.489,17.647,32,riffle_perfect
0,19,25,1,45,0.422,20,0.444,1,3,0.25,3,2,28,17,5,21,19,0.111,0.467,0.422,17.646,33,riffle_perfect
0,18,25,3,46,0.391,21,0.457,1,5,0.167,2,4,31,15,13,9,24,0.283,0.196,0.522,17.651,34,riffle_perfect
0,25,18,2,45,0.556,27,0.6,5,1,0.833,4,2,23,22,12,18,15,0.267,0.4,0.333,17.643,35,riffle_perfect
0,17,22,5,44,0.386,22,0.5,6,1,0.857,3,1,29,15,9,11,24,0.205,0.25,0.545,17.644,36,riffle_perfect
0,22,18,4,44,0.5,26,0.591,2,1,0.667,3,2,30,14,13,10,21,0.295,0.227,0.477,17.642,37,riffle_perfect
0,20,23,3,46,0.435,23,0.5,5,2,0.714,3,1,23,23,13,15,18,0.283,0.326,0.391,17.663,38,riffle_perfect
0,26,18,3,47,0.553,29,0.617,1,3,0.25,4,1,25,22,15,16,16,0.319,0.34,0.34,17.662,39,riffle_perfect
0,22,19,3,44,0.5,25,0.568,1,1,0.5,2,3,27,17,11,15,18,0.25,0.341,0.409,17.673,40,riffle_perfect
0,19,24,3,46,0.413,22,0.478,2,2,0.5,3,2,35,11,6,11,29,0.13,0.239,0.63,17.67,41,riffle_perfect
0,21,25,0,46,0.457,21,0.457,4,1,0.8,2,2,28,18,15,12,19,0.326,0.261,0.413,17.662,42,riffle_perfect
0,20,22,4,46,0.435,24,0.522,3,4,0.429,4,3,25,21,12,13,21,0.261,0.283,0.457,17.648,43,riffle_perfect
0,18,22,5,45,0.4,23,0.511,5,0,1.0,3,3,33,12,5,13,27,0.111,0.289,0.6,17.631,44,riffle_perfect
0,24,22,0,46,0.522,24,0.522,6,3,0.667,3,2,30,16,14,10,22,0.304,0.217,0.478,17.626,45,riffle_perfect
0,18,21,6,45,0.4,24,0.533,4,1,0.8,2,2,31,14,9,14,22,0.2,0.311,0.489,17.622,46,riffle_perfect
0,18,20,7,45,0.4,25,0.556,3,1,0.75,4,4,29,16,8,18,19,0.178,0.4,0.422,17.625,47,riffle_perfect
0,24,21,2,47,0.511,26,0.553,2,2,0.5,4,2,32,15,6,16,25,0.128,0.34,0.532,17.604,48,riffle_perfect
0,13,31,2,46,0.283,15,0.326,1,2,0.333,0,3,31,15,6,15,25,0.13,0.326,0.543,17.609,49,riffle_perfect
0,19,24,4,47,0.404,23,0.489,3,4,0.429,2,1,22,25,13,15,19,0.277,0.319,0.404,17.601,50,riffle_perfect
0,18,21,7,46,0.391,25,0.543,2,4,0.333,2,3,26,20,8,21,17,0.174,0.457,0.37,17.607,51,riffle_perfect
0,20,20,3,43,0.465,23,0.535,3,1,0.75,2,2,26,17,10,17,16,0.233,0.395,0.372,17.608,52,riffle_perfect
0,16,25,5,46,0.348,21,0.457,0,5,0.0,4,3,34,12,7,13,26,0.152,0.283,0.565,17.607,53,riffle_perfect
0,22,17,7,46,0.478,29,0.63,3,1,0.75,3,2,28,18,14,13,19,0.304,0.283,0.413,17.608,54,riffle_perfect
0,22,21,3,46,0.478,25,0.543,6,3,0.667,1,2,25,21,13,15,18,0.283,0.326,0.391,17.606,55,riffle_perfect
0,21,19,6,46,0.457,27,0.587,4,3,0.571,2,3,26,20,13,15,18,0.283,0.326,0.391,17.607,56,riffle_perfect
0,24,17,4,45,0.533,28,0.622,4,3,0.571,3,2,26,19,13,11,21,0.289,0.244,0.467,17.608,57,riffle_perfect
0,19,19,7,45,0.422,26,0.578,2,0,1.0,2,3,28,17,11,13,21,0.244,0.289,0.467,17.606,58,riffle_perfect
0,13,29,4,46,0.283,17,0.37,1,2,0.333,4,2,35,11,7,10,29,0.152,0.217,0.63,17.615,59,riffle_perfect
0,21,24,5,50,0.42,26,0.52,3,2,0.6,0,3,28,22,10,20,20,0.2,0.4,0.4,17.616,60,riffle_perfect
0,19,21,5,45,0.422,24,0.533,2,1,0.667,3,3,32,13,6,15,24,0.133,0.333,0.533,17.625,61,riffle_perfect
0,23,23,1,47,0.489,24,0.511,3,1,0.75,2,4,27,20,16,13,18,0.34,0.277,0.383,17.618,62,riffle_perfect
0,23,19,4,46,0.5,27,0.587,0,1,0.0,3,2,27,19,12,13,21,0.261,0.283,0.457,17.624,63,riffle_perfect
0,20,21,3,44,0.455,23,0.523,3,2,0.6,3,2,28,16,10,15,19,0.227,0.341,0.432,17.627,64,riffle_perfect
0,21,18,3,42,0.5,24,0.571,3,1,0.75,4,0,24,18,11,13,18,0.262,0.31,0.429,17.637,65,riffle_perfect
0,22,16,6,44,0.5,28,0.636,5,3,0.625,2,0,27,17,9,16,19,0.205,0.364,0.432,17.639,66,riffle_perfect
0,18,26,3,47,0.383,21,0.447,0,2,0.0,4,3,29,18,9,15,23,0.191,0.319,0.489,17.627,67,riffle_perfect
0,28,10,4,42,0.667,32,0.762,7,2,0.778,1,1,29,13,15,12,15,0.357,0.286,0.357,17.629,68,riffle_perfect
0,17,24,4,45,0.378,21,0.467,4,4,0.5,1,2,27,18,8,15,22,0.178,0.333,0.489,17.635,69,riffle_perfect
0,16,25,4,45,0.356,20,0.444,3,5,0.375,4,3,23,22,6,18,21,0.133,0.4,0.467,17.631,70,riffle_perfect
0,18,21,5,44,0.409,23,0.523,2,0,1.0,3,2,32,12,9,13,22,0.205,0.295,0.5,17.63,71,riffle_perfect
0,24,20,6,50,0.48,30,0.6,2,1,0.667,1,3,28,22,14,13,23,0.28,0.26,0.46,17.628,72,riffle_perfect
0,20,22,1,43,0.465,21,0.488,4,4,0.5,0,2,25,18,14,13,16,0.326,0.302,0.372,17.628,73,riffle_perfect
0,20,23,2,45,0.444,22,0.489,5,1,0.833,2,4,25,20,12,12,21,0.267,0.267,0.467,17.621,74,riffle_perfect
0,18,20,5,43,0.419,23,0.535,4,0,1.0,1,2,29,14,10,14,19,0.233,0.326,0.442,17.631,75,riffle_perfect
0,20,20,5,45,0.444,25,0.556,2,0,1.0,3,4,22,23,12,19,14,0.267,0.422,0.311,17.637,76,riffle_perfect
0,29,16,3,48,0.604,32,0.667,3,1,0.75,2,1,27,21,17,15,16,0.354,0.312,0.333,17.64,77,riffle_perfect
0,23,22,1,46,0.5,24,0.522,4,4,0.5,1,3,33,13,10,13,23,0.217,0.283,0.5,17.637,78,riffle_perfect
0,19,21,5,45,0.422,24,0.533,6,1,0.857,0,1,24,21,10,16,19,0.222,0.356,0.422,17.646,79,riffle_perfect
0,22,22,2,46,0.478,24,0.522,2,3,0.4,3,4,27,19,10,20,16,0.217,0.435,0.348,17.649,80,riffle_perfect
0,22,19,3,44,0.5,25,0.568,4,3,0.571,2,0,31,13,11,8,25,0.25,0.182,0.568,17.654,81,riffle_perfect
0,11,32,3,46,0.239,14,0.304,2,5,0.286,0,1,25,21,5,22,19,0.109,0.478,0.413,17.661,82,riffle_perfect
0,19,19,6,44,0.432,25,0.568,1,0,1.0,6,2,28,16,8,16,20,0.182,0.364,0.455,17.67,83,riffle_perfect
0,22,20,4,46,0.478,26,0.565,2,1,0.667,4,2,29,17,9,15,22,0.196,0.326,0.478,17.67,84,riffle_perfect
0,17,23,4,44,0.386,21,0.477,4,1,0.8,2,2,26,18,10,12,22,0.227,0.273,0.5,17.676,85,riffle_perfect
0,26,16,4,46,0.565,30,0.652,2,1,0.667,2,1,25,21,14,14,18,0.304,0.304,0.391,17.682,86,riffle_perfect
0,20,20,5,45,0.444,25,0.556,1,3,0.25,2,2,26,19,12,12,21,0.267,0.267,0.467,17.683,87,riffle_perfect
0,19,25,4,48,0.396,23,0.479,1,1,0.5,1,3,28,20,13,15,20,0.271,0.312,0.417,17.675,88,riffle_perfect
0,19,23,3,45,0.422,22,0.489,3,3,0.5,3,2,28,17,11,15,19,0.244,0.333,0.422,17.678,89,riffle_perfect
0,19,20,6,45,0.422,25,0.556,2,2,0.5,2,2,22,23,9,17,19,0.2,0.378,0.422,17.679,90,riffle_perfect
0,24,17,3,44,0.545,27,0.614,4,2,0.667,3,1,25,19,17,9,18,0.386,0.205,0.409,17.674,91,riffle_perfect
0,16,23,5,44,0.364,21,0.477,3,2,0.6,2,1,35,9,8,10,26,0.182,0.227,0.591,17.672,92,riffle_perfect
0,21,26,0,47,0.447,21,0.447,4,0,1.0,1,3,23,24,12,16,19,0.255,0.34,0.404,17.67,93,riffle_perfect
0,20,18,5,43,0.465,25,0.581,4,0,1.0,1,3,29,14,15,13,15,0.349,0.302,0.349,17.674,94,riffle_perfect
0,21,22,2,45,0.467,23,0.511,1,3,0.25,2,3,24,21,8,18,19,0.178,0.4,0.422,17.679,95,riffle_perfect
0,17,26,2,45,0.378,19,0.422,2,2,0.5,1,6,26,19,12,12,21,0.267,0.267,0.467,17.683,96,riffle_perfect
0,15,25,7,47,0.319,22,0.468,2,2,0.5,3,1,26,21,8,16,23,0.17,0.34,0.489,17.457,1,riffle_perfect
0,23,22,2,47,0.489,25,0.532,2,3,0.4,2,3,31,16,11,16,20,0.234,0.34,0.426,17.172,2,riffle_perfect
0,20,18,9,47,0.426,29,0.617,2,0,1.0,5,2,30,17,9,16,22,0.191,0.34,0.468,17.289,3,riffle_perfect
0,19,24,4,47,0.404,23,0.489,2,1,0.667,3,4,29,18,9,17,21,0.191,0.362,0.447,17.341,4,riffle_perfect
0,18,19,6,43,0.419,24,0.558,2,1,0.667,0,3,28,15,14,11,18,0.326,0.256,0.419,17.43,5,riffle_perfect
0,22,23,0,45,0.489,22,0.489,6,6,0.5,1,2,30,15,11,15,19,0.244,0.333,0.422,17.436,6,riffle_perfect
0,20,24,3,47,0.426,23,0.489,1,5,0.167,2,1,31,16,8,15,24,0.17,0.319,0.511,17.389,7,riffle_perfect
0,20,17,6,43,0.465,26,0.605,4,2,0.667,2,2,29,14,8,16,19,0.186,0.372,0.442,17.407,8,riffle_perfect
0,21,20,3,44,0.477,24,0.545,3,0,1.0,2,1,25,19,13,15,16,0.295,0.341,0.364,17.492,9,riffle_perfect
0,14,29,3,46,0.304,17,0.37,1,2,0.333,2,2,30,16,8,19,19,0.174,0.413,0.413,17.488,10,riffle_perfect
0,16,26,2,44,0.364,18,0.409,5,1,0.833,2,2,29,15,8,11,25,0.182,0.25,0.568,17.528,11,riffle_perfect
0,21,17,6,44,0.477,27,0.614,3,1,0.75,3,0,28,16,5,15,24,0.114,0.341,0.545,17.49,12,riffle_perfect
0,22,22,1,45,0.489,23,0.511,3,5,0.375,2,1,27,18,12,13,20,0.267,0.289,0.444,17.454,13,riffle_perfect
0,17,22,6,45,0.378,23,0.511,4,3,0.571,4,3,28,17,11,10,24,0.244,0.222,0.533,17.4,14,riffle_perfect
0,18,25,3,46,0.391,21,0.457,2,3,0.4,0,2,30,16,9,11,26,0.196,0.239,0.565,17.412,15,riffle_perfect
0,18,25,5,48,0.375,23,0.479,3,5,0.375,0,6,30,18,9,18,21,0.188,0.375,0.438,17.414,16,riffle_perfect
0,25,18,4,47,0.532,29,0.617,8,3,0.727,4,2,25,22,13,16,18,0.277,0.34,0.383,17.443,17,riffle_perfect
0,23,15,7,45,0.511,30,0.667,6,2,0.75,2,2,26,19,13,11,21,0.289,0.244,0.467,17.442,18,riffle_perfect
0,19,22,2,43,0.442,21,0.488,1,2,0.333,3,3,30,13,11,8,24,0.256,0.186,0.558,17.439,19,riffle_perfect
0,23,21,1,45,0.511,24,0.533,3,3,0.5,4,3,30,15,9,15,21,0.2,0.333,0.467,17.453,20,riffle_perfect
0,21,18,4,43,0.488,25,0.581,2,2,0.5,0,0,26,17,10,15,18,0.233,0.349,0.419,17.463,21,riffle_perfect
0,19,21,5,45,0.422,24,0.533,1,2,0.333,3,2,30,15,8,14,23,0.178,0.311,0.511,17.419,22,riffle_perfect
0,17,25,3,45,0.378,20,0.444,2,0,1.0,1,2,29,16,9,12,24,0.2,0.267,0.533,17.396,23,riffle_perfect
0,19,23,3,45,0.422,22,0.489,2,3,0.4,3,2,31,14,7,15,23,0.156,0.333,0.511,17.402,24,riffle_perfect
0,21,21,3,45,0.467,24,0.533,4,1,0.8,3,2,26,19,10,12,23,0.222,0.267,0.511,17.422,25,riffle_perfect
0,21,24,1,46,0.457,22,0.478,2,3,0.4,5,1,26,20,8,12,26,0.174,0.261,0.565,17.417,26,riffle_perfect
0,22,23,3,48,0.458,25,0.521,1,1,0.5,1,3,25,23,15,12,21,0.312,0.25,0.438,17.432,27,riffle_perfect
0,18,21,6,45,0.4,24,0.533,4,0,1.0,3,2,30,15,5,12,28,0.111,0.267,0.622,17.428,28,riffle_perfect
0,15,26,2,43,0.349,17,0.395,3,2,0.6,1,1,29,14,9,10,24,0.209,0.233,0.558,17.439,29,riffle_perfect
0,18,23,3,44,0.409,21,0.477,2,2,0.5,2,2,29,15,12,15,17,0.273,0.341,0.386,17.443,30,riffle_perfect
0,19,23,4,46,0.413,23,0.5,3,4,0.429,1,2,27,19,8,21,17,0.174,0.457,0.37,17.463,31,riffle_perfect
0,19,28,2,49,0.388,21,0.429,3,2,0.6,2,5,30,19,11,14,24,0.224,0.286,0.49,17.472,32,riffle_perfect
0,10,27,8,45,0.222,18,0.4,3,1,0.75,2,2,30,15,3,16,26,0.067,0.356,0.578,17.477,33,riffle_perfect
0,25,21,3,49,0.51,28,0.571,0,4,0.0,5,3,28,21,14,20,15,0.286,0.408,0.306,17.48,34,riffle_perfect
0,19,23,5,47,0.404,24,0.511,4,3,0.571,2,4,34,13,10,12,25,0.213,0.255,0.532,17.478,35,riffle_perfect
0,22,20,4,46,0.478,26,0.565,0,2,0.0,6,1,30,16,10,12,24,0.217,0.261,0.522,17.452,36,riffle_perfect
0,22,16,5,43,0.512,27,0.628,0,1,0.0,1,1,22,21,13,14,16,0.302,0.326,0.372,17.463,37,riffle_perfect
0,17,25,5,47,0.362,22,0.468,2,3,0.4,2,0,30,17,7,20,20,0.149,0.426,0.426,17.478,38,riffle_perfect
0,25,21,0,46,0.543,25,0.543,4,4,0.5,1,3,24,22,13,15,18,0.283,0.326,0.391,17.5,39,riffle_perfect
0,21,18,8,47,0.447,29,0.617,3,0,1.0,1,3,30,17,11,14,22,0.234,0.298,0.468,17.52,40,riffle_perfect
0,22,18,5,45,0.489,27,0.6,1,1,0.5,6,1,30,15,11,13,21,0.244,0.289,0.467,17.506,41,riffle_perfect
0,16,24,4,44,0.364,20,0.455,2,2,0.5,0,2,31,13,6,16,22,0.136,0.364,0.5,17.526,42,riffle_perfect
0,19,24,3,46,0.413,22,0.478,4,1,0.8,1,3,22,24,15,10,21,0.326,0.217,0.457,17.515,43,riffle_perfect
0,20,20,5,45,0.444,25,0.556,2,0,1.0,1,3,24,21,11,18,16,0.244,0.4,0.356,17.536,44,riffle_perfect
0,20,22,7,49,0.408,27,0.551,4,2,0.667,2,3,27,22,12,14,23,0.245,0.286,0.469,17.536,45,riffle_perfect
0,21,20,6,47,0.447,27,0.574,2,0,1.0,2,2,27,20,13,17,17,0.277,0.362,0.362,17.542,46,riffle_perfect
0,19,23,5,47,0.404,24,0.511,2,1,0.667,4,4,27,20,9,16,22,0.191,0.34,0.468,17.547,47,riffle_perfect
0,16,25,5,46,0.348,21,0.457,2,1,0.667,3,2,27,19,7,18,21,0.152,0.391,0.457,17.551,48,riffle_perfect
0,22,20,3,45,0.489,25,0.556,4,2,0.667,3,2,25,20,14,8,23,0.311,0.178,0.511,17.552,49,riffle_perfect
0,23,19,4,46,0.5,27,0.587,2,1,0.667,4,5,29,17,13,12,21,0.283,0.261,0.457,17.535,50,riffle_perfect
0,22,23,3,48,0.458,25,0.521,1,2,0.333,5,1,31,17,13,10,25,0.271,0.208,0.521,17.523,51,riffle_perfect
0,23,19,3,45,0.511,26,0.578,4,2,0.667,1,1,30,15,10,18,17,0.222,0.4,0.378,17.533,52,riffle_perfect
0,20,20,6,46,0.435,26,0.565,0,5,0.0,2,4,25,21,12,19,15,0.261,0.413,0.326,17.528,53,riffle_perfect
0,16,25,4,45,0.356,20,0.444,3,1,0.75,1,2,29,16,8,16,21,0.178,0.356,0.467,17.529,54,riffle_perfect
0,21,20,4,45,0.467,25,0.556,3,2,0.6,1,3,26,19,12,15,18,0.267,0.333,0.4,17.538,55,riffle_perfect
0,21,21,5,47,0.447,26,0.553,1,1,0.5,4,1,29,18,11,14,22,0.234,0.298,0.468,17.539,56,riffle_perfect
0,22,21,2,45,0.489,24,0.533,2,2,0.5,2,1,24,21,9,18,18,0.2,0.4,0.4,17.548,57,riffle_perfect
0,20,23,2,45,0.444,22,0.489,2,1,0.667,2,2,32,13,12,13,20,0.267,0.289,0.444,17.544,58,riffle_perfect
0,20,21,3,44,0.455,23,0.523,3,3,0.5,3,2,27,17,11,11,22,0.25,0.25,0.5,17.548,59,riffle_perfect
0,20,22,1,43,0.465,21,0.488,5,3,0.625,2,1,22,21,11,16,16,0.256,0.372,0.372,17.554,60,riffle_perfect
0,20,27,2,49,0.408,22,0.449,4,2,0.667,4,1,24,25,12,18,19,0.245,0.367,0.388,17.559,61,riffle_perfect
0,17,22,9,48,0.354,26,0.542,1,1,0.5,1,2,34,14,9,11,28,0.188,0.229,0.583,17.562,62,riffle_perfect
0,19,20,5,44,0.432,24,0.545,2,2,0.5,1,2,28,16,12,11,21,0.273,0.25,0.477,17.564,63,riffle_perfect
0,17,21,6,44,0.386,23,0.523,3,0,1.0,2,3,37,7,10,13,21,0.227,0.295,0.477,17.578,64,riffle_perfect
0,19,20,4,43,0.442,23,0.535,5,2,0.714,1,2,26,17,10,15,18,0.233,0.349,0.419,17.583,65,riffle_perfect
0,27,16,3,46,0.587,30,0.652,1,0,1.0,5,1,22,24,16,14,16,0.348,0.304,0.348,17.584,66,riffle_perfect
0,15,25,5,45,0.333,20,0.444,0,3,0.0,3,5,32,13,8,13,24,0.178,0.289,0.533,17.588,67,riffle_perfect
0,21,23,5,49,0.429,26,0.531,6,4,0.6,1,3,24,25,12,17,20,0.245,0.347,0.408,17.594,68,riffle_perfect
0,24,17,4,45,0.533,28,0.622,5,1,0.833,2,3,31,14,11,14,20,0.244,0.311,0.444,17.599,69,riffle_perfect
0,19,28,1,48,0.396,20,0.417,5,5,0.5,3,4,22,26,10,18,20,0.208,0.375,0.417,17.595,70,riffle_perfect
0,21,23,1,45,0.467,22,0.489,1,1,0.5,1,1,27,18,10,15,20,0.222,0.333,0.444,17.596,71,riffle_perfect
0,22,20,3,45,0.489,25,0.556,2,0,1.0,2,3,22,23,14,15,16,0.311,0.333,0.356,17.596,72,riffle_perfect
0,20,23,3,46,0.435,23,0.5,1,2,0.333,2,5,30,16,12,13,21,0.261,0.283,0.457,17.594,73,riffle_perfect
0,16,22,6,44,0.364,22,0.5,1,2,0.333,2,0,28,16,10,11,23,0.227,0.25,0.523,17.585,74,riffle_perfect
0,21,24,3,48,0.438,24,0.5,5,0,1.0,0,4,23,25,13,18,17,0.271,0.375,0.354,17.587,75,riffle_perfect
0,21,23,2,46,0.457,23,0.5,0,1,0.0,3,1,29,17,10,10,26,0.217,0.217,0.565,17.579,76,riffle_perfect
0,18,26,3,47,0.383,21,0.447,1,2,0.333,4,4,26,21,10,12,25,0.213,0.255,0.532,17.583,77,riffle_perfect
0,19,22,3,44,0.432,22,0.5,2,2,0.5,1,5,25,19,12,14,18,0.273,0.318,0.409,17.585,78,riffle_perfect
0,21,22,4,47,0.447,25,0.532,2,1,0.667,6,0,30,17,11,12,24,0.234,0.255,0.511,17.585,79,riffle_perfect
0,18,24,3,45,0.4,21,0.467,2,0,1.0,2,3,31,14,8,14,23,0.178,0.311,0.511,17.592,80,riffle_perfect
0,21,23,1,45,0.467,22,0.489,3,2,0.6,0,3,29,16,12,14,19,0.267,0.311,0.422,17.596,81,riffle_perfect
0,21,22,1,44,0.477,22,0.5,0,2,0.0,2,2,29,15,14,10,20,0.318,0.227,0.455,17.606,82,riffle_perfect
0,22,17,5,44,0.5,27,0.614,3,0,1.0,4,2,24,20,12,13,19,0.273,0.295,0.432,17.605,83,riffle_perfect
0,18,23,5,46,0.391,23,0.5,3,4,0.429,1,3,27,19,9,19,18,0.196,0.413,0.391,17.608,84,riffle_perfect
0,20,23,3,46,0.435,23,0.5,3,2,0.6,4,4,29,17,11,17,18,0.239,0.37,0.391,17.613,85,riffle_perfect
0,15,28,3,46,0.326,18,0.391,3,2,0.6,0,1,28,18,7,16,23,0.152,0.348,0.5,17.617,86,riffle_perfect
0,12,31,4,47,0.255,16,0.34,2,4,0.333,1,3,29,18,4,19,24,0.085,0.404,0.511,17.624,87,riffle_perfect
0,15,24,5,44,0.341,20,0.455,3,1,0.75,2,2,31,13,9,14,21,0.205,0.318,0.477,17.626,88,riffle_perfect
0,19,24,2,45,0.422,21,0.467,5,2,0.714,2,3,24,21,10,19,16,0.222,0.422,0.356,17.632,89,riffle_perfect
0,20,26,0,46,0.435,20,0.435,2,1,0.667,5,2,32,14,11,14,21,0.239,0.304,0.457,17.624,90,riffle_perfect
0,12,32,4,48,0.25,16,0.333,1,3,0.25,2,4,28,20,8,20,20,0.167,0.417,0.417,17.625,91,riffle_perfect
0,21,19,3,43,0.488,24,0.558,4,1,0.8,3,0,23,20,11,14,18,0.256,0.326,0.419,17.629,92,riffle_perfect
0,23,16,5,44,0.523,28,0.636,4,4,0.5,2,0,28,16,15,9,20,0.341,0.205,0.455,17.626,93,riffle_perfect
0,19,20,7,46,0.413,26,0.565,3,0,1.0,3,2,25,21,14,14,18,0.304,0.304,0.391,17.623,94,riffle_perfect
0,22,20,5,47,0.468,27,0.574,2,1,0.667,4,2,32,15,11,13,23,0.234,0.277,0.489,17.621,95,riffle_perfect
0,24,20,3,47,0.511,27,0.574,3,0,1.0,4,5,33,14,12,13,22,0.255,0.277,0.468,17.618,96,riffle_perfect
0,14,26,3,43,0.326,17,0.395,1,2,0.333,2,2,31,12,6,16,21,0.14,0.372,0.488,17.7,1,riffle_perfect
0,22,22,6,50,0.44,28,0.56,2,2,0.5,3,1,33,17,8,16,26,0.16,0.32,0.52,17.603,2,riffle_perfect
0,25,21,2,48,0.521,27,0.562,3,2,0.6,3,2,31,17,14,14,20,0.292,0.292,0.417,17.457,3,riffle_perfect
0,18,20,6,44,0.409,24,0.545,4,3,0.571,3,0,28,16,5,18,21,0.114,0.409,0.477,17.55,4,riffle_perfect
0,18,21,8,47,0.383,26,0.553,1,3,0.25,1,1,32,15,9,14,24,0.191,0.298,0.511,17.515,5,riffle_perfect
0,18,27,2,47,0.383,20,0.426,2,2,0.5,3,1,26,21,9,18,20,0.191,0.383,0.426,17.477,6,riffle_perfect
0,21,21,3,45,0.467,24,0.533,2,3,0.4,4,1,31,14,9,11,25,0.2,0.244,0.556,17.398,7,riffle_perfect
0,16,24,5,45,0.356,21,0.467,5,3,0.625,3,1,28,17,10,17,18,0.222,0.378,0.4,17.48,8,riffle_perfect
0,19,20,4,43,0.442,23,0.535,5,1,0.833,3,0,27,16,9,13,21,0.209,0.302,0.488,17.493,9,riffle_perfect
0,17,24,3,44,0.386,20,0.455,2,1,0.667,2,2,30,14,9,14,21,0.205,0.318,0.477,17.548,10,riffle_perfect
0,18,23,4,45,0.4,22,0.489,3,3,0.5,3,2,28,17,6,19,20,0.133,0.422,0.444,17.557,11,riffle_perfect
0,22,18,6,46,0.478,28,0.609,2,1,0.667,2,3,30,16,9,15,22,0.196,0.326,0.478,17.592,12,riffle_perfect
0,21,20,5,46,0.457,26,0.565,3,2,0.6,4,1,20,26,12,19,15,0.261,0.413,0.326,17.555,13,riffle_perfect
0,20,22,2,44,0.455,22,0.5,2,4,0.333,2,2,25,19,12,15,17,0.273,0.341,0.386,17.592,14,riffle_perfect
0,17,20,7,44,0.386,24,0.545,2,0,1.0,3,1,28,16,9,17,18,0.205,0.386,0.409,17.619,15,riffle_perfect
0,21,19,5,45,0.467,26,0.578,1,3,0.25,3,0,35,10,9,12,24,0.2,0.267,0.533,17.642,16,riffle_perfect
0,23,19,5,47,0.489,28,0.596,4,1,0.8,1,0,27,20,12,14,21,0.255,0.298,0.447,17.66,17,riffle_perfect
0,23,20,3,46,0.5,26,0.565,3,1,0.75,3,1,29,17,11,12,23,0.239,0.261,0.5,17.596,18,riffle_perfect
0,20,19,5,44,0.455,25,0.568,1,2,0.333,0,3,26,18,10,16,18,0.227,0.364,0.409,17.636,19,riffle_perfect
0,23,21,2,46,0.5,25,0.543,6,1,0.857,1,1,28,18,9,16,21,0.196,0.348,0.457,17.645,20,riffle_perfect
0,25,15,6,46,0.543,31,0.674,6,2,0.75,3,1,31,15,15,13,18,0.326,0.283,0.391,17.643,21,riffle_perfect
0,20,21,2,43,0.465,22,0.512,7,1,0.875,0,2,27,16,11,12,20,0.256,0.279,0.465,17.67,22,riffle_perfect
0,18,22,5,45,0.4,23,0.511,3,5,0.375,1,2,35,10,8,10,27,0.178,0.222,0.6,17.693,23,riffle_perfect
0,21,17,4,42,0.5,25,0.595,3,3,0.5,1,2,26,16,9,14,19,0.214,0.333,0.452,17.71,24,riffle_perfect
0,24,20,3,47,0.511,27,0.574,6,3,0.667,0,2,23,24,16,14,17,0.34,0.298,0.362,17.699,25,riffle_perfect
0,14,28,5,47,0.298,19,0.404,3,3,0.5,1,7,32,15,5,22,20,0.106,0.468,0.426,17.735,26,riffle_perfect
0,16,19,9,44,0.364,25,0.568,4,2,0.667,1,2,28,16,8,19,17,0.182,0.432,0.386,17.74,27,riffle_perfect
0,23,22,2,47,0.489,25,0.532,5,4,0.556,2,3,28,19,15,12,20,0.319,0.255,0.426,17.743,28,riffle_perfect
0,13,22,10,45,0.289,23,0.511,0,2,0.0,0,4,31,14,7,16,22,0.156,0.356,0.489,17.765,29,riffle_perfect
0,23,18,4,45,0.511,27,0.6,5,4,0.556,2,1,20,25,15,17,13,0.333,0.378,0.289,17.766,30,riffle_perfect
0,18,19,8,45,0.4,26,0.578,0,1,0.0,3,3,26,19,10,12,23,0.222,0.267,0.511,17.788,31,riffle_perfect
0,24,17,5,46,0.522,29,0.63,3,3,0.5,5,1,27,19,8,18,20,0.174,0.391,0.435,17.784,32,riffle_perfect
0,20,20,3,43,0.465,23,0.535,3,1,0.75,3,1,26,17,11,14,18,0.256,0.326,0.419,17.784,33,riffle_perfect
0,20,19,4,43,0.465,24,0.558,7,3,0.7,1,2,24,19,7,16,20,0.163,0.372,0.465,17.78,34,riffle_perfect
0,16,19,10,45,0.356,26,0.578,0,2,0.0,1,1,27,18,9,16,20,0.2,0.356,0.444,17.784,35,riffle_perfect
0,14,25,4,43,0.326,18,0.419,2,4,0.333,1,2,24,19,10,14,19,0.233,0.326,0.442,17.787,36,riffle_perfect
0,21,18,4,43,0.488,25,0.581,2,2,0.5,1,1,26,17,12,15,16,0.279,0.349,0.372,17.777,37,riffle_perfect
0,24,18,2,44,0.545,26,0.591,6,0,1.0,3,0,24,20,10,16,18,0.227,0.364,0.409,17.769,38,riffle_perfect
0,19,28,1,48,0.396,20,0.417,4,5,0.444,2,0,26,22,11,15,22,0.229,0.312,0.458,17.757,39,riffle_perfect
0,20,20,3,43,0.465,23,0.535,7,2,0.778,1,1,23,20,11,11,21,0.256,0.256,0.488,17.76,40,riffle_perfect
0,21,19,4,44,0.477,25,0.568,2,1,0.667,2,2,28,16,13,14,17,0.295,0.318,0.386,17.748,41,riffle_perfect
0,19,23,2,44,0.432,21,0.477,2,3,0.4,2,3,31,13,9,9,26,0.205,0.205,0.591,17.758,42,riffle_perfect
0,27,14,5,46,0.587,32,0.696,4,2,0.667,2,1,25,21,19,5,22,0.413,0.109,0.478,17.759,43,riffle_perfect
0,21,18,5,44,0.477,26,0.591,3,3,0.5,2,2,27,17,11,14,19,0.25,0.318,0.432,17.766,44,riffle_perfect
0,21,21,3,45,0.467,24,0.533,7,1,0.875,3,5,27,18,14,11,20,0.311,0.244,0.444,17.765,45,riffle_perfect
0,21,21,3,45,0.467,24,0.533,2,1,0.667,0,4,29,16,11,15,19,0.244,0.333,0.422,17.772,46,riffle_perfect
0,17,24,5,46,0.37,22,0.478,1,3,0.25,0,2,29,17,12,12,22,0.261,0.261,0.478,17.79,47,riffle_perfect
0,16,25,5,46,0.348,21,0.457,1,5,0.167,2,2,27,19,8,19,19,0.174,0.413,0.413,17.781,48,riffle_perfect
0,17,24,5,46,0.37,22,0.478,3,1,0.75,0,6,29,17,6,20,20,0.13,0.435,0.435,17.788,49,riffle_perfect
0,23,19,6,48,0.479,29,0.604,7,1,0.875,0,2,23,25,18,15,15,0.375,0.312,0.312,17.783,50,riffle_perfect
0,19,23,4,46,0.413,23,0.5,4,3,0.571,2,2,23,23,11,21,14,0.239,0.457,0.304,17.784,51,riffle_perfect
0,25,16,4,45,0.556,29,0.644,3,3,0.5,6,2,23,22,12,12,21,0.267,0.267,0.467,17.772,52,riffle_perfect
0,16,24,4,44,0.364,20,0.455,3,2,0.6,2,0,30,14,10,17,17,0.227,0.386,0.386,17.767,53,riffle_perfect
0,20,22,2,44,0.455,22,0.5,5,2,0.714,4,0,26,18,11,18,15,0.25,0.409,0.341,17.762,54,riffle_perfect
0,24,19,4,47,0.511,28,0.596,4,2,0.667,2,2,28,19,15,10,22,0.319,0.213,0.468,17.748,55,riffle_perfect
0,20,22,4,46,0.435,24,0.522,1,2,0.333,1,0,23,23,10,19,17,0.217,0.413,0.37,17.756,56,riffle_perfect
0,23,23,3,49,0.469,26,0.531,1,1,0.5,4,1,28,21,11,16,22,0.224,0.327,0.449,17.758,57,riffle_perfect
0,21,22,1,44,0.477,22,0.5,4,4,0.5,2,1,26,18,12,17,15,0.273,0.386,0.341,17.759,58,riffle_perfect
0,21,16,5,42,0.5,26,0.619,5,0,1.0,2,0,26,16,11,13,18,0.262,0.31,0.429,17.754,59,riffle_perfect
0,26,18,4,48,0.542,30,0.625,3,2,0.6,3,0,27,21,11,13,24,0.229,0.271,0.5,17.75,60,riffle_perfect
0,23,20,1,44,0.523,24,0.545,1,3,0.25,2,1,31,13,12,9,23,0.273,0.205,0.523,17.747,61,riffle_perfect
0,26,18,2,46,0.565,28,0.609,4,2,0.667,1,1,22,24,18,11,17,0.391,0.239,0.37,17.751,62,riffle_perfect
0,22,17,6,45,0.489,28,0.622,3,2,0.6,3,2,26,19,14,12,19,0.311,0.267,0.422,17.756,63,riffle_perfect
0,16,27,2,45,0.356,18,0.4,1,1,0.5,1,1,25,20,8,19,18,0.178,0.422,0.4,17.762,64,riffle_perfect
0,23,19,3,45,0.511,26,0.578,5,1,0.833,2,1,24,21,9,14,22,0.2,0.311,0.489,17.758,65,riffle_perfect
0,23,20,2,45,0.511,25,0.556,3,1,0.75,3,1,29,16,13,13,19,0.289,0.289,0.422,17.757,66,riffle_perfect
0,22,23,5,50,0.44,27,0.54,9,0,1.0,2,2,28,22,10,19,21,0.2,0.38,0.42,17.76,67,riffle_perfect
0,21,16,5,42,0.5,26,0.619,2,1,0.667,2,1,28,14,13,11,18,0.31,0.262,0.429,17.763,68,riffle_perfect
0,21,25,3,49,0.429,24,0.49,7,2,0.778,0,1,24,25,13,19,17,0.265,0.388,0.347,17.77,69,riffle_perfect
0,17,27,0,44,0.386,17,0.386,3,2,0.6,0,3,26,18,10,15,19,0.227,0.341,0.432,17.766,70,riffle_perfect
0,11,31,4,46,0.239,15,0.326,2,6,0.25,1,3,34,12,7,10,29,0.152,0.217,0.63,17.758,71,riffle_perfect
0,17,26,4,47,0.362,21,0.447,1,7,0.125,5,1,26,21,6,20,21,0.128,0.426,0.447,17.753,72,riffle_perfect
0,21,21,2,44,0.477,23,0.523,3,0,1.0,3,3,29,15,12,9,23,0.273,0.205,0.523,17.751,73,riffle_perfect
0,18,23,5,46,0.391,23,0.5,3,2,0.6,4,1,32,14,8,13,25,0.174,0.283,0.543,17.744,74,riffle_perfect
0,17,27,2,46,0.37,19,0.413,0,2,0.0,1,3,27,19,12,14,20,0.261,0.304,0.435,17.744,75,riffle_perfect
0,24,17,4,45,0.533,28,0.622,5,0,1.0,6,2,26,19,11,15,19,0.244,0.333,0.422,17.741,76,riffle_perfect
0,25,16,4,45,0.556,29,0.644,2,3,0.4,3,0,26,19,18,9,18,0.4,0.2,0.4,17.743,77,riffle_perfect
0,22,18,4,44,0.5,26,0.591,5,3,0.625,2,2,28,16,15,11,18,0.341,0.25,0.409,17.75,78,riffle_perfect
0,23,16,3,42,0.548,26,0.619,4,4,0.5,1,2,21,21,15,11,16,0.357,0.262,0.381,17.753,79,riffle_perfect
0,22,20,5,47,0.468,27,0.574,4,3,0.571,0,2,19,28,14,18,15,0.298,0.383,0.319,17.762,80,riffle_perfect
0,24,20,1,45,0.533,25,0.556,4,1,0.8,3,1,30,15,12,12,21,0.267,0.267,0.467,17.759,81,riffle_perfect
0,22,22,3,47,0.468,25,0.532,6,4,0.6,1,0,28,19,12,16,19,0.255,0.34,0.404,17.765,82,riffle_perfect
0,22,22,4,48,0.458,26,0.542,4,3,0.571,0,4,23,25,10,19,19,0.208,0.396,0.396,17.77,83,riffle_perfect
0,16,27,3,46,0.348,19,0.413,2,4,0.333,0,3,26,20,14,14,18,0.304,0.304,0.391,17.774,84,riffle_perfect
0,19,31,2,52,0.365,21,0.404,0,7,0.0,0,4,29,23,14,19,19,0.269,0.365,0.365,17.773,85,riffle_perfect
0,15,24,6,45,0.333,21,0.467,4,2,0.667,2,3,35,10,8,14,23,0.178,0.311,0.511,17.774,86,riffle_perfect
0,19,22,3,44,0.432,22,0.5,0,3,0.0,2,1,28,16,8,13,23,0.182,0.295,0.523,17.773,87,riffle_perfect
0,16,26,2,44,0.364,18,0.409,3,2,0.6,1,1,31,13,10,13,21,0.227,0.295,0.477,17.769,88,riffle_perfect
0,19,21,4,44,0.432,23,0.523,4,1,0.8,2,2,30,14,9,12,23,0.205,0.273,0.523,17.77,89,riffle_perfect
0,21,21,6,48,0.438,27,0.562,3,0,1.0,2,3,32,16,10,14,24,0.208,0.292,0.5,17.778,90,riffle_perfect
0,13,30,4,47,0.277,17,0.362,1,5,0.167,1,3,27,20,7,19,21,0.149,0.404,0.447,17.778,91,riffle_perfect
0,22,22,4,48,0.458,26,0.542,3,5,0.375,3,4,26,22,12,16,20,0.25,0.333,0.417,17.773,92,riffle_perfect
0,26,17,1,44,0.591,27,0.614,2,1,0.667,6,1,25,19,14,10,20,0.318,0.227,0.455,17.759,93,riffle_perfect
0,21,19,6,46,0.457,27,0.587,1,3,0.25,4,2,24,22,11,15,20,0.239,0.326,0.435,17.755,94,riffle_perfect
0,22,22,1,45,0.489,23,0.511,1,2,0.333,0,3,30,15,12,14,19,0.267,0.311,0.422,17.747,95,riffle_perfect
0,21,21,4,46,0.457,25,0.543,5,2,0.714,4,2,29,17,9,15,22,0.196,0.326,0.478,17.747,96,riffle_perfect
0,14,29,2,45,0.311,16,0.356,2,4,0.333,3,3,29,16,5,11,29,0.111,0.244,0.644,17.182,1,riffle_perfect
0,17,25,4,46,0.37,21,0.457,0,0,0,1,3,27,19,11,12,23,0.239,0.261,0.5,17.169,2,riffle_perfect
0,20,17,7,44,0.455,27,0.614,4,3,0.571,2,1,24,20,7,18,19,0.159,0.409,0.432,17.464,3,riffle_perfect
0,20,17,6,43,0.465,26,0.605,4,3,0.571,0,2,29,14,10,11,22,0.233,0.256,0.512,17.75,4,riffle_perfect
0,25,16,4,45,0.556,29,0.644,2,0,1.0,2,3,27,18,15,11,19,0.333,0.244,0.422,17.715,5,riffle_perfect
0,18,27,3,48,0.375,21,0.438,2,1,0.667,3,3,26,22,8,19,21,0.167,0.396,0.438,17.703,6,riffle_perfect
0,18,22,5,45,0.4,23,0.511,3,0,1.0,3,1,25,20,9,14,22,0.2,0.311,0.489,17.631,7,riffle_perfect
0,15,25,6,46,0.326,21,0.457,0,1,0.0,3,3,26,20,9,16,21,0.196,0.348,0.457,17.677,8,riffle_perfect
0,20,19,6,45,0.444,26,0.578,2,5,0.286,1,2,24,21,13,15,17,0.289,0.333,0.378,17.724,9,riffle_perfect
0,22,23,2,47,0.468,24,0.511,3,0,1.0,2,2,29,18,15,11,21,0.319,0.234,0.447,17.75,10,riffle_perfect
0,20,23,3,46,0.435,23,0.5,3,2,0.6,4,3,30,16,8,12,26,0.174,0.261,0.565,17.723,11,riffle_perfect
0,23,20,2,45,0.511,25,0.556,1,0,1.0,3,1,26,19,10,10,25,0.222,0.222,0.556,17.661,12,riffle_perfect
0,18,20,6,44,0.409,24,0.545,2,1,0.667,0,1,26,18,11,18,15,0.25,0.409,0.341,17.668,13,riffle_perfect
0,19,20,8,47,0.404,27,0.574,5,0,1.0,3,4,29,18,6,19,22,0.128,0.404,0.468,17.623,14,riffle_perfect
0,19,23,3,45,0.422,22,0.489,1,1,0.5,3,2,28,17,9,14,22,0.2,0.311,0.489,17.593,15,riffle_perfect
0,21,22,3,46,0.457,24,0.522,3,4,0.429,2,0,24,22,12,16,18,0.261,0.348,0.391,17.634,16,riffle_perfect
0,18,21,7,46,0.391,25,0.543,3,0,1.0,1,0,33,13,3,17,26,0.065,0.37,0.565,17.629,17,riffle_perfect
0,22,19,3,44,0.5,25,0.568,4,0,1.0,4,2,29,15,11,9,24,0.25,0.205,0.545,17.586,18,riffle_perfect
0,19,24,4,47,0.404,23,0.489,2,6,0.25,3,2,33,14,9,11,27,0.191,0.234,0.574,17.57,19,riffle_perfect
0,16,21,7,44,0.364,23,0.523,2,0,1.0,2,3,25,19,9,16,19,0.205,0.364,0.432,17.554,20,riffle_perfect
0,18,22,6,46,0.391,24,0.522,3,1,0.75,2,4,28,18,10,14,22,0.217,0.304,0.478,17.559,21,riffle_perfect
0,20,22,4,46,0.435,24,0.522,3,1,0.75,3,1,26,20,5,21,20,0.109,0.457,0.435,17.583,22,riffle_perfect
0,27,11,6,44,0.614,33,0.75,4,0,1.0,2,0,29,15,13,12,19,0.295,0.273,0.432,17.585,23,riffle_perfect
0,15,27,3,45,0.333,18,0.4,3,4,0.429,0,1,33,12,8,14,23,0.178,0.311,0.511,17.592,24,riffle_perfect
0,22,20,2,44,0.5,24,0.545,1,0,1.0,0,2,28,16,12,13,19,0.273,0.295,0.432,17.602,25,riffle_perfect
0,17,25,4,46,0.37,21,0.457,2,8,0.2,2,2,31,15,9,18,19,0.196,0.391,0.413,17.63,26,riffle_perfect
0,19,18,9,46,0.413,28,0.609,3,1,0.75,2,2,28,18,13,15,18,0.283,0.326,0.391,17.655,27,riffle_perfect
0,18,24,5,47,0.383,23,0.489,2,4,0.333,4,1,26,21,6,16,25,0.128,0.34,0.532,17.667,28,riffle_perfect
0,20,21,1,42,0.476,21,0.5,4,0,1.0,3,0,28,14,10,11,21,0.238,0.262,0.5,17.662,29,riffle_perfect
0,21,22,4,47,0.447,25,0.532,2,1,0.667,3,3,24,23,13,12,22,0.277,0.255,0.468,17.678,30,riffle_perfect
0,25,19,2,46,0.543,27,0.587,3,2,0.6,6,4,22,24,10,16,20,0.217,0.348,0.435,17.666,31,riffle_perfect
0,20,22,2,44,0.455,22,0.5,6,2,0.75,3,1,29,15,9,10,25,0.205,0.227,0.568,17.658,32,riffle_perfect
0,23,22,1,46,0.5,24,0.522,3,0,1.0,3,2,30,16,9,12,25,0.196,0.261,0.543,17.656,33,riffle_perfect
0,23,22,2,47,0.489,25,0.532,3,2,0.6,1,2,29,18,12,13,22,0.255,0.277,0.468,17.643,34,riffle_perfect
0,19,21,6,46,0.413,25,0.543,2,2,0.5,4,2,31,15,11,13,22,0.239,0.283,0.478,17.635,35,riffle_perfect
0,23,21,3,47,0.489,26,0.553,3,1,0.75,0,1,28,19,14,15,18,0.298,0.319,0.383,17.652,36,riffle_perfect
0,15,24,7,46,0.326,22,0.478,3,0,1.0,2,3,32,14,8,15,23,0.174,0.326,0.5,17.65,37,riffle_perfect
0,19,20,4,43,0.442,23,0.535,3,1,0.75,1,2,25,18,12,17,14,0.279,0.395,0.326,17.646,38,riffle_perfect
0,24,19,1,44,0.545,25,0.568,3,1,0.75,4,3,25,19,12,12,20,0.273,0.273,0.455,17.633,39,riffle_perfect
0,21,23,6,50,0.42,27,0.54,3,2,0.6,2,2,31,19,13,11,26,0.26,0.22,0.52,17.635,40,riffle_perfect
0,18,26,4,48,0.375,22,0.458,1,4,0.2,2,4,29,19,12,15,21,0.25,0.312,0.438,17.644,41,riffle_perfect
0,24,17,4,45,0.533,28,0.622,2,0,1.0,3,3,28,17,11,14,20,0.244,0.311,0.444,17.627,42,riffle_perfect
0,21,21,3,45,0.467,24,0.533,1,2,0.333,3,0,27,18,9,15,21,0.2,0.333,0.467,17.609,43,riffle_perfect
0,21,21,3,45,0.467,24,0.533,3,2,0.6,4,1,24,21,11,15,19,0.244,0.333,0.422,17.608,44,riffle_perfect
0,20,20,3,43,0.465,23,0.535,5,0,1.0,2,2,24,19,10,16,17,0.233,0.372,0.395,17.62,45,riffle_perfect
0,24,20,3,47,0.511,27,0.574,2,2,0.5,4,3,31,16,12,15,20,0.255,0.319,0.426,17.618,46,riffle_perfect
0,25,13,8,46,0.543,33,0.717,3,2,0.6,3,3,30,16,8,13,25,0.174,0.283,0.543,17.623,47,riffle_perfect
0,16,24,4,44,0.364,20,0.455,3,3,0.5,1,2,25,19,8,21,15,0.182,0.477,0.341,17.641,48,riffle_perfect
0,11,31,3,45,0.244,14,0.311,3,2,0.6,0,4,26,19,7,19,19,0.156,0.422,0.422,17.631,49,riffle_perfect
0,18,23,3,44,0.409,21,0.477,1,3,0.25,1,4,25,19,10,12,22,0.227,0.273,0.5,17.634,50,riffle_perfect
0,25,15,5,45,0.556,30,0.667,6,0,1.0,3,1,28,17,16,13,16,0.356,0.289,0.356,17.63,51,riffle_perfect
0,18,24,5,47,0.383,23,0.489,0,2,0.0,4,2,20,27,11,18,18,0.234,0.383,0.383,17.639,52,riffle_perfect
0,21,22,2,45,0.467,23,0.511,5,1,0.833,1,2,32,13,14,9,22,0.311,0.2,0.489,17.648,53,riffle_perfect
0,17,25,3,45,0.378,20,0.444,4,2,0.667,2,4,27,18,8,16,21,0.178,0.356,0.467,17.647,54,riffle_perfect
0,24,21,2,47,0.511,26,0.553,5,7,0.417,3,0,21,26,17,14,16,0.362,0.298,0.34,17.642,55,riffle_perfect
0,19,21,5,45,0.422,24,0.533,2,1,0.667,1,3,33,12,10,7,28,0.222,0.156,0.622,17.641,56,riffle_perfect
0,22,23,1,46,0.478,23,0.5,3,0,1.0,4,5,34,12,11,8,27,0.239,0.174,0.587,17.639,57,riffle_perfect
0,15,27,3,45,0.333,18,0.4,3,2,0.6,2,1,26,19,4,19,22,0.089,0.422,0.489,17.633,58,riffle_perfect
0,19,20,5,44,0.432,24,0.545,3,4,0.429,1,2,27,17,11,15,18,0.25,0.341,0.409,17.635,59,riffle_perfect
0,23,22,1,46,0.5,24,0.522,4,2,0.667,0,6,32,14,13,12,21,0.283,0.261,0.457,17.647,60,riffle_perfect
0,16,22,7,45,0.356,23,0.511,3,6,0.333,2,2,28,17,6,18,21,0.133,0.4,0.467,17.647,61,riffle_perfect
0,19,23,4,46,0.413,23,0.5,5,4,0.556,3,2,29,17,14,15,17,0.304,0.326,0.37,17.634,62,riffle_perfect
0,19,25,2,46,0.413,21,0.457,3,0,1.0,1,1,30,16,8,18,20,0.174,0.391,0.435,17.632,63,riffle_perfect
0,25,18,4,47,0.532,29,0.617,2,5,0.286,4,3,33,14,15,14,18,0.319,0.298,0.383,17.635,64,riffle_perfect
0,20,22,3,45,0.444,23,0.511,3,3,0.5,1,4,28,17,11,15,19,0.244,0.333,0.422,17.632,65,riffle_perfect
0,24,17,4,45,0.533,28,0.622,5,3,0.625,3,0,24,21,13,16,16,0.289,0.356,0.356,17.638,66,riffle_perfect
0,19,25,2,46,0.413,21,0.457,5,2,0.714,0,3,22,24,7,21,18,0.152,0.457,0.391,17.636,67,riffle_perfect
0,26,18,2,46,0.565,28,0.609,5,0,1.0,3,2,29,17,18,10,18,0.391,0.217,0.391,17.63,68,riffle_perfect
0,18,23,6,47,0.383,24,0.511,3,1,0.75,0,2,30,17,8,14,25,0.17,0.298,0.532,17.641,69,riffle_perfect
0,23,19,4,46,0.5,27,0.587,4,2,0.667,0,2,29,17,13,21,12,0.283,0.457,0.261,17.646,70,riffle_perfect
0,20,22,4,46,0.435,24,0.522,1,1,0.5,1,1,27,19,11,18,17,0.239,0.391,0.37,17.644,71,riffle_perfect
0,23,20,4,47,0.489,27,0.574,2,3,0.4,2,2,29,18,8,16,23,0.17,0.34,0.489,17.649,72,riffle_perfect
0,17,25,4,46,0.37,21,0.457,2,2,0.5,0,2,25,21,6,15,25,0.13,0.326,0.543,17.646,73,riffle_perfect
0,18,24,3,45,0.4,21,0.467,2,3,0.4,1,3,28,17,9,16,20,0.2,0.356,0.444,17.653,74,riffle_perfect
0,21,22,5,48,0.438,26,0.542,3,2,0.6,1,4,32,16,10,16,22,0.208,0.333,0.458,17.653,75,riffle_perfect
0,17,25,5,47,0.362,22,0.468,1,0,1.0,3,1,34,13,6,16,25,0.128,0.34,0.532,17.653,76,riffle_perfect
0,19,25,1,45,0.422,20,0.444,2,2,0.5,2,3,29,16,11,15,19,0.244,0.333,0.422,17.66,77,riffle_perfect
0,19,21,4,44,0.432,23,0.523,3,4,0.429,2,3,25,19,13,17,14,0.295,0.386,0.318,17.662,78,riffle_perfect
0,17,23,6,46,0.37,23,0.5,2,1,0.667,3,6,31,15,8,17,21,0.174,0.37,0.457,17.667,79,riffle_perfect
0,20,16,7,43,0.465,27,0.628,3,1,0.75,0,1,23,20,14,16,13,0.326,0.372,0.302,17.668,80,riffle_perfect
0,19,23,4,46,0.413,23,0.5,1,2,0.333,4,1,30,16,10,14,22,0.217,0.304,0.478,17.666,81,riffle_perfect
0,20,23,6,49,0.408,26,0.531,1,3,0.25,4,2,29,20,10,11,28,0.204,0.224,0.571,17.655,82,riffle_perfect
0,24,22,1,47,0.511,25,0.532,2,3,0.4,3,2,25,22,16,11,20,0.34,0.234,0.426,17.655,83,riffle_perfect
0,18,27,3,48,0.375,21,0.438,3,4,0.429,1,3,25,23,9,14,25,0.188,0.292,0.521,17.654,84,riffle_perfect
0,13,29,4,46,0.283,17,0.37,1,3,0.25,3,3,31,15,6,15,25,0.13,0.326,0.543,17.656,85,riffle_perfect
0,19,16,10,45,0.422,29,0.644,4,0,1.0,1,4,27,18,13,11,21,0.289,0.244,0.467,17.655,86,riffle_perfect
0,20,22,2,44,0.455,22,0.5,5,3,0.625,3,3,30,14,10,13,21,0.227,0.295,0.477,17.658,87,riffle_perfect
0,18,22,5,45,0.4,23,0.511,0,4,0.0,3,3,25,20,11,13,21,0.244,0.289,0.467,17.654,88,riffle_perfect
0,18,24,3,45,0.4,21,0.467,3,1,0.75,4,3,28,17,8,13,24,0.178,0.289,0.533,17.658,89,riffle_perfect
0,12,27,6,45,0.267,18,0.4,1,1,0.5,2,0,28,17,7,18,20,0.156,0.4,0.444,17.656,90,riffle_perfect
0,23,21,5,49,0.469,28,0.571,3,1,0.75,3,1,31,18,11,12,26,0.224,0.245,0.531,17.657,91,riffle_perfect
0,26,18,1,45,0.578,27,0.6,3,5,0.375,3,1,23,22,13,12,20,0.289,0.267,0.444,17.655,92,riffle_perfect
0,16,29,2,47,0.34,18,0.383,1,2,0.333,2,2,27,20,7,15,25,0.149,0.319,0.532,17.659,93,riffle_perfect
0,23,18,5,46,0.5,28,0.609,5,3,0.625,2,3,31,15,8,16,22,0.174,0.348,0.478,17.655,94,riffle_perfect
0,19,24,2,45,0.422,21,0.467,5,4,0.556,2,4,30,15,12,11,22,0.267,0.244,0.489,17.658,95,riffle_perfect
0,25,16,2,43,0.581,27,0.628,5,1,0.833,2,2,25,18,16,9,18,0.372,0.209,0.419,17.653,96,riffle_perfect
0,16,24,3,43,0.372,19,0.442,2,4,0.333,1,2,23,20,11,17,15,0.256,0.395,0.349,17.583,1,riffle_perfect
0,12,30,5,47,0.255,17,0.362,5,2,0.714,1,2,26,21,8,21,18,0.17,0.447,0.383,18.058,2,riffle_perfect
0,13,29,2,44,0.295,15,0.341,3,2,0.6,0,3,29,15,9,13,22,0.205,0.295,0.5,18.133,3,riffle_perfect
0,23,19,6,48,0.479,29,0.604,3,0,1.0,3,1,28,20,10,15,23,0.208,0.312,0.479,17.85,4,riffle_perfect
0,22,18,4,44,0.5,26,0.591,2,6,0.25,1,1,22,22,13,15,16,0.295,0.341,0.364,17.875,5,riffle_perfect
0,18,23,3,44,0.409,21,0.477,4,1,0.8,3,1,31,13,9,14,21,0.205,0.318,0.477,17.804,6,riffle_perfect
0,18,24,6,48,0.375,24,0.5,4,3,0.571,3,1,29,19,9,16,23,0.188,0.333,0.479,17.658,7,riffle_perfect
0,16,21,7,44,0.364,23,0.523,3,4,0.429,2,0,28,16,7,16,21,0.159,0.364,0.477,17.716,8,riffle_perfect
0,18,22,5,45,0.4,23,0.511,3,3,0.5,1,3,25,20,13,11,21,0.289,0.244,0.467,17.65,9,riffle_perfect
0,22,22,4,48,0.458,26,0.542,2,1,0.667,2,4,28,20,13,18,17,0.271,0.375,0.354,17.574,10,riffle_perfect
0,20,20,4,44,0.455,24,0.545,3,0,1.0,2,2,31,13,14,9,21,0.318,0.205,0.477,17.531,11,riffle_perfect
0,17,26,2,45,0.378,19,0.422,3,1,0.75,2,3,31,14,8,18,19,0.178,0.4,0.422,17.589,12,riffle_perfect
0,19,24,5,48,0.396,24,0.5,3,4,0.429,2,4,28,20,10,17,21,0.208,0.354,0.438,17.532,13,riffle_perfect
0,22,22,2,46,0.478,24,0.522,4,1,0.8,3,1,25,21,10,16,20,0.217,0.348,0.435,17.53,14,riffle_perfect
0,17,23,5,45,0.378,22,0.489,2,2,0.5,1,2,25,20,12,16,17,0.267,0.356,0.378,17.59,15,riffle_perfect
0,28,13,3,44,0.636,31,0.705,5,0,1.0,3,0,27,17,14,15,15,0.318,0.341,0.341,17.609,16,riffle_perfect
0,27,16,4,47,0.574,31,0.66,7,0,1.0,1,2,28,19,16,14,17,0.34,0.298,0.362,17.615,17,riffle_perfect
0,23,21,1,45,0.511,24,0.533,5,2,0.714,1,3,28,17,12,14,19,0.267,0.311,0.422,17.621,18,riffle_perfect
0,17,24,5,46,0.37,22,0.478,3,2,0.6,5,4,22,24,7,18,21,0.152,0.391,0.457,17.649,19,riffle_perfect
0,18,20,7,45,0.4,25,0.556,0,1,0.0,3,3,28,17,10,14,21,0.222,0.311,0.467,17.641,20,riffle_perfect
0,21,18,5,44,0.477,26,0.591,4,0,1.0,4,2,25,19,11,11,22,0.25,0.25,0.5,17.653,21,riffle_perfect
0,21,19,5,45,0.467,26,0.578,3,2,0.6,4,3,27,18,12,13,20,0.267,0.289,0.444,17.661,22,riffle_perfect
0,21,20,5,46,0.457,26,0.565,0,2,0.0,3,2,29,17,12,14,20,0.261,0.304,0.435,17.628,23,riffle_perfect
0,21,24,2,47,0.447,23,0.489,3,7,0.3,4,1,22,25,9,19,19,0.191,0.404,0.404,17.638,24,riffle_perfect
0,19,25,1,45,0.422,20,0.444,3,5,0.375,3,2,27,18,10,13,22,0.222,0.289,0.489,17.628,25,riffle_perfect
0,12,27,5,44,0.273,17,0.386,5,3,0.625,1,2,26,18,8,11,25,0.182,0.25,0.568,17.619,26,riffle_perfect
0,15,30,2,47,0.319,17,0.362,0,4,0.0,4,3,29,18,6,16,25,0.128,0.34,0.532,17.607,27,riffle_perfect
0,21,20,3,44,0.477,24,0.545,2,3,0.4,3,0,33,11,10,9,25,0.227,0.205,0.568,17.579,28,riffle_perfect
0,17,22,7,46,0.37,24,0.522,0,2,0.0,1,6,21,25,10,18,18,0.217,0.391,0.391,17.574,29,riffle_perfect
0,25,14,5,44,0.568,30,0.682,1,1,0.5,1,2,27,17,14,12,18,0.318,0.273,0.409,17.587,30,riffle_perfect
0,17,24,3,44,0.386,20,0.455,3,3,0.5,1,0,20,24,8,18,18,0.182,0.409,0.409,17.61,31,riffle_perfect
0,18,21,9,48,0.375,27,0.562,2,0,1.0,3,2,32,16,7,18,23,0.146,0.375,0.479,17.591,32,riffle_perfect
0,19,21,3,43,0.442,22,0.512,4,3,0.571,1,3,24,19,12,14,17,0.279,0.326,0.395,17.607,33,riffle_perfect
0,19,21,5,45,0.422,24,0.533,5,2,0.714,0,2,28,17,12,11,22,0.267,0.244,0.489,17.603,34,riffle_perfect
0,23,18,4,45,0.511,27,0.6,6,1,0.857,3,4,29,16,10,17,18,0.222,0.378,0.4,17.609,35,riffle_perfect
0,21,23,3,47,0.447,24,0.511,2,4,0.333,4,1,32,15,10,15,22,0.213,0.319,0.468,17.633,36,riffle_perfect
0,16,24,6,46,0.348,22,0.478,2,1,0.667,2,2,27,19,7,16,23,0.152,0.348,0.5,17.623,37,riffle_perfect
0,21,20,3,44,0.477,24,0.545,2,0,1.0,2,0,27,17,13,13,18,0.295,0.295,0.409,17.618,38,riffle_perfect
0,26,14,4,44,0.591,30,0.682,3,3,0.5,3,2,29,15,12,13,19,0.273,0.295,0.432,17.617,39,riffle_perfect
0,22,23,2,47,0.468,24,0.511,3,1,0.75,2,2,28,19,13,10,24,0.277,0.213,0.511,17.596,40,riffle_perfect
0,27,14,5,46,0.587,32,0.696,5,1,0.833,4,2,25,21,14,16,16,0.304,0.348,0.348,17.595,41,riffle_perfect
0,19,22,2,43,0.442,21,0.488,4,1,0.8,0,3,32,11,13,14,16,0.302,0.326,0.372,17.621,42,riffle_perfect
0,19,22,2,43,0.442,21,0.488,6,4,0.6,2,0,21,22,9,19,15,0.209,0.442,0.349,17.625,43,riffle_perfect
0,19,24,2,45,0.422,21,0.467,0,3,0.0,1,2,23,22,13,17,15,0.289,0.378,0.333,17.648,44,riffle_perfect
0,22,18,3,43,0.512,25,0.581,6,0,1.0,4,1,23,20,13,12,18,0.302,0.279,0.419,17.634,45,riffle_perfect
0,17,26,4,47,0.362,21,0.447,2,1,0.667,2,7,30,17,8,11,28,0.17,0.234,0.596,17.644,46,riffle_perfect
0,17,23,5,45,0.378,22,0.489,4,2,0.667,2,3,27,18,11,8,26,0.244,0.178,0.578,17.637,47,riffle_perfect
0,21,22,2,45,0.467,23,0.511,2,2,0.5,3,3,25,20,12,13,20,0.267,0.289,0.444,17.625,48,riffle_perfect
0,24,20,4,48,0.5,28,0.583,1,4,0.2,1,1,27,21,12,16,20,0.25,0.333,0.417,17.609,49,riffle_perfect
0,17,23,4,44,0.386,21,0.477,1,0,1.0,3,1,27,17,5,16,23,0.114,0.364,0.523,17.603,50,riffle_perfect
0,18,25,3,46,0.391,21,0.457,2,1,0.667,1,1,27,19,9,15,22,0.196,0.326,0.478,17.615,51,riffle_perfect
0,14,26,4,44,0.318,18,0.409,2,0,1.0,1,3,31,13,8,14,22,0.182,0.318,0.5,17.604,52,riffle_perfect
0,18,23,4,45,0.4,22,0.489,5,2,0.714,2,2,28,17,12,10,23,0.267,0.222,0.511,17.598,53,riffle_perfect
0,16,22,6,44,0.364,22,0.5,2,2,0.5,0,1,28,16,8,15,21,0.182,0.341,0.477,17.611,54,riffle_perfect
0,23,21,1,45,0.511,24,0.533,4,2,0.667,2,0,25,20,13,17,15,0.289,0.378,0.333,17.619,55,riffle_perfect
0,19,20,7,46,0.413,26,0.565,1,0,1.0,2,4,29,17,7,15,24,0.152,0.326,0.522,17.623,56,riffle_perfect
0,21,18,3,42,0.5,24,0.571,7,3,0.7,1,2,27,15,14,12,16,0.333,0.286,0.381,17.632,57,riffle_perfect
0,24,15,4,43,0.558,28,0.651,5,1,0.833,0,1,21,22,14,17,12,0.326,0.395,0.279,17.636,58,riffle_perfect
0,18,26,2,46,0.391,20,0.435,1,3,0.25,3,1,24,22,6,17,23,0.13,0.37,0.5,17.618,59,riffle_perfect
0,16,28,0,44,0.364,16,0.364,1,1,0.5,2,3,29,15,8,12,24,0.182,0.273,0.545,17.617,60,riffle_perfect
0,21,20,3,44,0.477,24,0.545,6,1,0.857,3,2,30,14,6,13,25,0.136,0.295,0.568,17.632,61,riffle_perfect
0,22,20,4,46,0.478,26,0.565,2,2,0.5,2,6,34,12,9,11,26,0.196,0.239,0.565,17.644,62,riffle_perfect
0,20,21,6,47,0.426,26,0.553,6,2,0.75,1,4,32,15,16,9,22,0.34,0.191,0.468,17.646,63,riffle_perfect
0,15,23,7,45,0.333,22,0.489,3,1,0.75,2,2,24,21,10,18,17,0.222,0.4,0.378,17.631,64,riffle_perfect
0,21,23,2,46,0.457,23,0.5,5,3,0.625,3,0,32,14,10,13,23,0.217,0.283,0.5,17.631,65,riffle_perfect
0,18,27,1,46,0.391,19,0.413,3,6,0.333,0,3,26,20,11,16,19,0.239,0.348,0.413,17.636,66,riffle_perfect
0,19,24,4,47,0.404,23,0.489,3,1,0.75,4,5,29,18,7,14,26,0.149,0.298,0.553,17.632,67,riffle_perfect
0,12,28,4,44,0.273,16,0.364,2,4,0.333,2,2,29,15,5,18,21,0.114,0.409,0.477,17.639,68,riffle_perfect
0,14,26,4,44,0.318,18,0.409,4,4,0.5,0,2,29,15,7,15,22,0.159,0.341,0.5,17.64,69,riffle_perfect
0,23,21,5,49,0.469,28,0.571,1,1,0.5,2,1,27,22,12,11,26,0.245,0.224,0.531,17.642,70,riffle_perfect
0,17,27,3,47,0.362,20,0.426,1,5,0.167,1,2,28,19,6,21,20,0.128,0.447,0.426,17.646,71,riffle_perfect
0,21,20,5,46,0.457,26,0.565,5,0,1.0,2,4,30,16,14,12,20,0.304,0.261,0.435,17.646,72,riffle_perfect
0,18,20,6,44,0.409,24,0.545,2,0,1.0,1,4,34,10,12,15,17,0.273,0.341,0.386,17.651,73,riffle_perfect
0,21,20,5,46,0.457,26,0.565,2,3,0.4,1,4,31,15,11,11,24,0.239,0.239,0.522,17.647,74,riffle_perfect
0,20,22,4,46,0.435,24,0.522,4,2,0.667,3,4,26,20,13,11,22,0.283,0.239,0.478,17.649,75,riffle_perfect
0,21,21,4,46,0.457,25,0.543,6,3,0.667,1,0,24,22,12,17,17,0.261,0.37,0.37,17.65,76,riffle_perfect
0,21,21,2,44,0.477,23,0.523,1,4,0.2,2,1,25,19,12,17,15,0.273,0.386,0.341,17.648,77,riffle_perfect
0,16,26,3,45,0.356,19,0.422,2,0,1.0,1,2,32,13,11,13,21,0.244,0.289,0.467,17.654,78,riffle_perfect
0,12,28,4,44,0.273,16,0.364,1,3,0.25,3,2,22,22,7,18,19,0.159,0.409,0.432,17.656,79,riffle_perfect
0,22,24,1,47,0.468,23,0.489,3,2,0.6,1,3,27,20,13,15,19,0.277,0.319,0.404,17.666,80,riffle_perfect
0,24,17,3,44,0.545,27,0.614,3,3,0.5,2,2,32,12,16,8,20,0.364,0.182,0.455,17.671,81,riffle_perfect
0,15,29,4,48,0.312,19,0.396,3,3,0.5,2,3,30,18,5,22,21,0.104,0.458,0.438,17.682,82,riffle_perfect
0,15,27,4,46,0.326,19,0.413,1,1,0.5,1,4,29,17,8,14,24,0.174,0.304,0.522,17.68,83,riffle_perfect
0,23,22,3,48,0.479,26,0.542,3,4,0.429,6,2,20,28,13,14,21,0.271,0.292,0.438,17.661,84,riffle_perfect
0,24,18,2,44,0.545,26,0.591,2,1,0.667,3,3,29,15,15,8,21,0.341,0.182,0.477,17.656,85,riffle_perfect
0,22,19,6,47,0.468,28,0.596,6,3,0.667,0,3,28,19,12,14,21,0.255,0.298,0.447,17.662,86,riffle_perfect
0,18,24,2,44,0.409,20,0.455,5,3,0.625,1,0,26,18,9,13,22,0.205,0.295,0.5,17.664,87,riffle_perfect
0,23,20,2,45,0.511,25,0.556,1,2,0.333,5,1,22,23,14,17,14,0.311,0.378,0.311,17.664,88,riffle_perfect
0,22,19,5,46,0.478,27,0.587,5,1,0.833,3,0,26,20,9,16,21,0.196,0.348,0.457,17.662,89,riffle_perfect
0,20,23,2,45,0.444,22,0.489,1,5,0.167,5,1,22,23,10,17,18,0.222,0.378,0.4,17.659,90,riffle_perfect
0,26,16,1,43,0.605,27,0.628,5,1,0.833,3,0,23,20,14,13,16,0.326,0.302,0.372,17.649,91,riffle_perfect
0,24,19,1,44,0.545,25,0.568,4,1,0.8,1,3,25,19,12,19,13,0.273,0.432,0.295,17.65,92,riffle_perfect
0,20,22,6,48,0.417,26,0.542,3,1,0.75,2,1,27,21,10,18,20,0.208,0.375,0.417,17.643,93,riffle_perfect
0,22,21,2,45,0.489,24,0.533,2,2,0.5,3,2,28,17,9,14,22,0.2,0.311,0.489,17.638,94,riffle_perfect
0,17,23,6,46,0.37,23,0.5,3,3,0.5,3,1,29,17,9,15,22,0.196,0.326,0.478,17.643,95,riffle_perfect
0,20,21,4,45,0.444,24,0.533,3,2,0.6,1,0,26,19,12,11,22,0.267,0.244,0.489,17.65,96,riffle_perfect
0,22,22,2,46,0.478,24,0.522,5,1,0.833,4,3,22,24,14,13,19,0.304,0.283,0.413,16.808,1,riffle_perfect
0,18,27,2,47,0.383,20,0.426,1,4,0.2,0,3,31,16,11,16,20,0.234,0.34,0.426,17.558,2,riffle_perfect
0,14,22,10,46,0.304,24,0.522,1,0,1.0,0,4,25,21,8,19,19,0.174,0.413,0.413,17.795,3,riffle_perfect
0,19,25,3,47,0.404,22,0.468,1,3,0.25,3,2,27,20,10,15,22,0.213,0.319,0.468,17.634,4,riffle_perfect
0,23,20,2,45,0.511,25,0.556,1,2,0.333,1,1,30,15,10,17,18,0.222,0.378,0.4,17.694,5,riffle_perfect
0,16,26,4,46,0.348,20,0.435,2,1,0.667,3,1,29,17,10,13,23,0.217,0.283,0.5,17.638,6,riffle_perfect
0,24,20,3,47,0.511,27,0.574,2,3,0.4,5,1,34,13,8,15,24,0.17,0.319,0.511,17.59,7,riffle_perfect
0,22,20,3,45,0.489,25,0.556,0,2,0.0,1,2,27,18,15,12,18,0.333,0.267,0.4,17.592,8,riffle_perfect
0,17,25,5,47,0.362,22,0.468,3,2,0.6,1,4,27,20,8,15,24,0.17,0.319,0.511,17.626,9,riffle_perfect
0,13,25,7,45,0.289,20,0.444,1,1,0.5,0,5,32,13,7,15,23,0.156,0.333,0.511,17.701,10,riffle_perfect
0,19,27,1,47,0.404,20,0.426,4,6,0.4,2,1,26,21,11,15,21,0.234,0.319,0.447,17.689,11,riffle_perfect
0,24,21,2,47,0.511,26,0.553,3,1,0.75,1,4,29,18,18,12,17,0.383,0.255,0.362,17.705,12,riffle_perfect
0,16,29,0,45,0.356,16,0.356,2,0,1.0,1,4,29,16,10,12,23,0.222,0.267,0.511,17.666,13,riffle_perfect
0,17,23,4,44,0.386,21,0.477,3,2,0.6,3,1,30,14,11,12,21,0.25,0.273,0.477,17.704,14,riffle_perfect
0,19,20,4,43,0.442,23,0.535,2,1,0.667,1,4,30,13,13,9,21,0.302,0.209,0.488,17.677,15,riffle_perfect
0,25,18,4,47,0.532,29,0.617,3,1,0.75,2,4,27,20,12,11,24,0.255,0.234,0.511,17.669,16,riffle_perfect
0,20,21,3,44,0.455,23,0.523,4,2,0.667,0,3,29,15,13,12,19,0.295,0.273,0.432,17.698,17,riffle_perfect
0,14,28,3,45,0.311,17,0.378,1,1,0.5,0,2,28,17,10,18,17,0.222,0.4,0.378,17.724,18,riffle_perfect
0,16,27,1,44,0.364,17,0.386,0,3,0.0,2,1,25,19,11,12,21,0.25,0.273,0.477,17.69,19,riffle_perfect
0,14,29,1,44,0.318,15,0.341,2,4,0.333,3,2,28,16,7,16,21,0.159,0.364,0.477,17.678,20,riffle_perfect
0,20,21,5,46,0.435,25,0.543,5,1,0.833,2,4,29,17,7,14,25,0.152,0.304,0.543,17.703,21,riffle_perfect
0,19,20,6,45,0.422,25,0.556,3,1,0.75,1,2,32,13,11,14,20,0.244,0.311,0.444,17.696,22,riffle_perfect
0,18,26,4,48,0.375,22,0.458,2,4,0.333,3,4,29,19,7,18,23,0.146,0.375,0.479,17.698,23,riffle_perfect
0,19,26,1,46,0.413,20,0.435,1,3,0.25,3,5,25,21,9,16,21,0.196,0.348,0.457,17.68,24,riffle_perfect
0,19,22,3,44,0.432,22,0.5,2,3,0.4,1,3,31,13,16,12,16,0.364,0.273,0.364,17.708,25,riffle_perfect
0,20,23,2,45,0.444,22,0.489,1,1,0.5,2,5,31,14,10,13,22,0.222,0.289,0.489,17.685,26,riffle_perfect
0,25,16,4,45,0.556,29,0.644,2,1,0.667,4,2,27,18,11,15,19,0.244,0.333,0.422,17.69,27,riffle_perfect
0,21,21,2,44,0.477,23,0.523,3,2,0.6,2,2,29,15,14,14,16,0.318,0.318,0.364,17.701,28,riffle_perfect
0,23,17,4,44,0.523,27,0.614,2,1,0.667,1,4,25,19,13,11,20,0.295,0.25,0.455,17.686,29,riffle_perfect
0,20,20,4,44,0.455,24,0.545,4,4,0.5,0,1,27,17,16,11,17,0.364,0.25,0.386,17.699,30,riffle_perfect
0,14,24,6,44,0.318,20,0.455,1,1,0.5,3,0,28,16,10,13,21,0.227,0.295,0.477,17.677,31,riffle_perfect
0,16,22,6,44,0.364,22,0.5,1,1,0.5,2,3,29,15,11,14,19,0.25,0.318,0.432,17.681,32,riffle_perfect
0,22,20,2,44,0.5,24,0.545,5,1,0.833,3,2,22,22,10,20,14,0.227,0.455,0.318,17.679,33,riffle_perfect
0,18,23,5,46,0.391,23,0.5,3,2,0.6,1,2,27,19,8,12,26,0.174,0.261,0.565,17.666,34,riffle_perfect
0,19,24,3,46,0.413,22,0.478,3,5,0.375,1,0,27,19,11,16,19,0.239,0.348,0.413,17.663,35,riffle_perfect
0,16,30,1,47,0.34,17,0.362,5,2,0.714,0,4,27,20,9,16,22,0.191,0.34,0.468,17.673,36,riffle_perfect
0,17,25,2,44,0.386,19,0.432,6,2,0.75,0,1,24,20,8,17,19,0.182,0.386,0.432,17.678,37,riffle_perfect
0,16,23,4,43,0.372,20,0.465,1,3,0.25,1,1,30,13,9,15,19,0.209,0.349,0.442,17.691,38,riffle_perfect
0,29,13,2,44,0.659,31,0.705,7,1,0.875,2,1,29,15,13,14,17,0.295,0.318,0.386,17.702,39,riffle_perfect
0,13,24,8,45,0.289,21,0.467,3,2,0.6,1,2,28,17,9,10,26,0.2,0.222,0.578,17.701,40,riffle_perfect
0,19,21,6,46,0.413,25,0.543,3,2,0.6,2,3,31,15,10,14,22,0.217,0.304,0.478,17.696,41,riffle_perfect
0,20,18,5,43,0.465,25,0.581,3,3,0.5,2,0,24,19,11,16,16,0.256,0.372,0.372,17.69,42,riffle_perfect
0,19,22,5,46,0.413,24,0.522,3,4,0.429,2,1,25,21,10,16,20,0.217,0.348,0.435,17.693,43,riffle_perfect
0,20,20,5,45,0.444,25,0.556,5,1,0.833,2,2,33,12,8,10,27,0.178,0.222,0.6,17.7,44,riffle_perfect
0,17,26,0,43,0.395,17,0.395,2,1,0.667,3,2,30,13,8,14,21,0.186,0.326,0.488,17.694,45,riffle_perfect
0,21,22,2,45,0.467,23,0.511,4,2,0.667,1,1,26,19,15,9,21,0.333,0.2,0.467,17.691,46,riffle_perfect
0,17,22,5,44,0.386,22,0.5,2,1,0.667,2,3,29,15,6,21,17,0.136,0.477,0.386,17.692,47,riffle_perfect
0,22,20,5,47,0.468,27,0.574,3,1,0.75,1,5,32,15,13,13,21,0.277,0.277,0.447,17.687,48,riffle_perfect
0,19,24,3,46,0.413,22,0.478,0,1,0.0,2,1,23,23,12,18,16,0.261,0.391,0.348,17.687,49,riffle_perfect
0,17,23,3,43,0.395,20,0.465,4,4,0.5,1,3,24,19,9,17,17,0.209,0.395,0.395,17.678,50,riffle_perfect
0,20,25,3,48,0.417,23,0.479,4,2,0.667,3,3,30,18,10,14,24,0.208,0.292,0.5,17.671,51,riffle_perfect
0,19,25,5,49,0.388,24,0.49,2,4,0.333,1,4,24,25,8,20,21,0.163,0.408,0.429,17.674,52,riffle_perfect
0,19,23,4,46,0.413,23,0.5,3,1,0.75,2,4,34,12,9,13,24,0.196,0.283,0.522,17.668,53,riffle_perfect
0,17,32,1,50,0.34,18,0.36,0,3,0.0,1,2,30,20,10,19,21,0.2,0.38,0.42,17.663,54,riffle_perfect
0,18,23,3,44,0.409,21,0.477,2,0,1.0,0,2,28,16,8,17,19,0.182,0.386,0.432,17.665,55,riffle_perfect
0,18,23,5,46,0.391,23,0.5,4,1,0.8,1,2,33,13,14,11,21,0.304,0.239,0.457,17.663,56,riffle_perfect
0,20,16,9,45,0.444,29,0.644,2,1,0.667,1,1,25,20,11,15,19,0.244,0.333,0.422,17.668,57,riffle_perfect
0,22,19,4,45,0.489,26,0.578,5,5,0.5,2,1,21,24,14,17,14,0.311,0.378,0.311,17.668,58,riffle_perfect
0,26,16,3,45,0.578,29,0.644,6,1,0.857,4,0,28,17,14,15,16,0.311,0.333,0.356,17.665,59,riffle_perfect
0,20,18,7,45,0.444,27,0.6,2,2,0.5,3,3,22,23,9,21,15,0.2,0.467,0.333,17.661,60,riffle_perfect
0,28,20,2,50,0.56,30,0.6,5,2,0.714,3,3,28,22,18,8,24,0.36,0.16,0.48,17.644,61,riffle_perfect
0,21,20,4,45,0.467,25,0.556,3,2,0.6,4,1,19,26,11,17,17,0.244,0.378,0.378,17.647,62,riffle_perfect
0,19,22,5,46,0.413,24,0.522,1,3,0.25,3,0,28,18,9,15,22,0.196,0.326,0.478,17.657,63,riffle_perfect
0,22,19,2,43,0.512,24,0.558,2,1,0.667,1,2,25,18,14,13,16,0.326,0.302,0.372,17.652,64,riffle_perfect
0,23,18,4,45,0.511,27,0.6,4,3,0.571,3,2,22,23,13,11,21,0.289,0.244,0.467,17.643,65,riffle_perfect
0,21,19,5,45,0.467,26,0.578,3,4,0.429,1,1,26,19,14,14,17,0.311,0.311,0.378,17.649,66,riffle_perfect
0,20,24,4,48,0.417,24,0.5,1,3,0.25,1,4,29,19,11,18,19,0.229,0.375,0.396,17.646,67,riffle_perfect
0,17,27,1,45,0.378,18,0.4,0,2,0.0,3,1,30,15,6,11,28,0.133,0.244,0.622,17.635,68,riffle_perfect
0,22,21,3,46,0.478,25,0.543,2,2,0.5,2,3,32,14,11,7,28,0.239,0.152,0.609,17.63,69,riffle_perfect
0,19,24,2,45,0.422,21,0.467,2,4,0.333,5,4,29,16,8,15,22,0.178,0.333,0.489,17.627,70,riffle_perfect
0,25,18,3,46,0.543,28,0.609,4,5,0.444,3,1,29,17,15,9,22,0.326,0.196,0.478,17.621,71,riffle_perfect
0,12,28,3,43,0.279,15,0.349,3,3,0.5,0,2,32,11,6,13,24,0.14,0.302,0.558,17.627,72,riffle_perfect
0,27,19,1,47,0.574,28,0.596,5,3,0.625,2,3,25,22,13,16,18,0.277,0.34,0.383,17.621,73,riffle_perfect
0,20,18,8,46,0.435,28,0.609,2,1,0.667,4,3,29,17,10,18,18,0.217,0.391,0.391,17.623,74,riffle_perfect
0,20,22,3,45,0.444,23,0.511,4,1,0.8,0,5,24,21,7,20,18,0.156,0.444,0.4,17.628,75,riffle_perfect
0,15,27,3,45,0.333,18,0.4,1,3,0.25,3,6,31,14,8,17,20,0.178,0.378,0.444,17.624,76,riffle_perfect
0,21,22,3,46,0.457,24,0.522,1,3,0.25,2,1,33,13,11,13,22,0.239,0.283,0.478,17.623,77,riffle_perfect
0,16,24,6,46,0.348,22,0.478,4,0,1.0,6,4,30,16,7,17,22,0.152,0.37,0.478,17.629,78,riffle_perfect
0,18,25,5,48,0.375,23,0.479,1,3,0.25,3,3,29,19,7,19,22,0.146,0.396,0.458,17.628,79,riffle_perfect
0,22,20,4,46,0.478,26,0.565,5,2,0.714,1,0,28,18,15,16,15,0.326,0.348,0.326,17.635,80,riffle_perfect
0,20,21,3,44,0.455,23,0.523,1,4,0.2,2,2,23,21,15,16,13,0.341,0.364,0.295,17.636,81,riffle_perfect
0,21,23,2,46,0.457,23,0.5,3,2,0.6,2,4,29,17,13,11,22,0.283,0.239,0.478,17.642,82,riffle_perfect
0,18,23,7,48,0.375,25,0.521,5,1,0.833,3,6,28,20,12,16,20,0.25,0.333,0.417,17.643,83,riffle_perfect
0,19,20,5,44,0.432,24,0.545,2,2,0.5,0,2,24,20,12,12,20,0.273,0.273,0.455,17.642,84,riffle_perfect
0,19,19,7,45,0.422,26,0.578,1,1,0.5,2,2,26,19,8,16,21,0.178,0.356,0.467,17.641,85,riffle_perfect
0,23,18,4,45,0.511,27,0.6,3,2,0.6,3,0,24,21,15,12,18,0.333,0.267,0.4,17.643,86,riffle_perfect
0,19,22,2,43,0.442,21,0.488,2,4,0.333,1,1,23,20,13,14,16,0.302,0.326,0.372,17.648,87,riffle_perfect
0,23,21,2,46,0.5,25,0.543,8,2,0.8,3,2,25,21,15,12,19,0.326,0.261,0.413,17.644,88,riffle_perfect
0,16,22,4,42,0.381,20,0.476,3,1,0.75,0,3,26,16,12,13,17,0.286,0.31,0.405,17.652,89,riffle_perfect
0,19,25,1,45,0.422,20,0.444,0,4,0.0,2,2,28,17,15,15,15,0.333,0.333,0.333,17.653,90,riffle_perfect
0,22,17,6,45,0.489,28,0.622,2,1,0.667,2,3,28,17,13,8,24,0.289,0.178,0.533,17.654,91,riffle_perfect
0,23,17,7,47,0.489,30,0.638,4,0,1.0,1,2,31,16,12,10,25,0.255,0.213,0.532,17.655,92,riffle_perfect
0,19,23,3,45,0.422,22,0.489,4,2,0.667,1,2,29,16,12,15,18,0.267,0.333,0.4,17.658,93,riffle_perfect
0,23,20,1,44,0.523,24,0.545,2,2,0.5,2,0,28,16,12,12,20,0.273,0.273,0.455,17.66,94,riffle_perfect
0,21,22,2,45,0.467,23,0.511,2,1,0.667,3,1,25,20,12,12,21,0.267,0.267,0.467,17.657,95,riffle_perfect
0,23,24,2,49,0.469,25,0.51,6,2,0.75,4,4,29,20,12,19,18,0.245,0.388,0.367,17.655,96,riffle_perfect
0,10,34,3,47,0.213,13,0.277,2,4,0.333,1,1,28,19,6,18,23,0.128,0.383,0.489,17.897,1,riffle_perfect
0,19,26,2,47,0.404,21,0.447,1,5,0.167,2,3,26,21,10,17,20,0.213,0.362,0.426,17.638,2,riffle_perfect
0,15,26,3,44,0.341,18,0.409,5,1,0.833,0,2,29,15,9,16,19,0.205,0.364,0.432,17.965,3,riffle_perfect
0,15,26,3,44,0.341,18,0.409,1,2,0.333,2,2,25,19,9,18,17,0.205,0.409,0.386,18.231,4,riffle_perfect
0,24,18,3,45,0.533,27,0.6,3,3,0.5,2,2,21,24,14,17,14,0.311,0.378,0.311,18.014,5,riffle_perfect
0,23,17,5,45,0.511,28,0.622,4,0,1.0,3,1,26,19,10,17,18,0.222,0.378,0.4,18.011,6,riffle_perfect
0,22,24,1,47,0.468,23,0.489,6,6,0.5,0,2,29,18,12,15,20,0.255,0.319,0.426,17.931,7,riffle_perfect
0,13,23,6,42,0.31,19,0.452,2,1,0.667,0,1,32,10,7,12,23,0.167,0.286,0.548,17.918,8,riffle_perfect
0,21,23,4,48,0.438,25,0.521,4,3,0.571,2,3,30,18,12,13,23,0.25,0.271,0.479,17.885,9,riffle_perfect
0,18,26,1,45,0.4,19,0.422,2,5,0.286,3,3,27,18,10,16,19,0.222,0.356,0.422,17.962,10,riffle_perfect
0,20,23,3,46,0.435,23,0.5,2,0,1.0,3,2,25,21,9,16,21,0.196,0.348,0.457,17.907,11,riffle_perfect
0,21,20,6,47,0.447,27,0.574,1,2,0.333,5,2,31,16,10,11,26,0.213,0.234,0.553,17.866,12,riffle_perfect
0,17,24,6,47,0.362,23,0.489,3,6,0.333,1,2,24,23,11,18,18,0.234,0.383,0.383,17.902,13,riffle_perfect
0,22,19,3,44,0.5,25,0.568,5,1,0.833,2,1,24,20,13,13,18,0.295,0.295,0.409,17.903,14,riffle_perfect
0,17,23,5,45,0.378,22,0.489,5,1,0.833,2,4,28,17,8,15,22,0.178,0.333,0.489,17.894,15,riffle_perfect
0,24,22,3,49,0.49,27,0.551,3,0,1.0,4,1,27,22,6,20,23,0.122,0.408,0.469,17.896,16,riffle_perfect
0,22,23,5,50,0.44,27,0.54,1,2,0.333,5,2,32,18,9,14,27,0.18,0.28,0.54,17.829,17,riffle_perfect
0,21,20,4,45,0.467,25,0.556,5,0,1.0,4,1,25,20,8,19,18,0.178,0.422,0.4,17.801,18,riffle_perfect
0,19,21,7,47,0.404,26,0.553,5,2,0.714,2,4,27,20,10,20,17,0.213,0.426,0.362,17.833,19,riffle_perfect
0,22,19,5,46,0.478,27,0.587,4,3,0.571,2,1,21,25,13,13,20,0.283,0.283,0.435,17.803,20,riffle_perfect
0,21,23,2,46,0.457,23,0.5,2,1,0.667,2,1,27,19,9,21,16,0.196,0.457,0.348,17.806,21,riffle_perfect
0,22,18,3,43,0.512,25,0.581,5,1,0.833,0,1,24,19,11,13,19,0.256,0.302,0.442,17.817,22,riffle_perfect
0,22,19,2,43,0.512,24,0.558,3,0,1.0,1,2,26,17,13,12,18,0.302,0.279,0.419,17.807,23,riffle_perfect
0,12,25,8,45,0.267,20,0.444,1,4,0.2,2,0,24,21,8,16,21,0.178,0.356,0.467,17.816,24,riffle_perfect
0,23,18,5,46,0.5,28,0.609,5,1,0.833,1,4,25,21,15,13,18,0.326,0.283,0.391,17.815,25,riffle_perfect
0,20,21,5,46,0.435,25,0.543,3,4,0.429,3,0,28,18,14,14,18,0.304,0.304,0.391,17.803,26,riffle_perfect
0,27,14,3,44,0.614,30,0.682,4,2,0.667,2,2,22,22,18,12,14,0.409,0.273,0.318,17.796,27,riffle_perfect
0,14,23,7,44,0.318,21,0.477,4,2,0.667,1,2,30,14,7,12,25,0.159,0.273,0.568,17.812,28,riffle_perfect
0,22,18,4,44,0.5,26,0.591,3,3,0.5,5,3,24,20,13,11,20,0.295,0.25,0.455,17.806,29,riffle_perfect
0,18,22,2,42,0.429,20,0.476,1,3,0.25,1,2,25,17,13,13,16,0.31,0.31,0.381,17.823,30,riffle_perfect
0,21,19,5,45,0.467,26,0.578,5,3,0.625,1,2,23,22,10,17,18,0.222,0.378,0.4,17.828,31,riffle_perfect
0,19,21,4,44,0.432,23,0.523,2,0,1.0,2,3,29,15,6,14,24,0.136,0.318,0.545,17.815,32,riffle_perfect
0,13,28,6,47,0.277,19,0.404,1,2,0.333,0,6,34,13,5,16,26,0.106,0.34,0.553,17.812,33,riffle_perfect
0,26,21,0,47,0.553,26,0.553,9,3,0.75,1,1,31,16,15,7,25,0.319,0.149,0.532,17.808,34,riffle_perfect
0,18,22,3,43,0.419,21,0.488,4,4,0.5,1,0,26,17,9,14,20,0.209,0.326,0.465,17.811,35,riffle_perfect
0,23,20,4,47,0.489,27,0.574,6,2,0.75,2,3,27,20,17,10,20,0.362,0.213,0.426,17.804,36,riffle_perfect
0,27,16,5,48,0.562,32,0.667,3,2,0.6,1,4,30,18,21,11,16,0.438,0.229,0.333,17.807,37,riffle_perfect
0,17,24,3,44,0.386,20,0.455,2,2,0.5,3,2,32,12,11,11,22,0.25,0.25,0.5,17.804,38,riffle_perfect
0,20,23,1,44,0.455,21,0.477,3,4,0.429,3,3,29,15,9,12,23,0.205,0.273,0.523,17.795,39,riffle_perfect
0,21,20,4,45,0.467,25,0.556,2,4,0.333,5,2,25,20,10,16,19,0.222,0.356,0.422,17.808,40,riffle_perfect
0,13,23,8,44,0.295,21,0.477,3,2,0.6,1,2,29,15,9,16,19,0.205,0.364,0.432,17.8,41,riffle_perfect
0,19,20,4,43,0.442,23,0.535,5,0,1.0,0,1,24,19,15,13,15,0.349,0.302,0.349,17.813,42,riffle_perfect
0,24,17,5,46,0.522,29,0.63,2,1,0.667,2,1,22,24,10,22,14,0.217,0.478,0.304,17.818,43,riffle_perfect
0,17,26,2,45,0.378,19,0.422,3,2,0.6,1,1,30,15,8,16,21,0.178,0.356,0.467,17.832,44,riffle_perfect
0,21,22,3,46,0.457,24,0.522,4,2,0.667,5,5,30,16,8,13,25,0.174,0.283,0.543,17.801,45,riffle_perfect
0,16,26,4,46,0.348,20,0.435,0,2,0.0,1,2,34,12,5,15,26,0.109,0.326,0.565,17.795,46,riffle_perfect
0,20,22,3,45,0.444,23,0.511,4,0,1.0,1,3,32,13,12,13,20,0.267,0.289,0.444,17.79,47,riffle_perfect
0,22,20,4,46,0.478,26,0.565,2,2,0.5,1,2,29,17,12,12,22,0.261,0.261,0.478,17.798,48,riffle_perfect
0,20,22,2,44,0.455,22,0.5,5,1,0.833,1,3,27,17,10,14,20,0.227,0.318,0.455,17.775,49,riffle_perfect
0,23,23,2,48,0.479,25,0.521,6,3,0.667,2,3,28,20,15,16,17,0.312,0.333,0.354,17.773,50,riffle_perfect
0,15,27,6,48,0.312,21,0.438,1,5,0.167,2,3,33,15,7,13,28,0.146,0.271,0.583,17.77,51,riffle_perfect
0,16,27,1,44,0.364,17,0.386,3,2,0.6,0,3,27,17,10,16,18,0.227,0.364,0.409,17.776,52,riffle_perfect
0,19,23,6,48,0.396,25,0.521,3,1,0.75,5,1,29,19,7,18,23,0.146,0.375,0.479,17.777,53,riffle_perfect
0,21,21,6,48,0.438,27,0.562,1,3,0.25,5,3,27,21,9,13,26,0.188,0.271,0.542,17.747,54,riffle_perfect
0,13,27,5,45,0.289,18,0.4,1,3,0.25,2,2,24,21,7,16,22,0.156,0.356,0.489,17.746,55,riffle_perfect
0,19,21,4,44,0.432,23,0.523,3,1,0.75,2,1,26,18,9,14,21,0.205,0.318,0.477,17.747,56,riffle_perfect
0,17,24,4,45,0.378,21,0.467,4,2,0.667,2,2,25,20,12,15,18,0.267,0.333,0.4,17.739,57,riffle_perfect
0,14,26,6,46,0.304,20,0.435,3,4,0.429,2,2,28,18,7,18,21,0.152,0.391,0.457,17.749,58,riffle_perfect
0,23,18,6,47,0.489,29,0.617,2,2,0.5,2,1,23,24,13,12,22,0.277,0.255,0.468,17.754,59,riffle_perfect
0,16,23,5,44,0.364,21,0.477,1,2,0.333,0,2,23,21,10,20,14,0.227,0.455,0.318,17.759,60,riffle_perfect
0,21,22,2,45,0.467,23,0.511,1,0,1.0,2,2,30,15,13,13,19,0.289,0.289,0.422,17.762,61,riffle_perfect
0,17,21,7,45,0.378,24,0.533,5,0,1.0,1,5,27,18,10,13,22,0.222,0.289,0.489,17.762,62,riffle_perfect
0,27,19,1,47,0.574,28,0.596,5,2,0.714,1,2,24,23,15,18,14,0.319,0.383,0.298,17.765,63,riffle_perfect
0,23,18,4,45,0.511,27,0.6,6,2,0.75,4,2,30,15,16,11,18,0.356,0.244,0.4,17.758,64,riffle_perfect
0,25,19,3,47,0.532,28,0.596,7,0,1.0,3,0,35,12,11,14,22,0.234,0.298,0.468,17.763,65,riffle_perfect
0,16,24,6,46,0.348,22,0.478,1,0,1.0,3,3,27,19,12,14,20,0.261,0.304,0.435,17.765,66,riffle_perfect
0,20,20,5,45,0.444,25,0.556,5,3,0.625,1,2,26,19,14,14,17,0.311,0.311,0.378,17.765,67,riffle_perfect
0,18,22,6,46,0.391,24,0.522,3,3,0.5,3,6,28,18,12,10,24,0.261,0.217,0.522,17.752,68,riffle_perfect
0,20,17,8,45,0.444,28,0.622,3,0,1.0,0,2,29,16,11,12,22,0.244,0.267,0.489,17.76,69,riffle_perfect
0,22,22,2,46,0.478,24,0.522,5,1,0.833,4,1,28,18,10,16,20,0.217,0.348,0.435,17.755,70,riffle_perfect
0,20,25,2,47,0.426,22,0.468,0,4,0.0,1,2,35,12,11,10,26,0.234,0.213,0.553,17.75,71,riffle_perfect
0,22,19,5,46,0.478,27,0.587,4,5,0.444,3,1,26,20,14,13,19,0.304,0.283,0.413,17.747,72,riffle_perfect
0,21,26,2,49,0.429,23,0.469,2,4,0.333,2,4,23,26,8,19,22,0.163,0.388,0.449,17.736,73,riffle_perfect
0,20,18,7,45,0.444,27,0.6,3,4,0.429,2,2,27,18,13,14,18,0.289,0.311,0.4,17.738,74,riffle_perfect
0,18,20,5,43,0.419,23,0.535,5,0,1.0,2,3,24,19,11,13,19,0.256,0.302,0.442,17.736,75,riffle_perfect
0,20,21,3,44,0.455,23,0.523,2,3,0.4,1,2,31,13,13,10,21,0.295,0.227,0.477,17.736,76,riffle_perfect
0,19,24,4,47,0.404,23,0.489,3,3,0.5,3,1,22,25,9,19,19,0.191,0.404,0.404,17.735,77,riffle_perfect
0,14,27,4,45,0.311,18,0.4,2,3,0.4,1,4,22,23,9,19,17,0.2,0.422,0.378,17.737,78,riffle_perfect
0,13,29,4,46,0.283,17,0.37,2,3,0.4,1,2,33,13,4,14,28,0.087,0.304,0.609,17.726,79,riffle_perfect
0,21,18,6,45,0.467,27,0.6,8,1,0.889,4,1,28,17,12,11,22,0.267,0.244,0.489,17.733,80,riffle_perfect
0,21,17,5,43,0.488,26,0.605,2,4,0.333,1,2,19,24,15,20,8,0.349,0.465,0.186,17.738,81,riffle_perfect
0,16,26,3,45,0.356,19,0.422,5,1,0.833,1,3,30,15,9,16,20,0.2,0.356,0.444,17.746,82,riffle_perfect
0,21,23,2,46,0.457,23,0.5,2,0,1.0,3,4,34,12,9,10,27,0.196,0.217,0.587,17.742,83,riffle_perfect
0,16,25,2,43,0.372,18,0.419,2,4,0.333,3,1,28,15,11,14,18,0.256,0.326,0.419,17.738,84,riffle_perfect
0,23,22,3,48,0.479,26,0.542,5,1,0.833,1,3,30,18,8,16,24,0.167,0.333,0.5,17.736,85,riffle_perfect
0,23,16,5,44,0.523,28,0.636,3,2,0.6,3,3,26,18,14,11,19,0.318,0.25,0.432,17.732,86,riffle_perfect
0,27,16,6,49,0.551,33,0.673,5,1,0.833,1,0,29,20,14,13,22,0.286,0.265,0.449,17.731,87,riffle_perfect
0,22,21,1,44,0.5,23,0.523,3,2,0.6,5,2,25,19,14,12,18,0.318,0.273,0.409,17.73,88,riffle_perfect
0,20,23,3,46,0.435,23,0.5,2,1,0.667,4,2,29,17,10,16,20,0.217,0.348,0.435,17.728,89,riffle_perfect
0,22,19,6,47,0.468,28,0.596,2,4,0.333,3,0,29,18,12,15,20,0.255,0.319,0.426,17.732,90,riffle_perfect
0,22,23,4,49,0.449,26,0.531,2,2,0.5,3,2,28,21,15,13,21,0.306,0.265,0.429,17.733,91,riffle_perfect
0,22,19,2,43,0.512,24,0.558,6,4,0.6,2,0,23,20,12,14,17,0.279,0.326,0.395,17.738,92,riffle_perfect
0,19,19,6,44,0.432,25,0.568,3,1,0.75,1,2,27,17,10,17,17,0.227,0.386,0.386,17.735,93,riffle_perfect
0,17,23,6,46,0.37,23,0.5,0,3,0.0,2,4,28,18,10,16,20,0.217,0.348,0.435,17.734,94,riffle_perfect
0,19,20,6,45,0.422,25,0.556,4,2,0.667,0,3,27,18,14,13,18,0.311,0.289,0.4,17.738,95,riffle_perfect
0,19,17,10,46,0.413,29,0.63,1,4,0.2,4,1,31,15,8,17,21,0.174,0.37,0.457,17.732,96,riffle_perfect
0,16,28,4,48,0.333,20,0.417,0,8,0.0,0,1,30,18,10,17,21,0.208,0.354,0.438,18.606,1,riffle_perfect
0,25,20,2,47,0.532,27,0.574,5,2,0.714,2,2,24,23,16,16,15,0.34,0.34,0.319,18.431,2,riffle_perfect
0,16,26,3,45,0.356,19,0.422,3,1,0.75,2,2,25,20,10,12,23,0.222,0.267,0.511,18.273,3,riffle_perfect
0,20,28,1,49,0.408,21,0.429,4,5,0.444,1,3,23,26,14,18,17,0.286,0.367,0.347,18.096,4,riffle_perfect
0,12,32,4,48,0.25,16,0.333,3,3,0.5,1,3,27,21,4,23,21,0.083,0.479,0.438,18.141,5,riffle_perfect
0,24,19,1,44,0.545,25,0.568,2,2,0.5,2,3,26,18,13,13,18,0.295,0.295,0.409,18.121,6,riffle_perfect
0,18,25,4,47,0.383,22,0.468,2,0,1.0,3,2,31,16,9,12,26,0.191,0.255,0.553,18.025,7,riffle_perfect
0,18,25,3,46,0.391,21,0.457,1,1,0.5,4,0,26,20,9,19,18,0.196,0.413,0.391,17.996,8,riffle_perfect
0,16,22,7,45,0.356,23,0.511,1,1,0.5,4,2,30,15,7,16,22,0.156,0.356,0.489,17.963,9,riffle_perfect
0,26,20,1,47,0.553,27,0.574,2,2,0.5,4,3,24,23,16,15,16,0.34,0.319,0.34,17.959,10,riffle_perfect
0,21,18,5,44,0.477,26,0.591,2,2,0.5,3,4,28,16,12,15,17,0.273,0.341,0.386,17.888,11,riffle_perfect
0,25,16,3,44,0.568,28,0.636,2,2,0.5,2,2,28,16,13,12,19,0.295,0.273,0.432,17.89,12,riffle_perfect
0,22,19,4,45,0.489,26,0.578,5,3,0.625,1,1,25,20,13,13,19,0.289,0.289,0.422,17.869,13,riffle_perfect
0,22,21,5,48,0.458,27,0.562,1,2,0.333,4,3,31,17,8,12,28,0.167,0.25,0.583,17.826,14,riffle_perfect
0,18,24,3,45,0.4,21,0.467,5,4,0.556,1,3,25,20,13,13,19,0.289,0.289,0.422,17.841,15,riffle_perfect
0,19,28,1,48,0.396,20,0.417,3,3,0.5,3,3,25,23,9,18,21,0.188,0.375,0.438,17.802,16,riffle_perfect
0,25,18,2,45,0.556,27,0.6,5,4,0.556,2,1,27,18,12,15,18,0.267,0.333,0.4,17.811,17,riffle_perfect
0,17,23,3,43,0.395,20,0.465,4,3,0.571,1,3,25,18,13,15,15,0.302,0.349,0.349,17.85,18,riffle_perfect
0,21,21,3,45,0.467,24,0.533,0,2,0.0,2,1,28,17,12,11,22,0.267,0.244,0.489,17.853,19,riffle_perfect
0,16,24,5,45,0.356,21,0.467,1,2,0.333,2,1,24,21,9,13,23,0.2,0.289,0.511,17.805,20,riffle_perfect
0,21,19,7,47,0.447,28,0.596,3,6,0.333,6,2,27,20,6,16,25,0.128,0.34,0.532,17.755,21,riffle_perfect
0,17,24,4,45,0.378,21,0.467,3,2,0.6,2,3,28,17,7,14,24,0.156,0.311,0.533,17.794,22,riffle_perfect
0,20,19,6,45,0.444,26,0.578,5,2,0.714,2,1,22,23,10,18,17,0.222,0.4,0.378,17.794,23,riffle_perfect
0,17,22,5,44,0.386,22,0.5,1,1,0.5,4,1,30,14,9,13,22,0.205,0.295,0.5,17.778,24,riffle_perfect
0,16,24,2,42,0.381,18,0.429,1,1,0.5,2,0,32,10,7,14,21,0.167,0.333,0.5,17.754,25,riffle_perfect
0,17,25,5,47,0.362,22,0.468,2,2,0.5,1,1,23,24,7,21,19,0.149,0.447,0.404,17.745,26,riffle_perfect
0,19,19,7,45,0.422,26,0.578,1,1,0.5,1,0,28,17,8,19,18,0.178,0.422,0.4,17.759,27,riffle_perfect
0,16,25,4,45,0.356,20,0.444,3,2,0.6,2,0,28,17,9,12,24,0.2,0.267,0.533,17.735,28,riffle_perfect
0,21,18,6,45,0.467,27,0.6,2,3,0.4,1,0,27,18,12,14,19,0.267,0.311,0.422,17.751,29,riffle_perfect
0,24,19,2,45,0.533,26,0.578,3,2,0.6,4,2,33,12,14,11,20,0.311,0.244,0.444,17.737,30,riffle_perfect
0,19,19,5,43,0.442,24,0.558,3,0,1.0,2,1,26,17,14,12,17,0.326,0.279,0.395,17.743,31,riffle_perfect
0,20,20,5,45,0.444,25,0.556,0,2,0.0,0,1,33,12,10,13,22,0.222,0.289,0.489,17.738,32,riffle_perfect
0,17,22,4,43,0.395,21,0.488,2,1,0.667,2,1,30,13,8,15,20,0.186,0.349,0.465,17.753,33,riffle_perfect
0,22,22,2,46,0.478,24,0.522,3,2,0.6,4,3,25,21,12,12,22,0.261,0.261,0.478,17.735,34,riffle_perfect
0,13,28,5,46,0.283,18,0.391,2,4,0.333,4,3,28,18,8,19,19,0.174,0.413,0.413,17.704,35,riffle_perfect
0,25,18,5,48,0.521,30,0.625,6,2,0.75,0,0,31,17,12,11,25,0.25,0.229,0.521,17.698,36,riffle_perfect
0,16,24,4,44,0.364,20,0.455,1,4,0.2,0,2,28,16,8,17,19,0.182,0.386,0.432,17.707,37,riffle_perfect
0,23,20,2,45,0.511,25,0.556,5,1,0.833,1,3,24,21,13,13,19,0.289,0.289,0.422,17.687,38,riffle_perfect
0,21,24,1,46,0.457,22,0.478,3,1,0.75,4,4,32,14,12,9,25,0.261,0.196,0.543,17.65,39,riffle_perfect
0,22,18,4,44,0.5,26,0.591,5,0,1.0,2,0,25,19,9,20,15,0.205,0.455,0.341,17.659,40,riffle_perfect
0,21,20,5,46,0.457,26,0.565,1,1,0.5,0,2,28,18,10,20,16,0.217,0.435,0.348,17.659,41,riffle_perfect
0,18,23,3,44,0.409,21,0.477,3,2,0.6,2,1,26,18,10,16,18,0.227,0.364,0.409,17.66,42,riffle_perfect
0,21,23,1,45,0.467,22,0.489,5,4,0.556,2,1,21,24,12,19,14,0.267,0.422,0.311,17.664,43,riffle_perfect
0,23,20,4,47,0.489,27,0.574,2,1,0.667,3,2,35,12,9,10,28,0.191,0.213,0.596,17.65,44,riffle_perfect
0,21,21,4,46,0.457,25,0.543,3,1,0.75,2,6,29,17,11,10,25,0.239,0.217,0.543,17.655,45,riffle_perfect
0,19,21,5,45,0.422,24,0.533,3,3,0.5,1,3,28,17,9,17,19,0.2,0.378,0.422,17.657,46,riffle_perfect
0,18,28,1,47,0.383,19,0.404,2,3,0.4,1,2,26,21,8,15,24,0.17,0.319,0.511,17.655,47,riffle_perfect
0,11,31,4,46,0.239,15,0.326,3,1,0.75,2,4,35,11,5,13,28,0.109,0.283,0.609,17.662,48,riffle_perfect
0,19,27,2,48,0.396,21,0.438,2,1,0.667,2,5,36,12,9,11,28,0.188,0.229,0.583,17.659,49,riffle_perfect
0,22,21,1,44,0.5,23,0.523,3,0,1.0,0,3,24,20,12,14,18,0.273,0.318,0.409,17.66,50,riffle_perfect
0,18,25,4,47,0.383,22,0.468,3,4,0.429,3,2,32,15,10,17,20,0.213,0.362,0.426,17.65,51,riffle_perfect
0,25,19,4,48,0.521,29,0.604,2,4,0.333,4,1,29,19,11,17,20,0.229,0.354,0.417,17.656,52,riffle_perfect
0,22,20,3,45,0.489,25,0.556,3,0,1.0,1,1,28,17,16,14,15,0.356,0.311,0.333,17.654,53,riffle_perfect
0,18,24,2,44,0.409,20,0.455,4,1,0.8,2,1,29,15,11,14,19,0.25,0.318,0.432,17.652,54,riffle_perfect
0,18,24,3,45,0.4,21,0.467,4,3,0.571,1,3,33,12,7,10,28,0.156,0.222,0.622,17.651,55,riffle_perfect
0,14,27,3,44,0.318,17,0.386,3,5,0.375,0,5,28,16,11,12,21,0.25,0.273,0.477,17.659,56,riffle_perfect
0,22,18,5,45,0.489,27,0.6,1,3,0.25,1,3,27,18,13,15,17,0.289,0.333,0.378,17.659,57,riffle_perfect
0,21,15,9,45,0.467,30,0.667,1,3,0.25,2,1,26,19,13,16,16,0.289,0.356,0.356,17.666,58,riffle_perfect
0,18,24,6,48,0.375,24,0.5,3,2,0.6,4,4,27,21,11,16,21,0.229,0.333,0.438,17.655,59,riffle_perfect
0,15,24,7,46,0.326,22,0.478,0,1,0.0,3,4,28,18,7,16,23,0.152,0.348,0.5,17.65,60,riffle_perfect
0,16,22,7,45,0.356,23,0.511,1,3,0.25,2,1,25,20,8,18,19,0.178,0.4,0.422,17.655,61,riffle_perfect
0,17,25,2,44,0.386,19,0.432,3,4,0.429,1,3,28,16,8,11,25,0.182,0.25,0.568,17.656,62,riffle_perfect
0,20,18,5,43,0.465,25,0.581,2,3,0.4,1,2,28,15,13,13,17,0.302,0.302,0.395,17.657,63,riffle_perfect
0,20,24,2,46,0.435,22,0.478,5,4,0.556,1,3,26,20,16,18,12,0.348,0.391,0.261,17.666,64,riffle_perfect
0,16,22,6,44,0.364,22,0.5,2,3,0.4,3,1,31,13,6,13,25,0.136,0.295,0.568,17.668,65,riffle_perfect
0,23,16,4,43,0.535,27,0.628,6,3,0.667,0,0,26,17,15,11,17,0.349,0.256,0.395,17.678,66,riffle_perfect
0,24,15,5,44,0.545,29,0.659,4,2,0.667,2,1,24,20,17,9,18,0.386,0.205,0.409,17.679,67,riffle_perfect
0,18,20,6,44,0.409,24,0.545,2,1,0.667,0,3,22,22,15,14,15,0.341,0.318,0.341,17.68,68,riffle_perfect
0,18,20,9,47,0.383,27,0.574,4,3,0.571,2,4,25,22,10,20,17,0.213,0.426,0.362,17.677,69,riffle_perfect
0,22,19,5,46,0.478,27,0.587,4,2,0.667,2,2,26,20,13,14,19,0.283,0.304,0.413,17.683,70,riffle_perfect
0,16,26,3,45,0.356,19,0.422,3,2,0.6,3,1,30,15,8,14,23,0.178,0.311,0.511,17.68,71,riffle_perfect
0,28,15,6,49,0.571,34,0.694,3,0,1.0,3,0,37,12,22,11,16,0.449,0.224,0.327,17.673,72,riffle_perfect
0,24,18,4,46,0.522,28,0.609,4,1,0.8,1,3,25,21,15,12,19,0.326,0.261,0.413,17.679,73,riffle_perfect
0,23,20,1,44,0.523,24,0.545,4,1,0.8,2,4,22,22,14,12,18,0.318,0.273,0.409,17.666,74,riffle_perfect
0,24,22,1,47,0.511,25,0.532,4,5,0.444,4,1,25,22,14,18,15,0.298,0.383,0.319,17.67,75,riffle_perfect
0,19,24,3,46,0.413,22,0.478,2,5,0.286,4,5,28,18,11,8,27,0.239,0.174,0.587,17.657,76,riffle_perfect
0,20,23,4,47,0.426,24,0.511,4,3,0.571,2,4,26,21,9,16,22,0.191,0.34,0.468,17.66,77,riffle_perfect
0,25,15,4,44,0.568,29,0.659,2,3,0.4,2,1,24,20,16,14,14,0.364,0.318,0.318,17.662,78,riffle_perfect
0,21,22,3,46,0.457,24,0.522,2,2,0.5,4,2,31,15,10,10,26,0.217,0.217,0.565,17.667,79,riffle_perfect
0,19,25,1,45,0.422,20,0.444,0,5,0.0,2,2,23,22,15,16,14,0.333,0.356,0.311,17.672,80,riffle_perfect
0,26,16,3,45,0.578,29,0.644,2,2,0.5,3,1,31,14,14,14,17,0.311,0.311,0.378,17.669,81,riffle_perfect
0,21,24,3,48,0.438,24,0.5,2,6,0.25,5,5,34,14,8,16,24,0.167,0.333,0.5,17.663,82,riffle_perfect
0,20,21,2,43,0.465,22,0.512,4,1,0.8,1,3,29,14,11,11,21,0.256,0.256,0.488,17.661,83,riffle_perfect
0,20,20,4,44,0.455,24,0.545,2,1,0.667,1,1,23,21,12,13,19,0.273,0.295,0.432,17.657,84,riffle_perfect
0,18,24,2,44,0.409,20,0.455,6,2,0.75,4,0,31,13,10,9,25,0.227,0.205,0.568,17.651,85,riffle_perfect
0,18,22,7,47,0.383,25,0.532,1,2,0.333,0,2,33,14,9,16,22,0.191,0.34,0.468,17.652,86,riffle_perfect
0,21,21,3,45,0.467,24,0.533,3,1,0.75,1,5,31,14,11,14,20,0.244,0.311,0.444,17.656,87,riffle_perfect
0,20,20,4,44,0.455,24,0.545,1,5,0.167,2,2,25,19,10,15,19,0.227,0.341,0.432,17.656,88,riffle_perfect
0,19,22,4,45,0.422,23,0.511,3,2,0.6,4,4,27,18,7,15,23,0.156,0.333,0.511,17.654,89,riffle_perfect
0,21,23,2,46,0.457,23,0.5,3,4,0.429,3,4,34,12,9,13,24,0.196,0.283,0.522,17.649,90,riffle_perfect
0,18,23,5,46,0.391,23,0.5,4,5,0.444,0,2,29,17,8,15,23,0.174,0.326,0.5,17.653,91,riffle_perfect
0,21,24,2,47,0.447,23,0.489,2,1,0.667,4,1,27,20,6,16,25,0.128,0.34,0.532,17.646,92,riffle_perfect
0,18,22,4,44,0.409,22,0.5,4,2,0.667,0,2,27,17,14,9,21,0.318,0.205,0.477,17.645,93,riffle_perfect
0,17,24,2,43,0.395,19,0.442,3,3,0.5,1,1,31,12,16,9,18,0.372,0.209,0.419,17.644,94,riffle_perfect
0,20,20,5,45,0.444,25,0.556,3,4,0.429,5,1,28,17,10,12,23,0.222,0.267,0.511,17.644,95,riffle_perfect
0,22,18,4,44,0.5,26,0.591,3,0,1.0,1,3,29,15,13,14,17,0.295,0.318,0.386,17.649,96,riffle_perfect
0,20,22,4,46,0.435,24,0.522,3,0,1.0,0,1,27,19,9,21,16,0.196,0.457,0.348,18.194,1,riffle_perfect
0,21,22,4,47,0.447,25,0.532,6,1,0.857,3,2,24,23,15,14,18,0.319,0.298,0.383,17.948,2,riffle_perfect
0,15,30,1,46,0.326,16,0.348,1,4,0.2,0,3,29,17,8,16,22,0.174,0.348,0.478,17.824,3,riffle_perfect
0,16,21,6,43,0.372,22,0.512,1,1,0.5,2,3,27,16,8,15,20,0.186,0.349,0.465,17.724,4,riffle_perfect
0,21,22,4,47,0.447,25,0.532,5,3,0.625,2,2,27,20,11,16,20,0.234,0.34,0.426,17.784,5,riffle_perfect
0,17,25,2,44,0.386,19,0.432,1,1,0.5,1,3,29,15,11,14,19,0.25,0.318,0.432,17.783,6,riffle_perfect
0,13,28,7,48,0.271,20,0.417,3,2,0.6,1,4,29,19,6,17,25,0.125,0.354,0.521,17.746,7,riffle_perfect
0,25,16,3,44,0.568,28,0.636,2,2,0.5,6,2,27,17,16,8,20,0.364,0.182,0.455,17.691,8,riffle_perfect
0,24,16,3,43,0.558,27,0.628,1,0,1.0,2,3,30,13,18,10,15,0.419,0.233,0.349,17.69,9,riffle_perfect
0,28,16,2,46,0.609,30,0.652,7,3,0.7,1,2,33,13,16,10,20,0.348,0.217,0.435,17.706,10,riffle_perfect
0,20,20,6,46,0.435,26,0.565,4,2,0.667,0,2,26,20,10,18,18,0.217,0.391,0.391,17.672,11,riffle_perfect
0,22,23,2,47,0.468,24,0.511,5,5,0.5,1,2,27,20,13,14,20,0.277,0.298,0.426,17.646,12,riffle_perfect
0,24,20,4,48,0.5,28,0.583,3,3,0.5,2,2,26,22,15,14,19,0.312,0.292,0.396,17.627,13,riffle_perfect
0,19,27,4,50,0.38,23,0.46,4,2,0.667,3,1,29,21,8,18,24,0.16,0.36,0.48,17.583,14,riffle_perfect
0,23,19,5,47,0.489,28,0.596,4,1,0.8,1,3,27,20,10,18,19,0.213,0.383,0.404,17.6,15,riffle_perfect
0,23,18,4,45,0.511,27,0.6,2,4,0.333,2,3,27,18,13,13,19,0.289,0.289,0.422,17.619,16,riffle_perfect
0,18,23,4,45,0.4,22,0.489,1,3,0.25,1,3,29,16,11,15,19,0.244,0.333,0.422,17.652,17,riffle_perfect
0,16,22,7,45,0.356,23,0.511,2,1,0.667,0,0,25,20,11,17,17,0.244,0.378,0.378,17.663,18,riffle_perfect
0,18,20,6,44,0.409,24,0.545,6,2,0.75,2,4,31,13,11,11,22,0.25,0.25,0.5,17.671,19,riffle_perfect
0,24,18,2,44,0.545,26,0.591,3,1,0.75,1,0,26,18,13,14,17,0.295,0.318,0.386,17.689,20,riffle_perfect
0,26,20,2,48,0.542,28,0.583,2,0,1.0,4,2,27,21,16,12,20,0.333,0.25,0.417,17.699,21,riffle_perfect
0,20,21,3,44,0.455,23,0.523,3,2,0.6,3,0,26,18,10,17,17,0.227,0.386,0.386,17.737,22,riffle_perfect
0,18,24,4,46,0.391,22,0.478,3,5,0.375,3,2,24,22,11,15,20,0.239,0.326,0.435,17.747,23,riffle_perfect
0,17,19,8,44,0.386,25,0.568,3,3,0.5,1,3,28,16,11,10,23,0.25,0.227,0.523,17.745,24,riffle_perfect
0,25,20,1,46,0.543,26,0.565,2,3,0.4,4,0,26,20,13,11,22,0.283,0.239,0.478,17.707,25,riffle_perfect
0,15,22,6,43,0.349,21,0.488,3,2,0.6,0,3,29,14,8,17,18,0.186,0.395,0.419,17.698,26,riffle_perfect
0,19,21,4,44,0.432,23,0.523,3,1,0.75,1,2,28,16,10,16,18,0.227,0.364,0.409,17.714,27,riffle_perfect
0,20,21,2,43,0.465,22,0.512,4,1,0.8,1,3,30,13,14,11,18,0.326,0.256,0.419,17.711,28,riffle_perfect
0,24,24,0,48,0.5,24,0.5,2,6,0.25,2,4,28,20,12,14,22,0.25,0.292,0.458,17.704,29,riffle_perfect
0,19,21,3,43,0.442,22,0.512,2,2,0.5,3,2,29,14,7,10,26,0.163,0.233,0.605,17.674,30,riffle_perfect
0,27,14,6,47,0.574,33,0.702,4,1,0.8,2,1,24,23,11,14,22,0.234,0.298,0.468,17.667,31,riffle_perfect
0,21,23,2,46,0.457,23,0.5,1,1,0.5,3,3,30,16,9,13,24,0.196,0.283,0.522,17.654,32,riffle_perfect
0,22,21,4,47,0.468,26,0.553,4,1,0.8,2,2,27,20,9,16,22,0.191,0.34,0.468,17.668,33,riffle_perfect
0,19,27,0,46,0.413,19,0.413,3,3,0.5,4,2,27,19,9,14,23,0.196,0.304,0.5,17.646,34,riffle_perfect
0,24,17,4,45,0.533,28,0.622,4,1,0.8,5,2,29,16,14,8,23,0.311,0.178,0.511,17.654,35,riffle_perfect
0,16,24,7,47,0.34,23,0.489,3,5,0.375,0,1,30,17,12,17,18,0.255,0.362,0.383,17.68,36,riffle_perfect
0,20,23,2,45,0.444,22,0.489,1,4,0.2,0,3,27,18,14,14,17,0.311,0.311,0.378,17.694,37,riffle_perfect
0,20,23,4,47,0.426,24,0.511,1,3,0.25,1,2,28,19,12,14,21,0.255,0.298,0.447,17.687,38,riffle_perfect
0,20,22,5,47,0.426,25,0.532,0,1,0.0,3,3,25,22,10,16,21,0.213,0.34,0.447,17.698,39,riffle_perfect
0,21,23,1,45,0.467,22,0.489,5,4,0.556,0,2,28,17,9,16,20,0.2,0.356,0.444,17.714,40,riffle_perfect
0,19,20,6,45,0.422,25,0.556,4,1,0.8,1,3,24,21,12,15,18,0.267,0.333,0.4,17.735,41,riffle_perfect
0,23,26,1,50,0.46,24,0.48,3,1,0.75,2,5,22,28,16,15,19,0.32,0.3,0.38,17.716,42,riffle_perfect
0,12,29,4,45,0.267,16,0.356,2,4,0.333,2,2,30,15,3,16,26,0.067,0.356,0.578,17.721,43,riffle_perfect
0,19,23,4,46,0.413,23,0.5,1,3,0.25,2,2,29,17,10,14,22,0.217,0.304,0.478,17.714,44,riffle_perfect
0,17,29,0,46,0.37,17,0.37,3,2,0.6,0,2,29,17,12,14,20,0.261,0.304,0.435,17.711,45,riffle_perfect
0,15,26,4,45,0.333,19,0.422,2,2,0.5,1,1,27,18,9,17,19,0.2,0.378,0.422,17.72,46,riffle_perfect
0,18,17,9,44,0.409,27,0.614,3,1,0.75,1,1,24,20,12,14,18,0.273,0.318,0.409,17.717,47,riffle_perfect
0,17,24,3,44,0.386,20,0.455,2,3,0.4,2,2,30,14,8,11,25,0.182,0.25,0.568,17.714,48,riffle_perfect
0,18,20,5,43,0.419,23,0.535,2,1,0.667,1,0,29,14,12,14,17,0.279,0.326,0.395,17.723,49,riffle_perfect
0,23,16,4,43,0.535,27,0.628,1,0,1.0,3,2,23,20,12,16,15,0.279,0.372,0.349,17.716,50,riffle_perfect
0,21,21,4,46,0.457,25,0.543,0,3,0.0,4,3,29,17,10,12,24,0.217,0.261,0.522,17.703,51,riffle_perfect
0,16,25,7,48,0.333,23,0.479,0,4,0.0,3,3,29,19,9,14,25,0.188,0.292,0.521,17.689,52,riffle_perfect
0,24,20,3,47,0.511,27,0.574,7,2,0.778,5,1,23,24,13,17,17,0.277,0.362,0.362,17.692,53,riffle_perfect
0,18,21,7,46,0.391,25,0.543,7,6,0.538,1,0,28,18,9,15,22,0.196,0.326,0.478,17.687,54,riffle_perfect
0,21,24,1,46,0.457,22,0.478,3,5,0.375,3,1,23,23,11,18,17,0.239,0.391,0.37,17.692,55,riffle_perfect
0,17,24,4,45,0.378,21,0.467,1,3,0.25,1,3,28,17,11,14,20,0.244,0.311,0.444,17.695,56,riffle_perfect
0,21,16,8,45,0.467,29,0.644,3,3,0.5,2,2,30,15,10,13,22,0.222,0.289,0.489,17.713,57,riffle_perfect
0,17,20,7,44,0.386,24,0.545,2,4,0.333,3,0,29,15,7,14,23,0.159,0.318,0.523,17.71,58,riffle_perfect
0,16,24,4,44,0.364,20,0.455,6,1,0.857,1,2,29,15,8,15,21,0.182,0.341,0.477,17.721,59,riffle_perfect
0,11,34,2,47,0.234,13,0.277,2,0,1.0,0,2,31,16,5,15,27,0.106,0.319,0.574,17.713,60,riffle_perfect
0,17,24,3,44,0.386,20,0.455,3,3,0.5,3,2,31,13,11,12,21,0.25,0.273,0.477,17.713,61,riffle_perfect
0,23,20,3,46,0.5,26,0.565,6,1,0.857,1,3,26,20,12,15,19,0.261,0.326,0.413,17.713,62,riffle_perfect
0,19,21,5,45,0.422,24,0.533,3,1,0.75,2,2,28,17,10,10,25,0.222,0.222,0.556,17.704,63,riffle_perfect
0,21,22,4,47,0.447,25,0.532,4,2,0.667,4,0,28,19,11,15,21,0.234,0.319,0.447,17.693,64,riffle_perfect
0,24,15,3,42,0.571,27,0.643,2,0,1.0,3,0,22,20,14,12,16,0.333,0.286,0.381,17.689,65,riffle_perfect
0,17,28,3,48,0.354,20,0.417,1,7,0.125,1,2,28,20,10,20,18,0.208,0.417,0.375,17.693,66,riffle_perfect
0,21,22,4,47,0.447,25,0.532,4,2,0.667,4,2,29,18,7,15,25,0.149,0.319,0.532,17.68,67,riffle_perfect
0,25,16,6,47,0.532,31,0.66,8,3,0.727,2,1,31,16,14,10,23,0.298,0.213,0.489,17.678,68,riffle_perfect
0,19,20,7,46,0.413,26,0.565,2,2,0.5,2,0,28,18,10,16,20,0.217,0.348,0.435,17.679,69,riffle_perfect
0,23,21,6,50,0.46,29,0.58,5,3,0.625,3,2,22,28,14,18,18,0.28,0.36,0.36,17.683,70,riffle_perfect
0,18,23,4,45,0.4,22,0.489,1,4,0.2,2,2,29,16,10,17,18,0.222,0.378,0.4,17.685,71,riffle_perfect
0,22,21,4,47,0.468,26,0.553,3,5,0.375,4,2,26,21,12,14,21,0.255,0.298,0.447,17.681,72,riffle_perfect
0,21,24,1,46,0.457,22,0.478,1,5,0.167,3,1,29,17,11,12,23,0.239,0.261,0.5,17.683,73,riffle_perfect
0,15,24,4,43,0.349,19,0.442,2,2,0.5,2,3,32,11,5,14,24,0.116,0.326,0.558,17.682,74,riffle_perfect
0,23,21,2,46,0.5,25,0.543,8,5,0.615,2,2,23,23,14,7,25,0.304,0.152,0.543,17.672,75,riffle_perfect
0,19,23,3,45,0.422,22,0.489,7,3,0.7,1,1,25,20,15,15,15,0.333,0.333,0.333,17.674,76,riffle_perfect
0,23,16,4,43,0.535,27,0.628,2,2,0.5,3,0,31,12,13,10,20,0.302,0.233,0.465,17.676,77,riffle_perfect
0,27,13,4,44,0.614,31,0.705,1,1,0.5,4,1,23,21,9,12,23,0.205,0.273,0.523,17.666,78,riffle_perfect
0,25,17,2,44,0.568,27,0.614,3,3,0.5,5,1,27,17,13,14,17,0.295,0.318,0.386,17.666,79,riffle_perfect
0,18,20,6,44,0.409,24,0.545,2,1,0.667,2,1,29,15,9,13,22,0.205,0.295,0.5,17.661,80,riffle_perfect
0,17,27,2,46,0.37,19,0.413,4,5,0.444,0,6,29,17,11,17,18,0.239,0.37,0.391,17.673,81,riffle_perfect
0,22,17,4,43,0.512,26,0.605,5,1,0.833,1,2,30,13,14,11,18,0.326,0.256,0.419,17.682,82,riffle_perfect
0,14,28,2,44,0.318,16,0.364,3,2,0.6,1,5,31,13,4,17,23,0.091,0.386,0.523,17.683,83,riffle_perfect
0,24,17,5,46,0.522,29,0.63,0,1,0.0,3,2,34,12,14,9,23,0.304,0.196,0.5,17.68,84,riffle_perfect
0,16,25,7,48,0.333,23,0.479,2,0,1.0,4,3,36,12,8,11,29,0.167,0.229,0.604,17.673,85,riffle_perfect
0,26,18,2,46,0.565,28,0.609,6,2,0.75,2,0,29,17,16,8,22,0.348,0.174,0.478,17.67,86,riffle_perfect
0,24,21,5,50,0.48,29,0.58,5,4,0.556,1,3,32,18,11,17,22,0.22,0.34,0.44,17.674,87,riffle_perfect
0,13,24,6,43,0.302,19,0.442,5,0,1.0,0,3,24,19,7,16,20,0.163,0.372,0.465,17.68,88,riffle_perfect
0,18,26,1,45,0.4,19,0.422,1,4,0.2,0,2,26,19,9,19,17,0.2,0.422,0.378,17.689,89,riffle_perfect
0,22,21,2,45,0.489,24,0.533,2,2,0.5,3,1,24,21,10,17,18,0.222,0.378,0.4,17.686,90,riffle_perfect
0,17,25,5,47,0.362,22,0.468,3,3,0.5,1,1,29,18,11,18,18,0.234,0.383,0.383,17.693,91,riffle_perfect
0,25,16,4,45,0.556,29,0.644,3,2,0.6,2,3,30,15,18,8,19,0.4,0.178,0.422,17.697,92,riffle_perfect
0,18,21,5,44,0.409,23,0.523,2,0,1.0,3,1,30,14,12,12,20,0.273,0.273,0.455,17.698,93,riffle_perfect
0,17,25,5,47,0.362,22,0.468,4,2,0.667,2,3,27,20,8,18,21,0.17,0.383,0.447,17.703,94,riffle_perfect
0,15,27,3,45,0.333,18,0.4,4,1,0.8,2,2,29,16,6,15,24,0.133,0.333,0.533,17.707,95,riffle_perfect
0,10,31,5,46,0.217,15,0.326,2,5,0.286,1,3,32,14,3,17,26,0.065,0.37,0.565,17.713,96,riffle_perfect
0,19,21,1,41,0.463,20,0.488,3,1,0.75,1,1,20,21,12,16,13,0.293,0.39,0.317,17.391,1,riffle_perfect
0,19,24,1,44,0.432,20,0.455,1,1,0.5,4,2,29,15,8,13,23,0.182,0.295,0.523,17.204,2,riffle_perfect
0,22,20,3,45,0.489,25,0.556,5,1,0.833,2,3,23,22,12,17,16,0.267,0.378,0.356,17.538,3,riffle_perfect
0,19,22,3,44,0.432,22,0.5,4,1,0.8,0,3,33,11,8,16,20,0.182,0.364,0.455,17.78,4,riffle_perfect
0,20,21,2,43,0.465,22,0.512,2,2,0.5,4,0,27,16,12,11,20,0.279,0.256,0.465,17.577,5,riffle_perfect
0,19,26,1,46,0.413,20,0.435,2,4,0.333,2,3,33,13,9,12,25,0.196,0.261,0.543,17.5,6,riffle_perfect
0,16,20,7,43,0.372,23,0.535,1,1,0.5,4,2,24,19,11,14,18,0.256,0.326,0.419,17.443,7,riffle_perfect
0,25,16,5,46,0.543,30,0.652,1,1,0.5,2,3,25,21,17,13,16,0.37,0.283,0.348,17.502,8,riffle_perfect
0,16,27,3,46,0.348,19,0.413,2,1,0.667,4,3,26,20,6,18,22,0.13,0.391,0.478,17.413,9,riffle_perfect
0,16,27,4,47,0.34,20,0.426,1,3,0.25,0,3,32,15,9,16,22,0.191,0.34,0.468,17.443,10,riffle_perfect
0,16,25,4,45,0.356,20,0.444,0,1,0.0,1,3,33,12,8,11,26,0.178,0.244,0.578,17.508,11,riffle_perfect
0,20,25,1,46,0.435,21,0.457,3,3,0.5,2,0,27,19,13,14,19,0.283,0.304,0.413,17.53,12,riffle_perfect
0,23,22,2,47,0.489,25,0.532,0,1,0.0,3,0,29,18,10,16,21,0.213,0.34,0.447,17.546,13,riffle_perfect
0,24,18,5,47,0.511,29,0.617,3,0,1.0,1,2,27,20,12,15,20,0.255,0.319,0.426,17.577,14,riffle_perfect
0,19,21,4,44,0.432,23,0.523,5,3,0.625,3,1,21,23,11,14,19,0.25,0.318,0.432,17.565,15,riffle_perfect
0,20,19,4,43,0.465,24,0.558,4,0,1.0,2,2,28,15,11,16,16,0.256,0.372,0.372,17.589,16,riffle_perfect
0,23,22,1,46,0.5,24,0.522,5,5,0.5,4,1,25,21,14,8,24,0.304,0.174,0.522,17.536,17,riffle_perfect
0,19,20,5,44,0.432,24,0.545,3,1,0.75,1,3,25,19,9,16,19,0.205,0.364,0.432,17.591,18,riffle_perfect
0,18,21,6,45,0.4,24,0.533,2,2,0.5,3,2,25,20,6,19,20,0.133,0.422,0.444,17.572,19,riffle_perfect
0,16,22,7,45,0.356,23,0.511,3,2,0.6,2,0,27,18,8,13,24,0.178,0.289,0.533,17.588,20,riffle_perfect
0,18,26,3,47,0.383,21,0.447,4,4,0.5,3,6,27,20,11,14,22,0.234,0.298,0.468,17.583,21,riffle_perfect
0,22,20,6,48,0.458,28,0.583,4,1,0.8,5,1,28,20,14,16,18,0.292,0.333,0.375,17.556,22,riffle_perfect
0,21,21,3,45,0.467,24,0.533,4,3,0.571,3,2,28,17,13,13,19,0.289,0.289,0.422,17.54,23,riffle_perfect
0,24,19,5,48,0.5,29,0.604,2,2,0.5,2,1,29,19,13,16,19,0.271,0.333,0.396,17.554,24,riffle_perfect
0,19,23,3,45,0.422,22,0.489,5,3,0.625,2,4,28,17,10,12,23,0.222,0.267,0.511,17.541,25,riffle_perfect
0,20,23,2,45,0.444,22,0.489,2,2,0.5,3,1,27,18,11,11,23,0.244,0.244,0.511,17.506,26,riffle_perfect
0,21,22,4,47,0.447,25,0.532,2,1,0.667,4,3,28,19,11,10,26,0.234,0.213,0.553,17.501,27,riffle_perfect
0,21,22,3,46,0.457,24,0.522,4,3,0.571,2,3,26,20,13,16,17,0.283,0.348,0.37,17.536,28,riffle_perfect
0,23,20,2,45,0.511,25,0.556,0,2,0.0,4,0,25,20,11,16,18,0.244,0.356,0.4,17.518,29,riffle_perfect
0,18,24,4,46,0.391,22,0.478,3,2,0.6,0,3,29,17,9,13,24,0.196,0.283,0.522,17.528,30,riffle_perfect
0,21,23,0,44,0.477,21,0.477,4,3,0.571,1,3,30,14,10,14,20,0.227,0.318,0.455,17.551,31,riffle_perfect
0,22,19,3,44,0.5,25,0.568,1,1,0.5,2,2,21,23,12,17,15,0.273,0.386,0.341,17.584,32,riffle_perfect
0,19,25,2,46,0.413,21,0.457,3,2,0.6,1,2,23,23,10,18,18,0.217,0.391,0.391,17.587,33,riffle_perfect
0,19,22,3,44,0.432,22,0.5,4,2,0.667,1,3,26,18,12,12,20,0.273,0.273,0.455,17.599,34,riffle_perfect
0,17,26,3,46,0.37,20,0.435,2,1,0.667,2,1,26,20,3,21,22,0.065,0.457,0.478,17.588,35,riffle_perfect
0,20,22,4,46,0.435,24,0.522,1,6,0.143,3,2,24,22,11,15,20,0.239,0.326,0.435,17.58,36,riffle_perfect
0,13,31,1,45,0.289,14,0.311,4,1,0.8,1,1,28,17,8,19,18,0.178,0.422,0.4,17.589,37,riffle_perfect
0,21,24,1,46,0.457,22,0.478,5,2,0.714,1,3,26,20,12,14,20,0.261,0.304,0.435,17.576,38,riffle_perfect
0,22,19,4,45,0.489,26,0.578,2,2,0.5,4,2,22,23,12,16,17,0.267,0.356,0.378,17.577,39,riffle_perfect
0,23,19,2,44,0.523,25,0.568,3,1,0.75,3,1,30,14,11,11,22,0.25,0.25,0.5,17.572,40,riffle_perfect
0,13,23,7,43,0.302,20,0.465,1,3,0.25,1,2,26,17,10,19,14,0.233,0.442,0.326,17.589,41,riffle_perfect
0,27,16,3,46,0.587,30,0.652,3,2,0.6,2,0,27,19,16,13,17,0.348,0.283,0.37,17.601,42,riffle_perfect
0,14,26,4,44,0.318,18,0.409,0,2,0.0,2,3,29,15,5,14,25,0.114,0.318,0.568,17.616,43,riffle_perfect
0,18,23,4,45,0.4,22,0.489,2,1,0.667,2,5,29,16,6,17,22,0.133,0.378,0.489,17.614,44,riffle_perfect
0,24,23,3,50,0.48,27,0.54,3,1,0.75,0,1,31,19,9,24,17,0.18,0.48,0.34,17.616,45,riffle_perfect
0,23,21,2,46,0.5,25,0.543,1,3,0.25,4,1,21,25,12,17,17,0.261,0.37,0.37,17.6,46,riffle_perfect
0,18,19,7,44,0.409,25,0.568,5,0,1.0,0,0,29,15,9,14,21,0.205,0.318,0.477,17.598,47,riffle_perfect
0,13,27,6,46,0.283,19,0.413,0,5,0.0,1,0,32,14,5,16,25,0.109,0.348,0.543,17.605,48,riffle_perfect
0,20,21,4,45,0.444,24,0.533,3,1,0.75,3,3,27,18,10,13,22,0.222,0.289,0.489,17.597,49,riffle_perfect
0,18,26,2,46,0.391,20,0.435,2,2,0.5,3,3,31,15,9,9,28,0.196,0.196,0.609,17.611,50,riffle_perfect
0,22,22,3,47,0.468,25,0.532,3,2,0.6,2,0,22,25,10,18,19,0.213,0.383,0.404,17.622,51,riffle_perfect
0,23,21,1,45,0.511,24,0.533,4,1,0.8,4,1,22,23,11,16,18,0.244,0.356,0.4,17.609,52,riffle_perfect
0,14,24,6,44,0.318,20,0.455,3,0,1.0,0,1,27,17,9,18,17,0.205,0.409,0.386,17.625,53,riffle_perfect
0,18,24,2,44,0.409,20,0.455,2,2,0.5,0,2,29,15,11,15,18,0.25,0.341,0.409,17.619,54,riffle_perfect
0,18,21,3,42,0.429,21,0.5,5,4,0.556,0,4,29,13,12,11,19,0.286,0.262,0.452,17.621,55,riffle_perfect
0,25,18,6,49,0.51,31,0.633,6,2,0.75,3,4,28,21,18,13,18,0.367,0.265,0.367,17.612,56,riffle_perfect
0,15,25,6,46,0.326,21,0.457,2,4,0.333,1,1,29,17,8,19,19,0.174,0.413,0.413,17.611,57,riffle_perfect
0,23,19,7,49,0.469,30,0.612,3,4,0.429,2,2,27,22,11,18,20,0.224,0.367,0.408,17.62,58,riffle_perfect
0,19,24,4,47,0.404,23,0.489,3,4,0.429,3,1,26,21,9,16,22,0.191,0.34,0.468,17.616,59,riffle_perfect
0,20,21,2,43,0.465,22,0.512,3,2,0.6,1,2,31,12,17,4,22,0.395,0.093,0.512,17.613,60,riffle_perfect
0,20,22,5,47,0.426,25,0.532,5,1,0.833,6,3,29,18,12,11,24,0.255,0.234,0.511,17.598,61,riffle_perfect
0,21,24,4,49,0.429,25,0.51,3,1,0.75,1,2,21,28,15,20,14,0.306,0.408,0.286,17.605,62,riffle_perfect
0,23,16,4,43,0.535,27,0.628,6,3,0.667,0,2,24,19,10,15,18,0.233,0.349,0.419,17.609,63,riffle_perfect
0,16,23,6,45,0.356,22,0.489,2,1,0.667,2,3,23,22,8,19,18,0.178,0.422,0.4,17.6,64,riffle_perfect
0,21,20,4,45,0.467,25,0.556,3,0,1.0,4,2,25,20,13,12,20,0.289,0.267,0.444,17.584,65,riffle_perfect
0,21,21,3,45,0.467,24,0.533,3,4,0.429,4,4,28,17,14,10,21,0.311,0.222,0.467,17.582,66,riffle_perfect
0,20,22,4,46,0.435,24,0.522,2,1,0.667,3,2,34,12,4,14,28,0.087,0.304,0.609,17.582,67,riffle_perfect
0,13,31,3,47,0.277,16,0.34,0,5,0.0,4,5,27,20,6,18,23,0.128,0.383,0.489,17.578,68,riffle_perfect
0,18,24,5,47,0.383,23,0.489,3,2,0.6,3,0,27,20,9,17,21,0.191,0.362,0.447,17.594,69,riffle_perfect
0,21,21,3,45,0.467,24,0.533,4,0,1.0,3,2,27,18,17,10,18,0.378,0.222,0.4,17.576,70,riffle_perfect
0,18,20,6,44,0.409,24,0.545,5,2,0.714,0,1,30,14,9,15,20,0.205,0.341,0.455,17.583,71,riffle_perfect
0,14,23,5,42,0.333,19,0.452,2,1,0.667,1,3,30,12,10,17,15,0.238,0.405,0.357,17.583,72,riffle_perfect
0,22,22,4,48,0.458,26,0.542,1,2,0.333,1,3,24,24,10,19,19,0.208,0.396,0.396,17.592,73,riffle_perfect
0,20,22,2,44,0.455,22,0.5,3,3,0.5,3,3,31,13,9,13,22,0.205,0.295,0.5,17.594,74,riffle_perfect
0,15,27,3,45,0.333,18,0.4,4,2,0.667,3,4,26,19,8,15,22,0.178,0.333,0.489,17.594,75,riffle_perfect
0,22,21,4,47,0.468,26,0.553,3,3,0.5,3,3,26,21,9,21,17,0.191,0.447,0.362,17.593,76,riffle_perfect
0,15,23,5,43,0.349,20,0.465,2,2,0.5,0,2,21,22,9,19,15,0.209,0.442,0.349,17.599,77,riffle_perfect
0,22,18,6,46,0.478,28,0.609,2,3,0.4,2,1,22,24,13,15,18,0.283,0.326,0.391,17.602,78,riffle_perfect
0,18,25,3,46,0.391,21,0.457,3,0,1.0,4,1,25,21,8,18,20,0.174,0.391,0.435,17.603,79,riffle_perfect
0,14,30,0,44,0.318,14,0.318,3,4,0.429,1,3,33,11,8,12,24,0.182,0.273,0.545,17.601,80,riffle_perfect
0,20,20,5,45,0.444,25,0.556,2,2,0.5,0,2,32,13,12,9,24,0.267,0.2,0.533,17.601,81,riffle_perfect
0,23,19,4,46,0.5,27,0.587,5,3,0.625,3,2,26,20,13,10,23,0.283,0.217,0.5,17.597,82,riffle_perfect
0,22,14,8,44,0.5,30,0.682,2,2,0.5,2,0,27,17,14,11,19,0.318,0.25,0.432,17.603,83,riffle_perfect
0,21,18,6,45,0.467,27,0.6,2,1,0.667,4,3,27,18,11,15,19,0.244,0.333,0.422,17.606,84,riffle_perfect
0,22,21,6,49,0.449,28,0.571,1,5,0.167,3,3,29,20,14,14,21,0.286,0.286,0.429,17.604,85,riffle_perfect
0,15,26,5,46,0.326,20,0.435,2,4,0.333,3,5,29,17,8,13,25,0.174,0.283,0.543,17.593,86,riffle_perfect
0,14,27,4,45,0.311,18,0.4,4,3,0.571,2,2,30,15,5,12,28,0.111,0.267,0.622,17.6,87,riffle_perfect
0,21,23,3,47,0.447,24,0.511,8,1,0.889,2,1,25,22,10,22,15,0.213,0.468,0.319,17.604,88,riffle_perfect
0,17,23,4,44,0.386,21,0.477,3,2,0.6,0,3,29,15,10,10,24,0.227,0.227,0.545,17.607,89,riffle_perfect
0,15,25,7,47,0.319,22,0.468,2,4,0.333,1,3,31,16,10,18,19,0.213,0.383,0.404,17.615,90,riffle_perfect
0,22,18,4,44,0.5,26,0.591,1,1,0.5,3,3,29,15,11,12,21,0.25,0.273,0.477,17.619,91,riffle_perfect
0,22,21,5,48,0.458,27,0.562,1,0,1.0,3,3,37,11,7,19,22,0.146,0.396,0.458,17.618,92,riffle_perfect
0,20,22,3,45,0.444,23,0.511,5,1,0.833,3,1,22,23,10,16,19,0.222,0.356,0.422,17.617,93,riffle_perfect
0,21,21,5,47,0.447,26,0.553,6,0,1.0,5,3,29,18,10,12,25,0.213,0.255,0.532,17.62,94,riffle_perfect
0,28,14,4,46,0.609,32,0.696,5,1,0.833,5,1,30,16,14,10,22,0.304,0.217,0.478,17.613,95,riffle_perfect
0,23,19,1,43,0.535,24,0.558,3,1,0.75,2,0,26,17,13,11,19,0.302,0.256,0.442,17.613,96,riffle_perfect
0,21,17,5,43,0.488,26,0.605,6,3,0.667,0,2,25,18,13,13,17,0.302,0.302,0.395,17.808,1,riffle_perfect
0,13,34,0,47,0.277,13,0.277,3,5,0.375,1,4,37,10,6,16,25,0.128,0.34,0.532,18.067,2,riffle_perfect
0,23,22,2,47,0.489,25,0.532,4,4,0.5,3,3,29,18,13,13,21,0.277,0.277,0.447,17.851,3,riffle_perfect
0,23,18,5,46,0.5,28,0.609,3,1,0.75,4,2,25,21,16,9,21,0.348,0.196,0.457,17.571,4,riffle_perfect
0,17,25,2,44,0.386,19,0.432,3,2,0.6,2,1,26,18,9,16,19,0.205,0.364,0.432,17.652,5,riffle_perfect
0,20,21,2,43,0.465,22,0.512,5,3,0.625,2,1,29,14,13,15,15,0.302,0.349,0.349,17.641,6,riffle_perfect
0,21,21,3,45,0.467,24,0.533,2,3,0.4,2,1,29,16,9,14,22,0.2,0.311,0.489,17.65,7,riffle_perfect
0,19,25,3,47,0.404,22,0.468,2,4,0.333,2,3,30,17,13,13,21,0.277,0.277,0.447,17.667,8,riffle_perfect
0,23,18,3,44,0.523,26,0.591,1,5,0.167,2,1,22,22,15,13,16,0.341,0.295,0.364,17.702,9,riffle_perfect
0,19,24,1,44,0.432,20,0.455,1,3,0.25,4,0,32,12,6,16,22,0.136,0.364,0.5,17.747,10,riffle_perfect
0,20,24,5,49,0.408,25,0.51,5,1,0.833,5,1,30,19,10,17,22,0.204,0.347,0.449,17.713,11,riffle_perfect
0,21,19,6,46,0.457,27,0.587,6,0,1.0,3,0,24,22,15,13,18,0.326,0.283,0.391,17.67,12,riffle_perfect
0,28,16,2,46,0.609,30,0.652,5,0,1.0,3,3,28,18,14,12,20,0.304,0.261,0.435,17.654,13,riffle_perfect
0,16,23,7,46,0.348,23,0.5,4,4,0.5,2,3,30,16,5,17,24,0.109,0.37,0.522,17.597,14,riffle_perfect
0,24,17,6,47,0.511,30,0.638,5,3,0.625,3,0,21,26,13,16,18,0.277,0.34,0.383,17.62,15,riffle_perfect
0,27,20,3,50,0.54,30,0.6,4,2,0.667,2,3,29,21,14,18,18,0.28,0.36,0.36,17.593,16,riffle_perfect
0,27,20,2,49,0.551,29,0.592,3,2,0.6,4,2,26,23,15,14,20,0.306,0.286,0.408,17.572,17,riffle_perfect
0,29,13,3,45,0.644,32,0.711,2,3,0.4,2,0,27,18,17,7,21,0.378,0.156,0.467,17.579,18,riffle_perfect
0,23,21,3,47,0.489,26,0.553,6,0,1.0,2,0,27,20,12,18,17,0.255,0.383,0.362,17.591,19,riffle_perfect
0,17,23,5,45,0.378,22,0.489,2,2,0.5,1,1,30,15,12,14,19,0.267,0.311,0.422,17.562,20,riffle_perfect
0,14,28,3,45,0.311,17,0.378,0,4,0.0,6,1,27,18,5,14,26,0.111,0.311,0.578,17.517,21,riffle_perfect
0,17,22,7,46,0.37,24,0.522,2,4,0.333,3,1,25,21,12,16,18,0.261,0.348,0.391,17.531,22,riffle_perfect
0,22,19,3,44,0.5,25,0.568,3,3,0.5,1,1,27,17,10,14,20,0.227,0.318,0.455,17.572,23,riffle_perfect
0,22,18,3,43,0.512,25,0.581,3,2,0.6,2,1,24,19,12,16,15,0.279,0.372,0.349,17.591,24,riffle_perfect
0,22,20,2,44,0.5,24,0.545,4,2,0.667,1,1,24,20,14,12,18,0.318,0.273,0.409,17.578,25,riffle_perfect
0,17,27,2,46,0.37,19,0.413,4,1,0.8,1,3,29,17,8,18,20,0.174,0.391,0.435,17.608,26,riffle_perfect
0,18,26,3,47,0.383,21,0.447,2,4,0.333,4,4,33,14,9,13,25,0.191,0.277,0.532,17.638,27,riffle_perfect
0,24,21,0,45,0.533,24,0.533,2,2,0.5,3,2,26,19,13,14,18,0.289,0.311,0.4,17.641,28,riffle_perfect
0,23,18,3,44,0.523,26,0.591,6,3,0.667,2,2,25,19,12,16,16,0.273,0.364,0.364,17.649,29,riffle_perfect
0,23,20,3,46,0.5,26,0.565,5,0,1.0,3,0,27,19,10,14,22,0.217,0.304,0.478,17.615,30,riffle_perfect
0,21,17,6,44,0.477,27,0.614,1,2,0.333,1,2,28,16,13,15,16,0.295,0.341,0.364,17.611,31,riffle_perfect
0,22,22,1,45,0.489,23,0.511,2,4,0.333,2,2,29,16,12,14,19,0.267,0.311,0.422,17.619,32,riffle_perfect
0,15,25,5,45,0.333,20,0.444,2,4,0.333,1,2,29,16,11,15,19,0.244,0.333,0.422,17.636,33,riffle_perfect
0,20,20,6,46,0.435,26,0.565,0,2,0.0,1,3,33,13,8,13,25,0.174,0.283,0.543,17.649,34,riffle_perfect
0,18,25,2,45,0.4,20,0.444,3,3,0.5,1,4,24,21,14,18,13,0.311,0.4,0.289,17.635,35,riffle_perfect
0,19,22,5,46,0.413,24,0.522,1,3,0.25,0,2,35,11,9,13,24,0.196,0.283,0.522,17.644,36,riffle_perfect
0,20,20,4,44,0.455,24,0.545,4,1,0.8,6,2,29,15,8,12,24,0.182,0.273,0.545,17.613,37,riffle_perfect
0,20,27,3,50,0.4,23,0.46,4,2,0.667,2,1,30,20,12,8,30,0.24,0.16,0.6,17.581,38,riffle_perfect
0,16,28,4,48,0.333,20,0.417,1,0,1.0,1,0,34,14,5,17,26,0.104,0.354,0.542,17.594,39,riffle_perfect
0,24,24,3,51,0.471,27,0.529,2,5,0.286,5,3,26,25,14,16,21,0.275,0.314,0.412,17.606,40,riffle_perfect
0,26,19,2,47,0.553,28,0.596,2,1,0.667,5,1,28,19,12,16,19,0.255,0.34,0.404,17.585,41,riffle_perfect
0,24,18,3,45,0.533,27,0.6,4,2,0.667,1,1,28,17,13,14,18,0.289,0.311,0.4,17.589,42,riffle_perfect
0,17,25,6,48,0.354,23,0.479,3,1,0.75,5,0,37,11,10,11,27,0.208,0.229,0.562,17.567,43,riffle_perfect
0,20,24,3,47,0.426,23,0.489,1,1,0.5,2,2,28,19,12,11,24,0.255,0.234,0.511,17.558,44,riffle_perfect
0,19,21,3,43,0.442,22,0.512,4,2,0.667,0,1,25,18,12,15,16,0.279,0.349,0.372,17.555,45,riffle_perfect
0,18,22,5,45,0.4,23,0.511,2,2,0.5,3,4,29,16,7,19,19,0.156,0.422,0.422,17.553,46,riffle_perfect
0,21,22,3,46,0.457,24,0.522,2,3,0.4,1,1,28,18,8,15,23,0.174,0.326,0.5,17.567,47,riffle_perfect
0,24,18,3,45,0.533,27,0.6,4,2,0.667,3,1,26,19,13,11,21,0.289,0.244,0.467,17.582,48,riffle_perfect
0,16,22,7,45,0.356,23,0.511,3,2,0.6,2,4,26,19,10,14,21,0.222,0.311,0.467,17.583,49,riffle_perfect
0,22,22,2,46,0.478,24,0.522,8,2,0.8,2,2,21,25,14,13,19,0.304,0.283,0.413,17.571,50,riffle_perfect
0,18,22,5,45,0.4,23,0.511,2,1,0.667,1,1,32,13,8,15,22,0.178,0.333,0.489,17.579,51,riffle_perfect
0,24,17,3,44,0.545,27,0.614,1,0,1.0,0,4,30,14,14,13,17,0.318,0.295,0.386,17.593,52,riffle_perfect
0,21,16,7,44,0.477,28,0.636,4,2,0.667,2,1,23,21,13,15,16,0.295,0.341,0.364,17.599,53,riffle_perfect
0,18,23,4,45,0.4,22,0.489,2,4,0.333,0,3,27,18,12,14,19,0.267,0.311,0.422,17.604,54,riffle_perfect
0,21,20,3,44,0.477,24,0.545,2,3,0.4,2,2,26,18,10,18,16,0.227,0.409,0.364,17.619,55,riffle_perfect
0,24,19,4,47,0.511,28,0.596,4,0,1.0,1,2,20,27,17,12,18,0.362,0.255,0.383,17.617,56,riffle_perfect
0,19,24,4,47,0.404,23,0.489,0,5,0.0,3,4,28,19,11,13,23,0.234,0.277,0.489,17.615,57,riffle_perfect
0,16,20,9,45,0.356,25,0.556,1,2,0.333,2,0,27,18,9,15,21,0.2,0.333,0.467,17.617,58,riffle_perfect
0,18,22,5,45,0.4,23,0.511,1,2,0.333,2,2,33,12,12,11,22,0.267,0.244,0.489,17.62,59,riffle_perfect
0,25,19,2,46,0.543,27,0.587,3,3,0.5,1,3,19,27,14,16,16,0.304,0.348,0.348,17.627,60,riffle_perfect
0,13,28,5,46,0.283,18,0.391,2,2,0.5,2,0,29,17,7,14,25,0.152,0.304,0.543,17.626,61,riffle_perfect
0,17,27,1,45,0.378,18,0.4,3,2,0.6,1,4,24,21,10,14,21,0.222,0.311,0.467,17.618,62,riffle_perfect
0,20,24,0,44,0.455,20,0.455,2,1,0.667,1,1,28,16,9,12,23,0.205,0.273,0.523,17.609,63,riffle_perfect
0,24,19,3,46,0.522,27,0.587,3,1,0.75,2,2,27,19,12,13,21,0.261,0.283,0.457,17.61,64,riffle_perfect
0,19,19,6,44,0.432,25,0.568,5,4,0.556,2,3,27,17,15,11,18,0.341,0.25,0.409,17.611,65,riffle_perfect
0,34,16,2,52,0.654,36,0.692,4,0,1.0,4,1,32,20,13,16,23,0.25,0.308,0.442,17.611,66,riffle_perfect
0,18,28,2,48,0.375,20,0.417,2,5,0.286,0,2,23,25,15,23,10,0.312,0.479,0.208,17.617,67,riffle_perfect
0,14,27,5,46,0.304,19,0.413,2,4,0.333,0,4,31,15,9,16,21,0.196,0.348,0.457,17.619,68,riffle_perfect
0,23,20,3,46,0.5,26,0.565,2,1,0.667,6,2,30,16,9,10,27,0.196,0.217,0.587,17.609,69,riffle_perfect
0,19,24,2,45,0.422,21,0.467,3,2,0.6,2,2,24,21,9,20,16,0.2,0.444,0.356,17.608,70,riffle_perfect
0,15,23,5,43,0.349,20,0.465,2,3,0.4,4,2,29,14,5,11,27,0.116,0.256,0.628,17.601,71,riffle_perfect
0,19,19,5,43,0.442,24,0.558,2,3,0.4,2,2,29,14,8,13,22,0.186,0.302,0.512,17.595,72,riffle_perfect
0,24,15,7,46,0.522,31,0.674,1,1,0.5,4,2,28,18,12,17,17,0.261,0.37,0.37,17.606,73,riffle_perfect
0,24,16,4,44,0.545,28,0.636,4,1,0.8,1,3,27,17,15,10,19,0.341,0.227,0.432,17.612,74,riffle_perfect
0,19,23,4,46,0.413,23,0.5,4,2,0.667,3,4,33,13,10,12,24,0.217,0.261,0.522,17.614,75,riffle_perfect
0,16,24,7,47,0.34,23,0.489,1,10,0.091,2,2,28,19,7,21,19,0.149,0.447,0.404,17.623,76,riffle_perfect
0,21,20,3,44,0.477,24,0.545,2,3,0.4,0,1,28,16,13,9,22,0.295,0.205,0.5,17.627,77,riffle_perfect
0,20,21,3,44,0.455,23,0.523,3,5,0.375,2,1,27,17,7,19,18,0.159,0.432,0.409,17.633,78,riffle_perfect
0,22,20,5,47,0.468,27,0.574,0,5,0.0,0,2,28,19,12,23,12,0.255,0.489,0.255,17.642,79,riffle_perfect
0,21,18,5,44,0.477,26,0.591,2,2,0.5,0,2,31,13,13,11,20,0.295,0.25,0.455,17.644,80,riffle_perfect
0,17,23,4,44,0.386,21,0.477,5,3,0.625,1,2,29,15,9,13,22,0.205,0.295,0.5,17.644,81,riffle_perfect
0,14,24,6,44,0.318,20,0.455,1,3,0.25,1,2,33,11,8,14,22,0.182,0.318,0.5,17.646,82,riffle_perfect
0,15,26,6,47,0.319,21,0.447,2,1,0.667,0,2,29,18,8,15,24,0.17,0.319,0.511,17.655,83,riffle_perfect
0,14,30,3,47,0.298,17,0.362,2,2,0.5,3,4,28,19,6,18,23,0.128,0.383,0.489,17.653,84,riffle_perfect
0,18,22,6,46,0.391,24,0.522,4,0,1.0,0,1,24,22,10,20,16,0.217,0.435,0.348,17.656,85,riffle_perfect
0,19,21,6,46,0.413,25,0.543,1,1,0.5,2,1,32,14,7,20,19,0.152,0.435,0.413,17.655,86,riffle_perfect
0,20,22,3,45,0.444,23,0.511,4,0,1.0,3,3,23,22,13,13,19,0.289,0.289,0.422,17.655,87,riffle_perfect
0,20,19,4,43,0.465,24,0.558,3,2,0.6,1,2,27,16,14,10,19,0.326,0.233,0.442,17.657,88,riffle_perfect
0,19,20,5,44,0.432,24,0.545,2,0,1.0,1,1,26,18,9,16,19,0.205,0.364,0.432,17.648,89,riffle_perfect
0,22,21,3,46,0.478,25,0.543,1,3,0.25,4,2,33,13,11,11,24,0.239,0.239,0.522,17.644,90,riffle_perfect
0,29,12,3,44,0.659,32,0.727,9,2,0.818,5,3,25,19,15,11,18,0.341,0.25,0.409,17.647,91,riffle_perfect
0,25,19,4,48,0.521,29,0.604,3,3,0.5,1,1,24,24,19,13,16,0.396,0.271,0.333,17.651,92,riffle_perfect
0,16,22,8,46,0.348,24,0.522,1,4,0.2,2,2,22,24,9,17,20,0.196,0.37,0.435,17.658,93,riffle_perfect
0,21,14,8,43,0.488,29,0.674,2,3,0.4,4,1,27,16,9,17,17,0.209,0.395,0.395,17.658,94,riffle_perfect
0,16,24,4,44,0.364,20,0.455,3,1,0.75,2,4,26,18,8,15,21,0.182,0.341,0.477,17.654,95,riffle_perfect
0,23,18,4,45,0.511,27,0.6,0,4,0.0,1,4,27,18,14,13,18,0.311,0.289,0.4,17.655,96,riffle_perfect
0,17,25,4,46,0.37,21,0.457,3,4,0.429,2,8,32,14,9,13,24,0.196,0.283,0.522,18.259,1,riffle_perfect
0,16,24,4,44,0.364,20,0.455,3,3,0.5,2,3,28,16,9,11,24,0.205,0.25,0.545,18.207,2,riffle_perfect
0,17,25,3,45,0.378,20,0.444,2,0,1.0,2,4,30,15,8,14,23,0.178,0.311,0.511,17.956,3,riffle_perfect
0,22,20,3,45,0.489,25,0.556,5,2,0.714,6,2,24,21,9,12,24,0.2,0.267,0.533,17.811,4,riffle_perfect
0,18,21,5,44,0.409,23,0.523,5,4,0.556,1,3,33,11,9,9,26,0.205,0.205,0.591,17.895,5,riffle_perfect
0,17,24,4,45,0.378,21,0.467,0,0,0,2,1,27,18,9,14,22,0.2,0.311,0.489,17.783,6,riffle_perfect
0,20,17,7,44,0.455,27,0.614,2,1,0.667,3,1,28,16,12,13,19,0.273,0.295,0.432,17.762,7,riffle_perfect
0,21,21,4,46,0.457,25,0.543,2,2,0.5,2,2,30,16,12,12,22,0.261,0.261,0.478,17.638,8,riffle_perfect
0,17,23,9,49,0.347,26,0.531,3,1,0.75,3,4,29,20,9,19,21,0.184,0.388,0.429,17.683,9,riffle_perfect
0,25,17,2,44,0.568,27,0.614,5,0,1.0,4,1,21,23,15,15,14,0.341,0.341,0.318,17.69,10,riffle_perfect
0,20,23,1,44,0.455,21,0.477,3,4,0.429,0,3,25,19,14,12,18,0.318,0.273,0.409,17.682,11,riffle_perfect
0,22,21,1,44,0.5,23,0.523,2,4,0.333,3,1,30,14,12,13,19,0.273,0.295,0.432,17.594,12,riffle_perfect
0,18,22,6,46,0.391,24,0.522,4,2,0.667,1,4,37,9,8,15,23,0.174,0.326,0.5,17.642,13,riffle_perfect
0,17,27,2,46,0.37,19,0.413,2,0,1.0,1,3,32,14,6,14,26,0.13,0.304,0.565,17.684,14,riffle_perfect
0,20,21,2,43,0.465,22,0.512,0,3,0.0,4,0,27,16,8,14,21,0.186,0.326,0.488,17.682,15,riffle_perfect
0,19,22,4,45,0.422,23,0.511,4,3,0.571,4,1,34,11,10,11,24,0.222,0.244,0.533,17.666,16,riffle_perfect
0,25,18,0,43,0.581,25,0.581,7,1,0.875,1,2,26,17,16,11,16,0.372,0.256,0.372,17.656,17,riffle_perfect
0,17,26,3,46,0.37,20,0.435,0,5,0.0,3,2,24,22,6,18,22,0.13,0.391,0.478,17.659,18,riffle_perfect
0,20,18,6,44,0.455,26,0.591,5,1,0.833,1,0,32,12,10,14,20,0.227,0.318,0.455,17.672,19,riffle_perfect
0,22,22,3,47,0.468,25,0.532,6,4,0.6,3,2,24,23,10,14,23,0.213,0.298,0.489,17.658,20,riffle_perfect
0,24,21,3,48,0.5,27,0.562,1,3,0.25,5,1,31,17,9,19,20,0.188,0.396,0.417,17.643,21,riffle_perfect
0,18,18,10,46,0.391,28,0.609,6,3,0.667,0,1,30,16,7,15,24,0.152,0.326,0.522,17.664,22,riffle_perfect
0,17,23,6,46,0.37,23,0.5,5,1,0.833,3,2,31,15,6,16,24,0.13,0.348,0.522,17.646,23,riffle_perfect
0,17,22,5,44,0.386,22,0.5,3,2,0.6,2,2,24,20,12,18,14,0.273,0.409,0.318,17.646,24,riffle_perfect
0,29,18,5,52,0.558,34,0.654,5,3,0.625,2,2,32,20,12,17,23,0.231,0.327,0.442,17.659,25,riffle_perfect
0,18,20,8,46,0.391,26,0.565,2,1,0.667,3,4,33,13,5,12,29,0.109,0.261,0.63,17.644,26,riffle_perfect
0,21,20,3,44,0.477,24,0.545,3,1,0.75,1,0,28,16,14,12,18,0.318,0.273,0.409,17.65,27,riffle_perfect
0,20,22,2,44,0.455,22,0.5,3,6,0.333,1,1,28,16,13,14,17,0.295,0.318,0.386,17.677,28,riffle_perfect
0,23,20,2,45,0.511,25,0.556,4,3,0.571,4,2,23,22,10,16,19,0.222,0.356,0.422,17.679,29,riffle_perfect
0,15,26,4,45,0.333,19,0.422,5,2,0.714,0,5,34,11,9,12,24,0.2,0.267,0.533,17.694,30,riffle_perfect
0,20,21,5,46,0.435,25,0.543,2,5,0.286,2,2,24,22,14,13,19,0.304,0.283,0.413,17.724,31,riffle_perfect
0,21,18,6,45,0.467,27,0.6,3,0,1.0,2,3,25,20,11,16,18,0.244,0.356,0.4,17.733,32,riffle_perfect
0,24,18,2,44,0.545,26,0.591,5,3,0.625,2,2,32,12,11,11,22,0.25,0.25,0.5,17.732,33,riffle_perfect
0,19,20,6,45,0.422,25,0.556,1,0,1.0,3,1,26,19,11,13,21,0.244,0.289,0.467,17.726,34,riffle_perfect
0,19,25,2,46,0.413,21,0.457,3,3,0.5,1,3,27,19,10,18,18,0.217,0.391,0.391,17.75,35,riffle_perfect
0,22,23,2,47,0.468,24,0.511,1,1,0.5,7,2,35,12,5,11,31,0.106,0.234,0.66,17.726,36,riffle_perfect
0,16,26,2,44,0.364,18,0.409,1,6,0.143,0,3,26,18,10,16,18,0.227,0.364,0.409,17.723,37,riffle_perfect
0,21,17,7,45,0.467,28,0.622,5,2,0.714,3,0,23,22,10,11,24,0.222,0.244,0.533,17.72,38,riffle_perfect
0,18,26,7,51,0.353,25,0.49,3,3,0.5,4,3,26,25,11,14,26,0.216,0.275,0.51,17.724,39,riffle_perfect
0,29,12,4,45,0.644,33,0.733,5,1,0.833,3,1,22,23,13,11,21,0.289,0.244,0.467,17.721,40,riffle_perfect
0,18,21,5,44,0.409,23,0.523,5,1,0.833,1,0,30,14,10,11,23,0.227,0.25,0.523,17.716,41,riffle_perfect
0,22,20,2,44,0.5,24,0.545,2,1,0.667,5,2,31,13,12,10,22,0.273,0.227,0.5,17.702,42,riffle_perfect
0,16,23,4,43,0.372,20,0.465,0,1,0.0,1,2,29,14,12,10,21,0.279,0.233,0.488,17.709,43,riffle_perfect
0,18,23,4,45,0.4,22,0.489,1,2,0.333,1,1,24,21,12,17,16,0.267,0.378,0.356,17.718,44,riffle_perfect
0,22,19,4,45,0.489,26,0.578,4,1,0.8,5,1,28,17,12,10,23,0.267,0.222,0.511,17.713,45,riffle_perfect
0,17,21,5,43,0.395,22,0.512,1,2,0.333,1,2,33,10,8,15,20,0.186,0.349,0.465,17.712,46,riffle_perfect
0,22,18,3,43,0.512,25,0.581,2,1,0.667,1,3,26,17,13,15,15,0.302,0.349,0.349,17.717,47,riffle_perfect
0,24,14,5,43,0.558,29,0.674,5,2,0.714,0,1,28,15,14,8,21,0.326,0.186,0.488,17.714,48,riffle_perfect
0,16,26,5,47,0.34,21,0.447,2,2,0.5,2,5,35,12,8,13,26,0.17,0.277,0.553,17.717,49,riffle_perfect
0,22,18,5,45,0.489,27,0.6,4,0,1.0,1,3,29,16,17,11,17,0.378,0.244,0.378,17.705,50,riffle_perfect
0,16,24,4,44,0.364,20,0.455,3,2,0.6,0,3,29,15,7,14,23,0.159,0.318,0.523,17.698,51,riffle_perfect
0,18,21,6,45,0.4,24,0.533,5,2,0.714,3,1,31,14,7,14,24,0.156,0.311,0.533,17.696,52,riffle_perfect
0,22,23,5,50,0.44,27,0.54,0,2,0.0,2,1,28,22,11,17,22,0.22,0.34,0.44,17.704,53,riffle_perfect
0,18,23,3,44,0.409,21,0.477,3,1,0.75,1,2,29,15,10,13,21,0.227,0.295,0.477,17.702,54,riffle_perfect
0,13,30,4,47,0.277,17,0.362,2,4,0.333,1,1,27,20,6,20,21,0.128,0.426,0.447,17.707,55,riffle_perfect
0,23,17,5,45,0.511,28,0.622,5,0,1.0,3,1,28,17,13,15,17,0.289,0.333,0.378,17.706,56,riffle_perfect
0,15,30,3,48,0.312,18,0.375,1,1,0.5,4,5,25,23,7,19,22,0.146,0.396,0.458,17.704,57,riffle_perfect
0,19,24,1,44,0.432,20,0.455,4,2,0.667,3,3,28,16,11,9,24,0.25,0.205,0.545,17.69,58,riffle_perfect
0,15,25,3,43,0.349,18,0.419,2,6,0.25,0,2,27,16,11,13,19,0.256,0.302,0.442,17.683,59,riffle_perfect
0,16,26,3,45,0.356,19,0.422,5,1,0.833,2,5,26,19,11,9,25,0.244,0.2,0.556,17.684,60,riffle_perfect
0,15,25,5,45,0.333,20,0.444,4,4,0.5,2,4,27,18,9,14,22,0.2,0.311,0.489,17.686,61,riffle_perfect
0,19,21,4,44,0.432,23,0.523,4,1,0.8,1,3,30,14,10,13,21,0.227,0.295,0.477,17.69,62,riffle_perfect
0,19,22,3,44,0.432,22,0.5,2,0,1.0,0,4,29,15,10,14,20,0.227,0.318,0.455,17.691,63,riffle_perfect
0,22,20,4,46,0.478,26,0.565,3,4,0.429,3,1,31,15,10,12,24,0.217,0.261,0.522,17.681,64,riffle_perfect
0,17,23,5,45,0.378,22,0.489,2,4,0.333,0,0,25,20,7,20,18,0.156,0.444,0.4,17.687,65,riffle_perfect
0,20,20,4,44,0.455,24,0.545,4,0,1.0,0,1,30,14,10,15,19,0.227,0.341,0.432,17.689,66,riffle_perfect
0,18,24,3,45,0.4,21,0.467,3,3,0.5,2,0,28,17,11,15,19,0.244,0.333,0.422,17.691,67,riffle_perfect
0,19,27,2,48,0.396,21,0.438,1,2,0.333,1,4,25,23,8,19,21,0.167,0.396,0.438,17.692,68,riffle_perfect
0,17,24,3,44,0.386,20,0.455,0,2,0.0,1,3,27,17,14,11,19,0.318,0.25,0.432,17.706,69,riffle_perfect
0,23,21,3,47,0.489,26,0.553,4,2,0.667,3,2,24,23,10,22,15,0.213,0.468,0.319,17.714,70,riffle_perfect
0,17,20,7,44,0.386,24,0.545,5,2,0.714,1,4,28,16,14,14,16,0.318,0.318,0.364,17.724,71,riffle_perfect
0,17,21,9,47,0.362,26,0.553,4,5,0.444,4,1,32,15,2,17,28,0.043,0.362,0.596,17.727,72,riffle_perfect
0,16,24,4,44,0.364,20,0.455,2,3,0.4,1,3,28,16,9,14,21,0.205,0.318,0.477,17.733,73,riffle_perfect
0,24,18,3,45,0.533,27,0.6,5,0,1.0,4,2,23,22,13,12,20,0.289,0.267,0.444,17.724,74,riffle_perfect
0,18,25,3,46,0.391,21,0.457,2,3,0.4,2,2,29,17,5,21,20,0.109,0.457,0.435,17.724,75,riffle_perfect
0,24,15,5,44,0.545,29,0.659,3,1,0.75,3,1,29,15,11,13,20,0.25,0.295,0.455,17.723,76,riffle_perfect
0,22,24,2,48,0.458,24,0.5,1,1,0.5,3,2,30,18,10,13,25,0.208,0.271,0.521,17.72,77,riffle_perfect
0,18,23,4,45,0.4,22,0.489,2,3,0.4,4,2,28,17,9,14,22,0.2,0.311,0.489,17.719,78,riffle_perfect
0,22,18,6,46,0.478,28,0.609,5,2,0.714,3,2,28,18,9,10,27,0.196,0.217,0.587,17.714,79,riffle_perfect
0,17,22,6,45,0.378,23,0.511,2,1,0.667,1,4,36,9,8,15,22,0.178,0.333,0.489,17.713,80,riffle_perfect
0,22,17,7,46,0.478,29,0.63,6,3,0.667,0,5,29,17,13,12,21,0.283,0.261,0.457,17.716,81,riffle_perfect
0,23,20,6,49,0.469,29,0.592,6,2,0.75,3,3,29,20,9,15,25,0.184,0.306,0.51,17.712,82,riffle_perfect
0,18,25,4,47,0.383,22,0.468,1,3,0.25,4,3,27,20,10,13,24,0.213,0.277,0.511,17.706,83,riffle_perfect
0,16,24,3,43,0.372,19,0.442,2,1,0.667,1,2,23,20,14,14,15,0.326,0.326,0.349,17.711,84,riffle_perfect
0,24,18,3,45,0.533,27,0.6,1,0,1.0,3,2,24,21,13,12,20,0.289,0.267,0.444,17.706,85,riffle_perfect
0,23,21,3,47,0.489,26,0.553,5,0,1.0,3,1,28,19,10,17,20,0.213,0.362,0.426,17.7,86,riffle_perfect
0,18,28,0,46,0.391,18,0.391,0,0,0,2,2,29,17,7,17,22,0.152,0.37,0.478,17.689,87,riffle_perfect
0,14,29,2,45,0.311,16,0.356,4,1,0.8,2,3,29,16,6,16,23,0.133,0.356,0.511,17.691,88,riffle_perfect
0,12,24,9,45,0.267,21,0.467,3,0,1.0,0,4,28,17,9,13,23,0.2,0.289,0.511,17.694,89,riffle_perfect
0,22,22,2,46,0.478,24,0.522,0,1,0.0,2,1,27,19,12,13,21,0.261,0.283,0.457,17.69,90,riffle_perfect
0,22,24,0,46,0.478,22,0.478,1,2,0.333,5,3,34,12,13,6,27,0.283,0.13,0.587,17.673,91,riffle_perfect
0,20,18,5,43,0.465,25,0.581,4,2,0.667,2,5,32,11,10,10,23,0.233,0.233,0.535,17.67,92,riffle_perfect
0,29,19,2,50,0.58,31,0.62,4,2,0.667,3,3,30,20,14,13,23,0.28,0.26,0.46,17.673,93,riffle_perfect
0,18,25,5,48,0.375,23,0.479,2,0,1.0,4,3,29,19,7,20,21,0.146,0.417,0.438,17.675,94,riffle_perfect
0,21,20,5,46,0.457,26,0.565,4,1,0.8,2,2,25,21,12,14,20,0.261,0.304,0.435,17.675,95,riffle_perfect
0,16,24,5,45,0.356,21,0.467,2,1,0.667,1,2,32,13,6,21,18,0.133,0.467,0.4,17.675,96,riffle_perfect
0,18,23,3,44,0.409,21,0.477,3,4,0.429,0,1,26,18,9,18,17,0.205,0.409,0.386,18.152,1,riffle_perfect
0,25,16,3,44,0.568,28,0.636,4,3,0.571,0,1,25,19,13,16,15,0.295,0.364,0.341,17.855,2,riffle_perfect
0,27,18,3,48,0.562,30,0.625,5,1,0.833,1,1,33,15,12,8,28,0.25,0.167,0.583,17.747,3,riffle_perfect
0,16,23,5,44,0.364,21,0.477,2,5,0.286,2,3,27,17,7,17,20,0.159,0.386,0.455,17.781,4,riffle_perfect
0,21,20,4,45,0.467,25,0.556,5,2,0.714,2,2,30,15,10,14,21,0.222,0.311,0.467,17.61,5,riffle_perfect
0,29,16,0,45,0.644,29,0.644,7,2,0.778,7,0,26,19,12,14,19,0.267,0.311,0.422,17.563,6,riffle_perfect
0,20,21,5,46,0.435,25,0.543,5,5,0.5,3,2,31,15,10,10,26,0.217,0.217,0.565,17.543,7,riffle_perfect
0,25,15,4,44,0.568,29,0.659,5,2,0.714,4,2,27,17,12,11,21,0.273,0.25,0.477,17.516,8,riffle_perfect
0,23,24,2,49,0.469,25,0.51,7,3,0.7,0,0,27,22,17,12,20,0.347,0.245,0.408,17.541,9,riffle_perfect
0,24,21,2,47,0.511,26,0.553,4,2,0.667,2,3,30,17,12,14,21,0.255,0.298,0.447,17.552,10,riffle_perfect
0,25,16,5,46,0.543,30,0.652,6,3,0.667,0,1,26,20,17,12,17,0.37,0.261,0.37,17.551,11,riffle_perfect
0,19,20,5,44,0.432,24,0.545,2,1,0.667,3,2,28,16,8,18,18,0.182,0.409,0.409,17.526,12,riffle_perfect
0,20,20,5,45,0.444,25,0.556,2,1,0.667,1,1,27,18,12,13,20,0.267,0.289,0.444,17.55,13,riffle_perfect
0,20,23,2,45,0.444,22,0.489,5,3,0.625,2,2,37,8,10,7,28,0.222,0.156,0.622,17.563,14,riffle_perfect
0,22,19,5,46,0.478,27,0.587,3,2,0.6,3,1,31,15,14,14,18,0.304,0.304,0.391,17.567,15,riffle_perfect
0,21,26,2,49,0.429,23,0.469,2,1,0.667,1,4,34,15,12,13,24,0.245,0.265,0.49,17.575,16,riffle_perfect
0,18,23,5,46,0.391,23,0.5,4,3,0.571,2,1,27,19,9,18,19,0.196,0.391,0.413,17.56,17,riffle_perfect
0,14,24,3,41,0.341,17,0.415,3,2,0.6,0,0,23,18,8,16,17,0.195,0.39,0.415,17.599,18,riffle_perfect
0,16,24,6,46,0.348,22,0.478,2,4,0.333,4,1,30,16,6,16,24,0.13,0.348,0.522,17.599,19,riffle_perfect
0,19,20,6,45,0.422,25,0.556,3,1,0.75,2,2,22,23,14,14,17,0.311,0.311,0.378,17.599,20,riffle_perfect
0,21,19,6,46,0.457,27,0.587,2,3,0.4,2,3,30,16,12,15,19,0.261,0.326,0.413,17.557,21,riffle_perfect
0,25,22,1,48,0.521,26,0.542,2,5,0.286,2,0,25,23,9,20,19,0.188,0.417,0.396,17.571,22,riffle_perfect
0,26,19,4,49,0.531,30,0.612,3,4,0.429,2,0,28,21,16,12,21,0.327,0.245,0.429,17.566,23,riffle_perfect
0,22,20,5,47,0.468,27,0.574,2,3,0.4,2,4,32,15,10,15,22,0.213,0.319,0.468,17.57,24,riffle_perfect
0,20,23,4,47,0.426,24,0.511,2,2,0.5,3,3,28,19,13,13,21,0.277,0.277,0.447,17.569,25,riffle_perfect
0,13,26,4,43,0.302,17,0.395,2,2,0.5,2,3,29,14,2,19,22,0.047,0.442,0.512,17.546,26,riffle_perfect
0,18,21,7,46,0.391,25,0.543,5,3,0.625,2,1,38,8,6,7,33,0.13,0.152,0.717,17.56,27,riffle_perfect
0,15,23,6,44,0.341,21,0.477,2,1,0.667,2,2,30,14,7,12,25,0.159,0.273,0.568,17.593,28,riffle_perfect
0,19,23,4,46,0.413,23,0.5,6,1,0.857,1,1,27,19,10,12,24,0.217,0.261,0.522,17.585,29,riffle_perfect
0,18,22,6,46,0.391,24,0.522,1,2,0.333,4,2,25,21,9,16,21,0.196,0.348,0.457,17.588,30,riffle_perfect
0,24,17,5,46,0.522,29,0.63,4,1,0.8,2,3,24,22,10,16,20,0.217,0.348,0.435,17.589,31,riffle_perfect
0,13,26,4,43,0.302,17,0.395,0,3,0.0,1,5,31,12,11,14,18,0.256,0.326,0.419,17.6,32,riffle_perfect
0,18,16,12,46,0.391,30,0.652,3,1,0.75,1,0,21,25,9,19,18,0.196,0.413,0.391,17.616,33,riffle_perfect
0,21,20,2,43,0.488,23,0.535,4,4,0.5,3,1,29,14,10,12,21,0.233,0.279,0.488,17.627,34,riffle_perfect
0,18,21,5,44,0.409,23,0.523,2,1,0.667,2,2,24,20,10,14,20,0.227,0.318,0.455,17.627,35,riffle_perfect
0,21,25,4,50,0.42,25,0.5,0,4,0.0,0,1,22,28,15,17,18,0.3,0.34,0.36,17.629,36,riffle_perfect
0,20,22,4,46,0.435,24,0.522,2,4,0.333,4,2,31,15,7,12,27,0.152,0.261,0.587,17.614,37,riffle_perfect
0,20,22,4,46,0.435,24,0.522,4,1,0.8,1,3,24,22,11,14,21,0.239,0.304,0.457,17.635,38,riffle_perfect
0,12,31,5,48,0.25,17,0.354,3,1,0.75,2,2,23,25,5,25,18,0.104,0.521,0.375,17.631,39,riffle_perfect
0,24,15,6,45,0.533,30,0.667,6,1,0.857,2,1,19,26,15,17,13,0.333,0.378,0.289,17.64,40,riffle_perfect
0,17,26,4,47,0.362,21,0.447,3,2,0.6,2,4,35,12,9,12,26,0.191,0.255,0.553,17.633,41,riffle_perfect
0,26,20,4,50,0.52,30,0.6,1,4,0.2,5,2,25,25,13,13,24,0.26,0.26,0.48,17.627,42,riffle_perfect
0,17,29,1,47,0.362,18,0.383,2,4,0.333,2,1,28,19,7,17,23,0.149,0.362,0.489,17.642,43,riffle_perfect
0,20,20,5,45,0.444,25,0.556,1,4,0.2,2,3,28,17,9,12,24,0.2,0.267,0.533,17.64,44,riffle_perfect
0,22,19,4,45,0.489,26,0.578,4,2,0.667,1,2,31,14,8,18,19,0.178,0.4,0.422,17.639,45,riffle_perfect
0,20,23,1,44,0.455,21,0.477,2,2,0.5,1,3,30,14,9,14,21,0.205,0.318,0.477,17.644,46,riffle_perfect
0,22,19,4,45,0.489,26,0.578,6,1,0.857,4,3,31,14,10,15,20,0.222,0.333,0.444,17.641,47,riffle_perfect
0,18,24,4,46,0.391,22,0.478,3,0,1.0,1,0,28,18,8,15,23,0.174,0.326,0.5,17.655,48,riffle_perfect
0,18,23,4,45,0.4,22,0.489,3,0,1.0,2,3,32,13,12,9,24,0.267,0.2,0.533,17.642,49,riffle_perfect
0,20,25,1,46,0.435,21,0.457,3,2,0.6,2,1,25,21,12,18,16,0.261,0.391,0.348,17.646,50,riffle_perfect
0,26,22,1,49,0.531,27,0.551,3,1,0.75,3,2,29,20,12,16,21,0.245,0.327,0.429,17.635,51,riffle_perfect
0,14,28,5,47,0.298,19,0.404,3,6,0.333,2,2,30,17,6,10,31,0.128,0.213,0.66,17.643,52,riffle_perfect
0,24,18,2,44,0.545,26,0.591,3,5,0.375,4,2,21,23,12,16,16,0.273,0.364,0.364,17.64,53,riffle_perfect
0,19,24,4,47,0.404,23,0.489,4,5,0.444,1,2,29,18,13,14,20,0.277,0.298,0.426,17.646,54,riffle_perfect
0,17,25,3,45,0.378,20,0.444,0,2,0.0,1,3,26,19,8,16,21,0.178,0.356,0.467,17.659,55,riffle_perfect
0,22,18,5,45,0.489,27,0.6,1,2,0.333,1,3,32,13,12,10,23,0.267,0.222,0.511,17.657,56,riffle_perfect
0,22,18,4,44,0.5,26,0.591,6,0,1.0,1,0,23,21,14,11,19,0.318,0.25,0.432,17.654,57,riffle_perfect
0,17,27,2,46,0.37,19,0.413,4,4,0.5,1,2,24,22,12,16,18,0.261,0.348,0.391,17.663,58,riffle_perfect
0,20,22,5,47,0.426,25,0.532,4,1,0.8,4,1,28,19,12,14,21,0.255,0.298,0.447,17.673,59,riffle_perfect
0,16,24,5,45,0.356,21,0.467,2,2,0.5,2,2,25,20,10,14,21,0.222,0.311,0.467,17.683,60,riffle_perfect
0,22,24,2,48,0.458,24,0.5,7,1,0.875,3,2,24,24,12,17,19,0.25,0.354,0.396,17.673,61,riffle_perfect
0,20,18,7,45,0.444,27,0.6,3,5,0.375,4,1,28,17,9,12,24,0.2,0.267,0.533,17.675,62,riffle_perfect
0,23,22,4,49,0.469,27,0.551,0,1,0.0,4,1,28,21,12,15,22,0.245,0.306,0.449,17.677,63,riffle_perfect
0,25,16,3,44,0.568,28,0.636,4,1,0.8,3,3,27,17,13,14,17,0.295,0.318,0.386,17.664,64,riffle_perfect
0,20,21,5,46,0.435,25,0.543,1,1,0.5,2,2,29,17,11,15,20,0.239,0.326,0.435,17.667,65,riffle_perfect
0,17,25,2,44,0.386,19,0.432,6,5,0.545,5,3,29,15,7,14,23,0.159,0.318,0.523,17.671,66,riffle_perfect
0,20,20,3,43,0.465,23,0.535,6,3,0.667,1,1,24,19,9,17,17,0.209,0.395,0.395,17.679,67,riffle_perfect
0,19,22,4,45,0.422,23,0.511,3,3,0.5,0,4,32,13,12,11,22,0.267,0.244,0.489,17.681,68,riffle_perfect
0,21,21,3,45,0.467,24,0.533,2,2,0.5,5,2,29,16,6,16,23,0.133,0.356,0.511,17.674,69,riffle_perfect
0,19,23,2,44,0.432,21,0.477,4,2,0.667,0,1,26,18,17,9,18,0.386,0.205,0.409,17.675,70,riffle_perfect
0,19,23,2,44,0.432,21,0.477,0,2,0.0,1,1,27,17,8,15,21,0.182,0.341,0.477,17.68,71,riffle_perfect
0,19,25,3,47,0.404,22,0.468,2,3,0.4,1,4,33,14,10,13,24,0.213,0.277,0.511,17.68,72,riffle_perfect
0,13,26,6,45,0.289,19,0.422,1,1,0.5,2,2,33,12,7,16,22,0.156,0.356,0.489,17.666,73,riffle_perfect
0,18,25,2,45,0.4,20,0.444,2,4,0.333,3,2,34,11,10,6,29,0.222,0.133,0.644,17.665,74,riffle_perfect
0,19,23,2,44,0.432,21,0.477,2,3,0.4,4,3,23,21,9,17,18,0.205,0.386,0.409,17.662,75,riffle_perfect
0,18,25,3,46,0.391,21,0.457,2,0,1.0,0,3,33,13,9,15,22,0.196,0.326,0.478,17.67,76,riffle_perfect
0,16,26,4,46,0.348,20,0.435,4,4,0.5,2,2,32,14,9,12,25,0.196,0.261,0.543,17.673,77,riffle_perfect
0,24,16,5,45,0.533,29,0.644,4,1,0.8,2,1,25,20,13,14,18,0.289,0.311,0.4,17.674,78,riffle_perfect
0,21,22,3,46,0.457,24,0.522,0,4,0.0,2,1,28,18,8,18,20,0.174,0.391,0.435,17.679,79,riffle_perfect
0,23,18,3,44,0.523,26,0.591,3,0,1.0,3,3,25,19,11,11,22,0.25,0.25,0.5,17.665,80,riffle_perfect
0,23,22,4,49,0.469,27,0.551,1,3,0.25,3,1,26,23,8,19,22,0.163,0.388,0.449,17.665,81,riffle_perfect
0,17,31,3,51,0.333,20,0.392,1,3,0.25,2,6,24,27,8,23,20,0.157,0.451,0.392,17.665,82,riffle_perfect
0,12,29,3,44,0.273,15,0.341,1,5,0.167,1,2,26,18,7,14,23,0.159,0.318,0.523,17.665,83,riffle_perfect
0,19,23,3,45,0.422,22,0.489,3,4,0.429,4,0,25,20,10,17,18,0.222,0.378,0.4,17.666,84,riffle_perfect
0,21,18,3,42,0.5,24,0.571,4,4,0.5,2,2,23,19,12,15,15,0.286,0.357,0.357,17.668,85,riffle_perfect
0,17,23,4,44,0.386,21,0.477,2,1,0.667,2,2,28,16,6,17,21,0.136,0.386,0.477,17.662,86,riffle_perfect
0,22,17,5,44,0.5,27,0.614,6,0,1.0,0,3,28,16,12,14,18,0.273,0.318,0.409,17.67,87,riffle_perfect
0,16,28,3,47,0.34,19,0.404,2,1,0.667,2,3,27,20,10,17,20,0.213,0.362,0.426,17.678,88,riffle_perfect
0,19,22,6,47,0.404,25,0.532,3,0,1.0,1,2,24,23,9,19,19,0.191,0.404,0.404,17.678,89,riffle_perfect
0,17,26,1,44,0.386,18,0.409,2,3,0.4,2,3,30,14,6,14,24,0.136,0.318,0.545,17.677,90,riffle_perfect
0,21,20,6,47,0.447,27,0.574,4,3,0.571,6,1,31,16,4,13,30,0.085,0.277,0.638,17.672,91,riffle_perfect
0,20,21,3,44,0.455,23,0.523,3,1,0.75,3,2,31,13,12,9,23,0.273,0.205,0.523,17.671,92,riffle_perfect
0,19,24,4,47,0.404,23,0.489,2,0,1.0,0,5,29,18,8,16,23,0.17,0.34,0.489,17.675,93,riffle_perfect
0,14,25,5,44,0.318,19,0.432,1,2,0.333,2,3,28,16,9,11,24,0.205,0.25,0.545,17.673,94,riffle_perfect
0,26,12,4,42,0.619,30,0.714,2,1,0.667,1,1,25,17,16,12,14,0.381,0.286,0.333,17.672,95,riffle_perfect
0,19,22,3,44,0.432,22,0.5,3,4,0.429,1,2,32,12,13,10,21,0.295,0.227,0.477,17.677,96,riffle_perfect
0,19,21,4,44,0.432,23,0.523,2,1,0.667,3,1,26,18,7,14,23,0.159,0.318,0.523,17.686,1,riffle_perfect
0,19,20,3,42,0.452,22,0.524,3,5,0.375,0,0,22,20,12,20,10,0.286,0.476,0.238,17.902,2,riffle_perfect
0,18,28,3,49,0.367,21,0.429,2,3,0.4,1,5,33,16,11,10,28,0.224,0.204,0.571,17.5,3,riffle_perfect
0,18,25,2,45,0.4,20,0.444,1,2,0.333,1,2,26,19,12,13,20,0.267,0.289,0.444,17.578,4,riffle_perfect
0,18,25,2,45,0.4,20,0.444,2,3,0.4,0,4,31,14,15,12,18,0.333,0.267,0.4,17.707,5,riffle_perfect
0,15,23,7,45,0.333,22,0.489,3,1,0.75,3,2,35,10,4,11,30,0.089,0.244,0.667,17.483,6,riffle_perfect
0,21,21,6,48,0.438,27,0.562,3,2,0.6,3,3,24,24,11,16,21,0.229,0.333,0.438,17.488,7,riffle_perfect
0,25,26,1,52,0.481,26,0.5,7,1,0.875,3,2,29,23,12,22,18,0.231,0.423,0.346,17.452,8,riffle_perfect
0,16,26,4,46,0.348,20,0.435,4,1,0.8,3,1,24,22,9,15,22,0.196,0.326,0.478,17.467,9,riffle_perfect
0,20,19,8,47,0.426,28,0.596,1,4,0.2,1,0,22,25,13,17,17,0.277,0.362,0.362,17.551,10,riffle_perfect
0,19,24,3,46,0.413,22,0.478,1,3,0.25,4,2,27,19,10,16,20,0.217,0.348,0.435,17.547,11,riffle_perfect
0,20,18,4,42,0.476,24,0.571,2,2,0.5,1,1,21,21,14,16,12,0.333,0.381,0.286,17.576,12,riffle_perfect
0,22,22,2,46,0.478,24,0.522,2,4,0.333,2,2,31,15,11,17,18,0.239,0.37,0.391,17.563,13,riffle_perfect
0,19,22,7,48,0.396,26,0.542,0,2,0.0,3,4,33,15,7,14,27,0.146,0.292,0.562,17.531,14,riffle_perfect
0,19,24,2,45,0.422,21,0.467,3,2,0.6,2,1,26,19,9,16,20,0.2,0.356,0.444,17.515,15,riffle_perfect
0,22,23,2,47,0.468,24,0.511,5,2,0.714,4,2,27,20,10,15,22,0.213,0.319,0.468,17.503,16,riffle_perfect
0,17,24,3,44,0.386,20,0.455,2,5,0.286,0,2,24,20,11,19,14,0.25,0.432,0.318,17.532,17,riffle_perfect
0,22,19,3,44,0.5,25,0.568,1,0,1.0,3,1,25,19,16,9,19,0.364,0.205,0.432,17.523,18,riffle_perfect
0,17,23,5,45,0.378,22,0.489,1,1,0.5,1,2,31,14,10,10,25,0.222,0.222,0.556,17.509,19,riffle_perfect
0,18,25,5,48,0.375,23,0.479,4,0,1.0,3,2,27,21,9,13,26,0.188,0.271,0.542,17.491,20,riffle_perfect
0,12,26,6,44,0.273,18,0.409,2,1,0.667,1,2,30,14,4,15,25,0.091,0.341,0.568,17.494,21,riffle_perfect
0,20,19,6,45,0.444,26,0.578,5,3,0.625,2,5,29,16,8,18,19,0.178,0.4,0.422,17.52,22,riffle_perfect
0,23,18,2,43,0.535,25,0.581,7,1,0.875,1,2,26,17,13,11,19,0.302,0.256,0.442,17.512,23,riffle_perfect
0,19,23,3,45,0.422,22,0.489,4,2,0.667,2,3,23,22,12,16,17,0.267,0.356,0.378,17.508,24,riffle_perfect
0,18,28,2,48,0.375,20,0.417,3,5,0.375,2,5,36,12,11,13,24,0.229,0.271,0.5,17.53,25,riffle_perfect
0,19,20,6,45,0.422,25,0.556,2,4,0.333,4,1,32,13,8,10,27,0.178,0.222,0.6,17.495,26,riffle_perfect
0,19,27,2,48,0.396,21,0.438,3,1,0.75,3,0,28,20,6,18,24,0.125,0.375,0.5,17.488,27,riffle_perfect
0,17,25,2,44,0.386,19,0.432,4,2,0.667,1,2,24,20,8,14,22,0.182,0.318,0.5,17.499,28,riffle_perfect
0,19,22,4,45,0.422,23,0.511,4,3,0.571,2,4,24,21,12,18,15,0.267,0.4,0.333,17.526,29,riffle_perfect
0,23,19,5,47,0.489,28,0.596,3,1,0.75,3,2,26,21,10,15,22,0.213,0.319,0.468,17.499,30,riffle_perfect
0,18,25,3,46,0.391,21,0.457,2,2,0.5,1,2,29,17,12,14,20,0.261,0.304,0.435,17.505,31,riffle_perfect
0,20,19,5,44,0.455,25,0.568,2,6,0.25,2,2,24,20,13,14,17,0.295,0.318,0.386,17.519,32,riffle_perfect
0,19,23,2,44,0.432,21,0.477,2,4,0.333,1,2,26,18,13,18,13,0.295,0.409,0.295,17.537,33,riffle_perfect
0,22,20,4,46,0.478,26,0.565,3,1,0.75,1,1,30,16,10,13,23,0.217,0.283,0.5,17.543,34,riffle_perfect
0,23,23,1,47,0.489,24,0.511,3,0,1.0,1,5,32,15,14,15,18,0.298,0.319,0.383,17.552,35,riffle_perfect
0,20,21,4,45,0.444,24,0.533,3,1,0.75,2,1,28,17,10,14,21,0.222,0.311,0.467,17.548,36,riffle_perfect
0,19,24,2,45,0.422,21,0.467,1,2,0.333,4,3,32,13,7,15,23,0.156,0.333,0.511,17.546,37,riffle_perfect
0,24,20,0,44,0.545,24,0.545,2,2,0.5,4,1,26,18,13,16,15,0.295,0.364,0.341,17.556,38,riffle_perfect
0,15,22,7,44,0.341,22,0.5,3,1,0.75,0,1,24,20,8,19,17,0.182,0.432,0.386,17.568,39,riffle_perfect
0,19,27,3,49,0.388,22,0.449,2,4,0.333,2,3,33,16,7,13,29,0.143,0.265,0.592,17.557,40,riffle_perfect
0,20,23,3,46,0.435,23,0.5,1,2,0.333,4,2,35,11,9,10,27,0.196,0.217,0.587,17.582,41,riffle_perfect
0,16,23,5,44,0.364,21,0.477,2,0,1.0,4,2,29,15,7,15,22,0.159,0.341,0.5,17.577,42,riffle_perfect
0,17,26,3,46,0.37,20,0.435,2,4,0.333,1,2,26,20,14,16,16,0.304,0.348,0.348,17.579,43,riffle_perfect
0,18,27,1,46,0.391,19,0.413,2,8,0.2,1,3,26,20,10,18,18,0.217,0.391,0.391,17.603,44,riffle_perfect
0,24,15,8,47,0.511,32,0.681,4,3,0.571,2,2,29,18,17,6,24,0.362,0.128,0.511,17.609,45,riffle_perfect
0,19,19,5,43,0.442,24,0.558,5,3,0.625,2,1,28,15,10,15,18,0.233,0.349,0.419,17.612,46,riffle_perfect
0,17,22,6,45,0.378,23,0.511,2,2,0.5,3,1,28,17,7,17,21,0.156,0.378,0.467,17.609,47,riffle_perfect
0,19,20,5,44,0.432,24,0.545,2,2,0.5,1,2,31,13,10,17,17,0.227,0.386,0.386,17.615,48,riffle_perfect
0,21,21,2,44,0.477,23,0.523,3,1,0.75,4,2,31,13,11,12,21,0.25,0.273,0.477,17.597,49,riffle_perfect
0,20,21,4,45,0.444,24,0.533,7,5,0.583,3,2,30,15,12,12,21,0.267,0.267,0.467,17.602,50,riffle_perfect
0,24,21,4,49,0.49,28,0.571,3,1,0.75,2,4,31,18,10,14,25,0.204,0.286,0.51,17.596,51,riffle_perfect
0,18,26,2,46,0.391,20,0.435,3,3,0.5,3,2,30,16,9,12,25,0.196,0.261,0.543,17.607,52,riffle_perfect
0,17,21,4,42,0.405,21,0.5,4,3,0.571,2,0,25,17,13,12,17,0.31,0.286,0.405,17.609,53,riffle_perfect
0,23,20,4,47,0.489,27,0.574,6,2,0.75,3,2,28,19,13,15,19,0.277,0.319,0.404,17.599,54,riffle_perfect
0,22,19,3,44,0.5,25,0.568,2,2,0.5,2,1,23,21,11,15,18,0.25,0.341,0.409,17.586,55,riffle_perfect
0,22,17,4,43,0.512,26,0.605,6,1,0.857,4,2,30,13,12,10,21,0.279,0.233,0.488,17.581,56,riffle_perfect
0,16,25,6,47,0.34,22,0.468,2,2,0.5,1,1,33,14,9,13,25,0.191,0.277,0.532,17.579,57,riffle_perfect
0,24,20,2,46,0.522,26,0.565,3,1,0.75,4,2,23,23,16,11,19,0.348,0.239,0.413,17.561,58,riffle_perfect
0,17,24,7,48,0.354,24,0.5,4,4,0.5,3,1,26,22,5,21,22,0.104,0.438,0.458,17.568,59,riffle_perfect
0,19,24,3,46,0.413,22,0.478,1,3,0.25,1,1,21,25,13,18,15,0.283,0.391,0.326,17.575,60,riffle_perfect
0,25,22,1,48,0.521,26,0.542,2,1,0.667,1,2,29,19,13,19,16,0.271,0.396,0.333,17.581,61,riffle_perfect
0,20,19,7,46,0.435,27,0.587,2,2,0.5,2,1,27,19,9,17,20,0.196,0.37,0.435,17.592,62,riffle_perfect
0,24,18,3,45,0.533,27,0.6,1,0,1.0,4,0,22,23,10,15,20,0.222,0.333,0.444,17.577,63,riffle_perfect
0,15,27,6,48,0.312,21,0.438,1,2,0.333,3,4,30,18,6,18,24,0.125,0.375,0.5,17.583,64,riffle_perfect
0,19,22,5,46,0.413,24,0.522,4,4,0.5,3,2,31,15,10,11,25,0.217,0.239,0.543,17.586,65,riffle_perfect
0,15,26,6,47,0.319,21,0.447,1,1,0.5,3,2,32,15,2,20,25,0.043,0.426,0.532,17.58,66,riffle_perfect
0,24,21,2,47,0.511,26,0.553,3,2,0.6,0,2,29,18,16,9,22,0.34,0.191,0.468,17.577,67,riffle_perfect
0,19,21,4,44,0.432,23,0.523,4,2,0.667,0,3,28,16,14,15,15,0.318,0.341,0.341,17.58,68,riffle_perfect
0,19,23,2,44,0.432,21,0.477,2,1,0.667,1,2,28,16,13,9,22,0.295,0.205,0.5,17.586,69,riffle_perfect
0,22,22,1,45,0.489,23,0.511,4,2,0.667,2,2,27,18,13,13,19,0.289,0.289,0.422,17.583,70,riffle_perfect
0,26,18,5,49,0.531,31,0.633,3,0,1.0,2,1,27,22,13,17,19,0.265,0.347,0.388,17.585,71,riffle_perfect
0,24,12,7,43,0.558,31,0.721,1,1,0.5,2,1,30,13,13,11,19,0.302,0.256,0.442,17.586,72,riffle_perfect
0,16,24,4,44,0.364,20,0.455,3,7,0.3,1,3,24,20,10,19,15,0.227,0.432,0.341,17.59,73,riffle_perfect
0,20,21,3,44,0.455,23,0.523,6,1,0.857,2,1,23,21,10,15,19,0.227,0.341,0.432,17.592,74,riffle_perfect
0,19,21,5,45,0.422,24,0.533,4,1,0.8,3,2,25,20,9,17,19,0.2,0.378,0.422,17.595,75,riffle_perfect
0,20,19,7,46,0.435,27,0.587,1,1,0.5,2,0,32,14,8,15,23,0.174,0.326,0.5,17.6,76,riffle_perfect
0,24,21,0,45,0.533,24,0.533,6,1,0.857,3,4,31,14,10,8,27,0.222,0.178,0.6,17.607,77,riffle_perfect
0,17,22,4,43,0.395,21,0.488,2,4,0.333,0,1,29,14,10,11,22,0.233,0.256,0.512,17.6,78,riffle_perfect
0,18,22,4,44,0.409,22,0.5,4,1,0.8,2,0,23,21,7,21,16,0.159,0.477,0.364,17.604,79,riffle_perfect
0,19,24,4,47,0.404,23,0.489,3,4,0.429,0,6,32,15,11,16,20,0.234,0.34,0.426,17.611,80,riffle_perfect
0,13,26,6,45,0.289,19,0.422,2,3,0.4,2,2,28,17,5,16,24,0.111,0.356,0.533,17.602,81,riffle_perfect
0,20,20,5,45,0.444,25,0.556,1,2,0.333,4,0,32,13,6,18,21,0.133,0.4,0.467,17.61,82,riffle_perfect
0,25,22,4,51,0.49,29,0.569,5,4,0.556,2,1,24,27,11,20,20,0.216,0.392,0.392,17.618,83,riffle_perfect
0,18,24,5,47,0.383,23,0.489,5,1,0.833,1,1,29,18,9,18,20,0.191,0.383,0.426,17.624,84,riffle_perfect
0,20,24,2,46,0.435,22,0.478,4,0,1.0,1,4,28,18,11,10,25,0.239,0.217,0.543,17.624,85,riffle_perfect
0,13,30,4,47,0.277,17,0.362,4,7,0.364,1,4,24,23,4,23,20,0.085,0.489,0.426,17.634,86,riffle_perfect
0,22,20,5,47,0.468,27,0.574,0,2,0.0,2,1,28,19,12,17,18,0.255,0.362,0.383,17.646,87,riffle_perfect
0,15,26,4,45,0.333,19,0.422,1,2,0.333,1,4,24,21,11,16,18,0.244,0.356,0.4,17.647,88,riffle_perfect
0,16,23,6,45,0.356,22,0.489,3,2,0.6,1,6,29,16,9,16,20,0.2,0.356,0.444,17.647,89,riffle_perfect
0,20,21,3,44,0.455,23,0.523,5,3,0.625,3,3,29,15,8,14,22,0.182,0.318,0.5,17.65,90,riffle_perfect
0,20,23,2,45,0.444,22,0.489,4,5,0.444,3,3,25,20,11,11,23,0.244,0.244,0.511,17.648,91,riffle_perfect
0,20,26,3,49,0.408,23,0.469,3,1,0.75,3,3,34,15,8,16,25,0.163,0.327,0.51,17.648,92,riffle_perfect
0,20,19,7,46,0.435,27,0.587,2,2,0.5,4,1,29,17,9,14,23,0.196,0.304,0.5,17.654,93,riffle_perfect
0,22,22,1,45,0.489,23,0.511,3,1,0.75,1,2,30,15,15,11,19,0.333,0.244,0.422,17.657,94,riffle_perfect
0,23,18,3,44,0.523,26,0.591,7,2,0.778,1,2,26,18,13,16,15,0.295,0.364,0.341,17.664,95,riffle_perfect
0,16,20,10,46,0.348,26,0.565,3,3,0.5,2,2,28,18,11,19,16,0.239,0.413,0.348,17.668,96,riffle_perfect
0,17,25,4,46,0.37,21,0.457,2,1,0.667,4,2,30,16,9,11,26,0.196,0.239,0.565,17.156,1,riffle_perfect
0,19,23,3,45,0.422,22,0.489,6,2,0.75,2,4,33,12,12,9,24,0.267,0.2,0.533,17.22,2,riffle_perfect
0,21,22,2,45,0.467,23,0.511,5,0,1.0,3,2,28,17,12,13,20,0.267,0.289,0.444,17.279,3,riffle_perfect
0,23,18,5,46,0.5,28,0.609,5,2,0.714,2,3,22,24,14,16,16,0.304,0.348,0.348,17.505,4,riffle_perfect
0,19,24,3,46,0.413,22,0.478,5,3,0.625,2,1,32,14,11,7,28,0.239,0.152,0.609,17.458,5,riffle_perfect
0,19,26,3,48,0.396,22,0.458,5,0,1.0,5,3,27,21,10,10,28,0.208,0.208,0.583,17.162,6,riffle_perfect
0,20,20,6,46,0.435,26,0.565,3,1,0.75,2,2,23,23,10,19,17,0.217,0.413,0.37,17.195,7,riffle_perfect
0,17,21,7,45,0.378,24,0.533,2,1,0.667,2,2,22,23,12,15,18,0.267,0.333,0.4,17.328,8,riffle_perfect
0,20,19,7,46,0.435,27,0.587,4,1,0.8,1,0,28,18,10,19,17,0.217,0.413,0.37,17.412,9,riffle_perfect
0,19,20,7,46,0.413,26,0.565,2,4,0.333,0,3,29,17,11,17,18,0.239,0.37,0.391,17.549,10,riffle_perfect
0,22,20,4,46,0.478,26,0.565,5,2,0.714,4,2,21,25,15,17,14,0.326,0.37,0.304,17.559,11,riffle_perfect
0,26,17,3,46,0.565,29,0.63,4,3,0.571,6,1,27,19,10,13,23,0.217,0.283,0.5,17.49,12,riffle_perfect
0,14,23,8,45,0.311,22,0.489,2,1,0.667,1,3,31,14,7,15,23,0.156,0.333,0.511,17.565,13,riffle_perfect
0,24,15,5,44,0.545,29,0.659,2,1,0.667,4,1,27,17,11,17,16,0.25,0.386,0.364,17.542,14,riffle_perfect
0,29,15,3,47,0.617,32,0.681,6,4,0.6,1,1,27,20,14,20,13,0.298,0.426,0.277,17.586,15,riffle_perfect
0,17,19,5,41,0.415,22,0.537,1,2,0.333,0,2,26,15,16,11,14,0.39,0.268,0.341,17.595,16,riffle_perfect
0,23,17,5,45,0.511,28,0.622,8,2,0.8,0,1,23,22,16,20,9,0.356,0.444,0.2,17.611,17,riffle_perfect
0,21,18,4,43,0.488,25,0.581,4,2,0.667,2,1,25,18,14,12,17,0.326,0.279,0.395,17.649,18,riffle_perfect
0,17,25,5,47,0.362,22,0.468,1,0,1.0,0,2,29,18,9,19,19,0.191,0.404,0.404,17.65,19,riffle_perfect
0,16,26,4,46,0.348,20,0.435,2,1,0.667,0,4,31,15,9,15,22,0.196,0.326,0.478,17.637,20,riffle_perfect
0,18,23,4,45,0.4,22,0.489,3,1,0.75,0,1,27,18,12,13,20,0.267,0.289,0.444,17.644,21,riffle_perfect
0,18,25,2,45,0.4,20,0.444,1,0,1.0,2,4,30,15,7,15,23,0.156,0.333,0.511,17.603,22,riffle_perfect
0,19,25,1,45,0.422,20,0.444,5,1,0.833,4,2,28,17,8,14,23,0.178,0.311,0.511,17.589,23,riffle_perfect
0,13,29,2,44,0.295,15,0.341,1,1,0.5,2,1,24,20,6,18,20,0.136,0.409,0.455,17.603,24,riffle_perfect
0,18,25,2,45,0.4,20,0.444,2,4,0.333,3,1,29,16,6,14,25,0.133,0.311,0.556,17.572,25,riffle_perfect
0,22,25,3,50,0.44,25,0.5,4,1,0.8,4,4,25,25,11,18,21,0.22,0.36,0.42,17.58,26,riffle_perfect
0,18,18,7,43,0.419,25,0.581,4,2,0.667,0,0,22,21,12,16,15,0.279,0.372,0.349,17.617,27,riffle_perfect
0,21,19,3,43,0.488,24,0.558,3,3,0.5,1,1,28,15,14,14,15,0.326,0.326,0.349,17.606,28,riffle_perfect
0,24,16,4,44,0.545,28,0.636,4,0,1.0,6,2,29,15,14,13,17,0.318,0.295,0.386,17.593,29,riffle_perfect
0,17,21,5,43,0.395,22,0.512,3,2,0.6,0,2,23,20,13,12,18,0.302,0.279,0.419,17.603,30,riffle_perfect
0,25,19,0,44,0.568,25,0.568,4,2,0.667,4,2,34,10,8,13,23,0.182,0.295,0.523,17.62,31,riffle_perfect
0,20,24,3,47,0.426,23,0.489,4,1,0.8,4,1,29,18,9,15,23,0.191,0.319,0.489,17.632,32,riffle_perfect
0,18,23,4,45,0.4,22,0.489,3,2,0.6,1,3,27,18,7,19,19,0.156,0.422,0.422,17.649,33,riffle_perfect
0,21,23,0,44,0.477,21,0.477,4,6,0.4,3,2,22,22,10,16,18,0.227,0.364,0.409,17.657,34,riffle_perfect
0,19,26,2,47,0.404,21,0.447,2,2,0.5,1,2,27,20,8,22,17,0.17,0.468,0.362,17.658,35,riffle_perfect
0,24,18,4,46,0.522,28,0.609,6,2,0.75,4,2,28,18,15,9,22,0.326,0.196,0.478,17.646,36,riffle_perfect
0,19,20,6,45,0.422,25,0.556,2,2,0.5,4,1,25,20,9,16,20,0.2,0.356,0.444,17.623,37,riffle_perfect
0,16,26,5,47,0.34,21,0.447,2,1,0.667,2,5,24,23,8,18,21,0.17,0.383,0.447,17.63,38,riffle_perfect
0,18,23,4,45,0.4,22,0.489,2,1,0.667,0,3,25,20,14,11,20,0.311,0.244,0.444,17.616,39,riffle_perfect
0,18,18,8,44,0.409,26,0.591,2,3,0.4,0,3,31,13,8,12,24,0.182,0.273,0.545,17.632,40,riffle_perfect
0,20,18,6,44,0.455,26,0.591,2,1,0.667,4,3,30,14,11,9,24,0.25,0.205,0.545,17.618,41,riffle_perfect
0,19,22,4,45,0.422,23,0.511,3,2,0.6,2,5,30,15,10,11,24,0.222,0.244,0.533,17.618,42,riffle_perfect
0,21,19,5,45,0.467,26,0.578,3,2,0.6,1,2,27,18,13,18,14,0.289,0.4,0.311,17.628,43,riffle_perfect
0,18,24,4,46,0.391,22,0.478,5,3,0.625,3,4,26,20,8,19,19,0.174,0.413,0.413,17.643,44,riffle_perfect
0,24,20,2,46,0.522,26,0.565,2,2,0.5,1,2,30,16,10,15,21,0.217,0.326,0.457,17.649,45,riffle_perfect
0,21,26,1,48,0.438,22,0.458,3,6,0.333,2,2,30,18,11,16,21,0.229,0.333,0.438,17.639,46,riffle_perfect
0,20,23,5,48,0.417,25,0.521,0,3,0.0,2,2,31,17,12,17,19,0.25,0.354,0.396,17.647,47,riffle_perfect
0,20,21,4,45,0.444,24,0.533,4,1,0.8,0,2,32,13,9,14,22,0.2,0.311,0.489,17.656,48,riffle_perfect
0,19,20,6,45,0.422,25,0.556,2,2,0.5,0,2,29,16,13,13,19,0.289,0.289,0.422,17.652,49,riffle_perfect
0,12,26,8,46,0.261,20,0.435,3,4,0.429,1,3,29,17,5,17,24,0.109,0.37,0.522,17.665,50,riffle_perfect
0,27,20,1,48,0.562,28,0.583,6,3,0.667,3,0,24,24,19,16,13,0.396,0.333,0.271,17.661,51,riffle_perfect
0,18,24,2,44,0.409,20,0.455,1,1,0.5,2,3,31,13,9,12,23,0.205,0.273,0.523,17.668,52,riffle_perfect
0,16,22,6,44,0.364,22,0.5,1,1,0.5,3,3,31,13,7,10,27,0.159,0.227,0.614,17.671,53,riffle_perfect
0,19,20,6,45,0.422,25,0.556,4,1,0.8,2,3,27,18,12,16,17,0.267,0.356,0.378,17.678,54,riffle_perfect
0,22,20,3,45,0.489,25,0.556,2,0,1.0,3,2,26,19,11,14,20,0.244,0.311,0.444,17.674,55,riffle_perfect
0,20,28,1,49,0.408,21,0.429,0,1,0.0,3,3,26,23,16,16,17,0.327,0.327,0.347,17.66,56,riffle_perfect
0,20,20,6,46,0.435,26,0.565,4,2,0.667,1,5,24,22,12,15,19,0.261,0.326,0.413,17.67,57,riffle_perfect
0,19,22,3,44,0.432,22,0.5,8,0,1.0,1,4,28,16,9,14,21,0.205,0.318,0.477,17.676,58,riffle_perfect
0,15,28,1,44,0.341,16,0.364,2,3,0.4,3,3,24,20,8,13,23,0.182,0.295,0.523,17.681,59,riffle_perfect
0,24,14,5,43,0.558,29,0.674,4,0,1.0,2,1,23,20,14,12,17,0.326,0.279,0.395,17.678,60,riffle_perfect
0,25,14,4,43,0.581,29,0.674,4,3,0.571,2,0,23,20,15,14,14,0.349,0.326,0.326,17.676,61,riffle_perfect
0,19,19,6,44,0.432,25,0.568,3,3,0.5,2,2,24,20,11,16,17,0.25,0.364,0.386,17.681,62,riffle_perfect
0,25,17,4,46,0.543,29,0.63,3,1,0.75,2,0,26,20,14,13,19,0.304,0.283,0.413,17.675,63,riffle_perfect
0,19,25,3,47,0.404,22,0.468,2,1,0.667,4,4,30,17,12,10,25,0.255,0.213,0.532,17.669,64,riffle_perfect
0,19,21,6,46,0.413,25,0.543,3,3,0.5,2,0,28,18,10,18,18,0.217,0.391,0.391,17.672,65,riffle_perfect
0,19,19,6,44,0.432,25,0.568,2,2,0.5,3,0,27,17,11,15,18,0.25,0.341,0.409,17.668,66,riffle_perfect
0,21,21,3,45,0.467,24,0.533,2,1,0.667,4,0,24,21,12,15,18,0.267,0.333,0.4,17.656,67,riffle_perfect
0,20,23,3,46,0.435,23,0.5,2,2,0.5,3,2,30,16,10,13,23,0.217,0.283,0.5,17.644,68,riffle_perfect
0,22,21,4,47,0.468,26,0.553,2,0,1.0,3,0,27,20,10,16,21,0.213,0.34,0.447,17.63,69,riffle_perfect
0,21,24,2,47,0.447,23,0.489,4,3,0.571,6,1,29,18,8,16,23,0.17,0.34,0.489,17.624,70,riffle_perfect
0,26,19,3,48,0.542,29,0.604,4,2,0.667,3,3,30,18,12,16,20,0.25,0.333,0.417,17.626,71,riffle_perfect
0,21,20,2,43,0.488,23,0.535,3,0,1.0,0,3,25,18,16,12,15,0.372,0.279,0.349,17.62,72,riffle_perfect
0,22,19,5,46,0.478,27,0.587,4,1,0.8,5,3,20,26,9,19,18,0.196,0.413,0.391,17.624,73,riffle_perfect
0,16,24,6,46,0.348,22,0.478,0,2,0.0,2,0,23,23,9,19,18,0.196,0.413,0.391,17.625,74,riffle_perfect
0,25,16,4,45,0.556,29,0.644,2,2,0.5,7,3,27,18,10,10,25,0.222,0.222,0.556,17.615,75,riffle_perfect
0,20,25,4,49,0.408,24,0.49,2,5,0.286,2,4,28,21,10,20,19,0.204,0.408,0.388,17.615,76,riffle_perfect
0,16,29,1,46,0.348,17,0.37,0,6,0.0,1,1,22,24,10,16,20,0.217,0.348,0.435,17.616,77,riffle_perfect
0,22,22,2,46,0.478,24,0.522,2,2,0.5,2,2,30,16,10,16,20,0.217,0.348,0.435,17.618,78,riffle_perfect
0,22,23,4,49,0.449,26,0.531,4,1,0.8,2,3,31,18,12,13,24,0.245,0.265,0.49,17.622,79,riffle_perfect
0,21,22,3,46,0.457,24,0.522,3,3,0.5,3,0,24,22,9,17,20,0.196,0.37,0.435,17.611,80,riffle_perfect
0,25,17,3,45,0.556,28,0.622,2,2,0.5,5,1,28,17,13,12,20,0.289,0.267,0.444,17.612,81,riffle_perfect
0,16,25,5,46,0.348,21,0.457,2,4,0.333,0,1,35,11,5,17,24,0.109,0.37,0.522,17.619,82,riffle_perfect
0,16,25,4,45,0.356,20,0.444,2,2,0.5,1,4,28,17,8,16,21,0.178,0.356,0.467,17.624,83,riffle_perfect
0,18,21,5,44,0.409,23,0.523,6,2,0.75,2,0,24,20,13,15,16,0.295,0.341,0.364,17.619,84,riffle_perfect
0,26,15,4,45,0.578,30,0.667,2,1,0.667,2,2,25,20,18,12,15,0.4,0.267,0.333,17.621,85,riffle_perfect
0,23,20,3,46,0.5,26,0.565,4,1,0.8,2,3,27,19,12,11,23,0.261,0.239,0.5,17.623,86,riffle_perfect
0,16,25,4,45,0.356,20,0.444,4,4,0.5,0,2,20,25,15,16,14,0.333,0.356,0.311,17.622,87,riffle_perfect
0,23,17,5,45,0.511,28,0.622,4,4,0.5,1,2,24,21,12,17,16,0.267,0.378,0.356,17.627,88,riffle_perfect
0,20,24,4,48,0.417,24,0.5,4,3,0.571,5,4,31,17,8,11,29,0.167,0.229,0.604,17.62,89,riffle_perfect
0,21,21,3,45,0.467,24,0.533,2,4,0.333,5,1,33,12,6,11,28,0.133,0.244,0.622,17.615,90,riffle_perfect
0,18,23,4,45,0.4,22,0.489,1,1,0.5,5,1,25,20,5,14,26,0.111,0.311,0.578,17.611,91,riffle_perfect
0,20,24,3,47,0.426,23,0.489,2,1,0.667,3,5,31,16,14,9,24,0.298,0.191,0.511,17.604,92,riffle_perfect
0,22,22,2,46,0.478,24,0.522,1,3,0.25,2,2,26,20,12,14,20,0.261,0.304,0.435,17.607,93,riffle_perfect
0,19,23,4,46,0.413,23,0.5,4,2,0.667,4,1,27,19,7,15,24,0.152,0.326,0.522,17.611,94,riffle_perfect
0,23,23,2,48,0.479,25,0.521,3,1,0.75,1,4,28,20,9,17,22,0.188,0.354,0.458,17.615,95,riffle_perfect
0,18,25,4,47,0.383,22,0.468,5,6,0.455,1,1,33,14,8,14,25,0.17,0.298,0.532,17.62,96,riffle_perfect
0,21,19,6,46,0.457,27,0.587,2,3,0.4,4,1,27,19,10,19,17,0.217,0.413,0.37,17.704,1,riffle_perfect
0,18,20,7,45,0.4,25,0.556,2,1,0.667,2,2,32,13,12,13,20,0.267,0.289,0.444,18.321,2,riffle_perfect
0,16,26,4,46,0.348,20,0.435,2,3,0.4,2,2,22,24,11,19,16,0.239,0.413,0.348,18.372,3,riffle_perfect
0,25,17,2,44,0.568,27,0.614,5,1,0.833,2,2,18,26,17,11,16,0.386,0.25,0.364,18.193,4,riffle_perfect
0,15,27,5,47,0.319,20,0.426,3,7,0.3,1,1,23,24,9,21,17,0.191,0.447,0.362,18.21,5,riffle_perfect
0,16,25,3,44,0.364,19,0.432,0,2,0.0,2,3,29,15,8,13,23,0.182,0.295,0.523,18.097,6,riffle_perfect
0,15,23,6,44,0.341,21,0.477,1,4,0.2,2,3,27,17,8,19,17,0.182,0.432,0.386,18.107,7,riffle_perfect
0,21,20,5,46,0.457,26,0.565,5,3,0.625,2,1,33,13,8,15,23,0.174,0.326,0.5,18.093,8,riffle_perfect
0,23,20,2,45,0.511,25,0.556,5,1,0.833,1,1,34,11,17,7,21,0.378,0.156,0.467,18.02,9,riffle_perfect
0,21,18,5,44,0.477,26,0.591,6,3,0.667,4,1,29,15,11,13,20,0.25,0.295,0.455,17.986,10,riffle_perfect
0,27,14,4,45,0.6,31,0.689,7,1,0.875,2,3,23,22,13,12,20,0.289,0.267,0.444,17.952,11,riffle_perfect
0,16,25,4,45,0.356,20,0.444,4,2,0.667,0,1,25,20,11,17,17,0.244,0.378,0.378,18.047,12,riffle_perfect
0,18,21,4,43,0.419,22,0.512,3,2,0.6,1,3,29,14,9,13,21,0.209,0.302,0.488,18.022,13,riffle_perfect
0,24,18,3,45,0.533,27,0.6,2,3,0.4,3,1,31,14,10,15,20,0.222,0.333,0.444,17.98,14,riffle_perfect
0,22,21,2,45,0.489,24,0.533,2,2,0.5,3,2,29,16,15,10,20,0.333,0.222,0.444,17.913,15,riffle_perfect
0,20,21,5,46,0.435,25,0.543,0,3,0.0,1,2,29,17,14,10,22,0.304,0.217,0.478,17.927,16,riffle_perfect
0,23,23,3,49,0.469,26,0.531,1,3,0.25,3,2,32,17,13,11,25,0.265,0.224,0.51,17.814,17,riffle_perfect
0,19,24,3,46,0.413,22,0.478,5,2,0.714,1,5,22,24,9,19,18,0.196,0.413,0.391,17.789,18,riffle_perfect
0,18,20,8,46,0.391,26,0.565,4,1,0.8,2,4,33,13,8,12,26,0.174,0.261,0.565,17.737,19,riffle_perfect
0,22,19,4,45,0.489,26,0.578,5,1,0.833,1,5,32,13,8,11,26,0.178,0.244,0.578,17.733,20,riffle_perfect
0,25,17,3,45,0.556,28,0.622,2,2,0.5,2,0,31,14,15,11,19,0.333,0.244,0.422,17.738,21,riffle_perfect
0,22,21,2,45,0.489,24,0.533,3,0,1.0,3,0,24,21,15,13,17,0.333,0.289,0.378,17.721,22,riffle_perfect
0,22,23,6,51,0.431,28,0.549,4,1,0.8,3,2,23,28,16,16,19,0.314,0.314,0.373,17.728,23,riffle_perfect
0,17,25,2,44,0.386,19,0.432,2,1,0.667,1,2,29,15,10,13,21,0.227,0.295,0.477,17.725,24,riffle_perfect
0,26,16,2,44,0.591,28,0.636,5,0,1.0,1,0,21,23,16,13,15,0.364,0.295,0.341,17.728,25,riffle_perfect
0,19,21,5,45,0.422,24,0.533,0,1,0.0,2,1,24,21,13,16,16,0.289,0.356,0.356,17.751,26,riffle_perfect
0,22,20,4,46,0.478,26,0.565,3,1,0.75,2,1,25,21,13,18,15,0.283,0.391,0.326,17.771,27,riffle_perfect
0,18,19,6,43,0.419,24,0.558,2,0,1.0,2,3,28,15,10,14,19,0.233,0.326,0.442,17.775,28,riffle_perfect
0,17,26,2,45,0.378,19,0.422,1,3,0.25,1,2,29,16,8,12,25,0.178,0.267,0.556,17.782,29,riffle_perfect
0,20,20,4,44,0.455,24,0.545,8,2,0.8,1,3,27,17,12,15,17,0.273,0.341,0.386,17.781,30,riffle_perfect
0,24,22,1,47,0.511,25,0.532,5,2,0.714,4,3,31,16,12,13,22,0.255,0.277,0.468,17.762,31,riffle_perfect
0,15,26,6,47,0.319,21,0.447,5,4,0.556,2,4,26,21,7,17,23,0.149,0.362,0.489,17.79,32,riffle_perfect
0,18,23,4,45,0.4,22,0.489,4,2,0.667,0,3,21,24,12,19,14,0.267,0.422,0.311,17.785,33,riffle_perfect
0,19,27,1,47,0.404,20,0.426,5,2,0.714,2,3,34,13,8,14,25,0.17,0.298,0.532,17.79,34,riffle_perfect
0,18,24,6,48,0.375,24,0.5,2,1,0.667,2,4,24,24,11,17,20,0.229,0.354,0.417,17.788,35,riffle_perfect
0,13,28,6,47,0.277,19,0.404,1,7,0.125,1,2,26,21,5,20,22,0.106,0.426,0.468,17.798,36,riffle_perfect
0,24,20,4,48,0.5,28,0.583,3,1,0.75,5,3,31,17,10,18,20,0.208,0.375,0.417,17.773,37,riffle_perfect
0,25,18,5,48,0.521,30,0.625,3,3,0.5,1,1,23,25,15,12,21,0.312,0.25,0.438,17.783,38,riffle_perfect
0,20,22,3,45,0.444,23,0.511,4,0,1.0,4,4,23,22,14,13,18,0.311,0.289,0.4,17.771,39,riffle_perfect
0,19,23,3,45,0.422,22,0.489,6,0,1.0,2,4,35,10,7,11,27,0.156,0.244,0.6,17.768,40,riffle_perfect
0,18,22,5,45,0.4,23,0.511,1,2,0.333,0,2,31,14,11,13,21,0.244,0.289,0.467,17.766,41,riffle_perfect
0,19,20,6,45,0.422,25,0.556,3,3,0.5,2,2,33,12,8,12,25,0.178,0.267,0.556,17.752,42,riffle_perfect
0,19,21,4,44,0.432,23,0.523,1,2,0.333,3,4,26,18,8,16,20,0.182,0.364,0.455,17.749,43,riffle_perfect
0,21,21,2,44,0.477,23,0.523,5,1,0.833,3,5,31,13,9,15,20,0.205,0.341,0.455,17.743,44,riffle_perfect
0,18,21,4,43,0.419,22,0.512,3,2,0.6,3,2,24,19,9,15,19,0.209,0.349,0.442,17.735,45,riffle_perfect
0,18,25,3,46,0.391,21,0.457,3,2,0.6,2,2,31,15,8,14,24,0.174,0.304,0.522,17.739,46,riffle_perfect
0,22,20,3,45,0.489,25,0.556,4,3,0.571,0,1,27,18,12,12,21,0.267,0.267,0.467,17.747,47,riffle_perfect
0,24,19,3,46,0.522,27,0.587,8,3,0.727,0,0,33,13,15,9,22,0.326,0.196,0.478,17.763,48,riffle_perfect
0,23,21,2,46,0.5,25,0.543,4,2,0.667,2,2,29,17,10,15,21,0.217,0.326,0.457,17.764,49,riffle_perfect
0,18,23,4,45,0.4,22,0.489,1,1,0.5,1,2,30,15,11,15,19,0.244,0.333,0.422,17.762,50,riffle_perfect
0,20,24,1,45,0.444,21,0.467,8,1,0.889,1,4,26,19,15,13,17,0.333,0.289,0.378,17.764,51,riffle_perfect
0,25,20,3,48,0.521,28,0.583,1,2,0.333,3,0,26,22,11,17,20,0.229,0.354,0.417,17.762,52,riffle_perfect
0,24,19,1,44,0.545,25,0.568,7,4,0.636,4,1,25,19,11,11,22,0.25,0.25,0.5,17.768,53,riffle_perfect
0,25,16,6,47,0.532,31,0.66,6,0,1.0,2,3,32,15,10,12,25,0.213,0.255,0.532,17.768,54,riffle_perfect
0,18,18,7,43,0.419,25,0.581,0,1,0.0,2,2,31,12,10,12,21,0.233,0.279,0.488,17.77,55,riffle_perfect
0,12,26,6,44,0.273,18,0.409,5,5,0.5,2,3,33,11,9,14,21,0.205,0.318,0.477,17.781,56,riffle_perfect
0,18,23,4,45,0.4,22,0.489,1,0,1.0,4,2,31,14,8,14,23,0.178,0.311,0.511,17.781,57,riffle_perfect
0,17,20,7,44,0.386,24,0.545,2,3,0.4,2,1,25,19,10,14,20,0.227,0.318,0.455,17.776,58,riffle_perfect
0,26,16,3,45,0.578,29,0.644,3,4,0.429,6,2,29,16,11,10,24,0.244,0.222,0.533,17.743,59,riffle_perfect
0,25,20,3,48,0.521,28,0.583,1,0,1.0,2,3,32,16,15,13,20,0.312,0.271,0.417,17.75,60,riffle_perfect
0,16,26,4,46,0.348,20,0.435,3,4,0.429,4,4,28,18,6,15,25,0.13,0.326,0.543,17.749,61,riffle_perfect
0,22,16,5,43,0.512,27,0.628,2,1,0.667,2,1,28,15,10,14,19,0.233,0.326,0.442,17.744,62,riffle_perfect
0,25,16,6,47,0.532,31,0.66,7,2,0.778,1,1,26,21,17,8,22,0.362,0.17,0.468,17.733,63,riffle_perfect
0,21,20,6,47,0.447,27,0.574,3,3,0.5,3,2,29,18,14,16,17,0.298,0.34,0.362,17.734,64,riffle_perfect
0,18,19,7,44,0.409,25,0.568,2,0,1.0,2,0,28,16,9,14,21,0.205,0.318,0.477,17.739,65,riffle_perfect
0,15,23,8,46,0.326,23,0.5,2,3,0.4,2,4,30,16,7,15,24,0.152,0.326,0.522,17.74,66,riffle_perfect
0,15,26,5,46,0.326,20,0.435,2,3,0.4,2,3,29,17,9,16,21,0.196,0.348,0.457,17.738,67,riffle_perfect
0,18,21,6,45,0.4,24,0.533,1,5,0.167,0,1,28,17,12,15,18,0.267,0.333,0.4,17.745,68,riffle_perfect
0,17,22,5,44,0.386,22,0.5,4,3,0.571,1,4,33,11,8,14,22,0.182,0.318,0.5,17.745,69,riffle_perfect
0,16,22,5,43,0.372,21,0.488,7,3,0.7,1,2,26,17,10,12,21,0.233,0.279,0.488,17.75,70,riffle_perfect
0,25,18,6,49,0.51,31,0.633,1,1,0.5,4,1,29,20,13,12,24,0.265,0.245,0.49,17.75,71,riffle_perfect
0,25,14,7,46,0.543,32,0.696,5,1,0.833,3,2,27,19,15,13,18,0.326,0.283,0.391,17.742,72,riffle_perfect
0,24,18,4,46,0.522,28,0.609,5,3,0.625,1,0,27,19,16,9,21,0.348,0.196,0.457,17.743,73,riffle_perfect
0,16,25,4,45,0.356,20,0.444,2,0,1.0,2,2,32,13,6,17,22,0.133,0.378,0.489,17.733,74,riffle_perfect
0,20,27,1,48,0.417,21,0.438,6,3,0.667,2,3,26,22,10,19,19,0.208,0.396,0.396,17.731,75,riffle_perfect
0,24,22,2,48,0.5,26,0.542,4,1,0.8,2,1,24,24,13,18,17,0.271,0.375,0.354,17.723,76,riffle_perfect
0,20,22,3,45,0.444,23,0.511,1,2,0.333,0,2,27,18,12,13,20,0.267,0.289,0.444,17.729,77,riffle_perfect
0,23,20,1,44,0.523,24,0.545,3,2,0.6,3,3,24,20,18,7,19,0.409,0.159,0.432,17.725,78,riffle_perfect
0,16,22,6,44,0.364,22,0.5,1,0,1.0,0,3,24,20,11,14,19,0.25,0.318,0.432,17.736,79,riffle_perfect
0,24,16,4,44,0.545,28,0.636,2,2,0.5,2,1,34,10,12,10,22,0.273,0.227,0.5,17.731,80,riffle_perfect
0,20,19,5,44,0.455,25,0.568,3,2,0.6,4,0,24,20,8,17,19,0.182,0.386,0.432,17.721,81,riffle_perfect
0,26,17,4,47,0.553,30,0.638,5,4,0.556,4,3,30,17,13,19,15,0.277,0.404,0.319,17.715,82,riffle_perfect
0,16,21,5,42,0.381,21,0.5,1,2,0.333,1,2,26,16,10,13,19,0.238,0.31,0.452,17.719,83,riffle_perfect
0,23,16,7,46,0.5,30,0.652,0,1,0.0,2,3,35,11,14,12,20,0.304,0.261,0.435,17.723,84,riffle_perfect
0,16,26,3,45,0.356,19,0.422,1,3,0.25,3,2,30,15,9,11,25,0.2,0.244,0.556,17.718,85,riffle_perfect
0,22,19,6,47,0.468,28,0.596,3,1,0.75,2,3,33,14,9,18,20,0.191,0.383,0.426,17.713,86,riffle_perfect
0,23,20,1,44,0.523,24,0.545,1,1,0.5,2,4,30,14,14,10,20,0.318,0.227,0.455,17.711,87,riffle_perfect
0,24,19,3,46,0.522,27,0.587,8,2,0.8,2,1,22,24,16,11,19,0.348,0.239,0.413,17.702,88,riffle_perfect
0,21,27,4,52,0.404,25,0.481,4,4,0.5,1,5,27,25,13,19,20,0.25,0.365,0.385,17.7,89,riffle_perfect
0,23,22,0,45,0.511,23,0.511,1,6,0.143,1,2,24,21,14,15,16,0.311,0.333,0.356,17.706,90,riffle_perfect
0,20,20,5,45,0.444,25,0.556,3,1,0.75,3,2,28,17,9,15,21,0.2,0.333,0.467,17.708,91,riffle_perfect
0,16,24,4,44,0.364,20,0.455,3,0,1.0,2,3,29,15,9,12,23,0.205,0.273,0.523,17.702,92,riffle_perfect
0,23,22,2,47,0.489,25,0.532,2,4,0.333,3,1,25,22,12,15,20,0.255,0.319,0.426,17.701,93,riffle_perfect
0,21,20,5,46,0.457,26,0.565,2,4,0.333,4,1,35,11,8,13,25,0.174,0.283,0.543,17.698,94,riffle_perfect
0,20,22,5,47,0.426,25,0.532,2,2,0.5,3,2,31,16,14,13,20,0.298,0.277,0.426,17.694,95,riffle_perfect
0,15,25,5,45,0.333,20,0.444,2,3,0.4,3,2,24,21,8,18,19,0.178,0.4,0.422,17.696,96,riffle_perfect
0,18,24,2,44,0.409,20,0.455,0,3,0.0,0,4,26,18,16,9,19,0.364,0.205,0.432,18.182,1,riffle_perfect
0,19,18,7,44,0.432,26,0.591,4,1,0.8,1,2,31,13,13,11,20,0.295,0.25,0.455,18.22,2,riffle_perfect
0,23,19,3,45,0.511,26,0.578,2,3,0.4,5,1,25,20,10,15,20,0.222,0.333,0.444,17.709,3,riffle_perfect
0,19,24,1,44,0.432,20,0.455,5,3,0.625,1,3,28,16,11,13,20,0.25,0.295,0.455,17.843,4,riffle_perfect
0,16,29,3,48,0.333,19,0.396,2,1,0.667,2,1,27,21,8,19,21,0.167,0.396,0.438,17.863,5,riffle_perfect
0,19,21,5,45,0.422,24,0.533,4,2,0.667,0,2,25,20,13,15,17,0.289,0.333,0.378,17.863,6,riffle_perfect
0,25,16,2,43,0.581,27,0.628,4,2,0.667,2,2,24,19,13,16,14,0.302,0.372,0.326,17.828,7,riffle_perfect
0,18,24,3,45,0.4,21,0.467,0,2,0.0,1,1,28,17,11,16,18,0.244,0.356,0.4,17.85,8,riffle_perfect
0,24,21,1,46,0.522,25,0.543,6,2,0.75,1,2,21,25,18,11,17,0.391,0.239,0.37,17.845,9,riffle_perfect
0,26,17,3,46,0.565,29,0.63,5,2,0.714,3,4,24,22,15,13,18,0.326,0.283,0.391,17.799,10,riffle_perfect
0,20,21,4,45,0.444,24,0.533,7,0,1.0,1,1,22,23,10,20,15,0.222,0.444,0.333,17.84,11,riffle_perfect
0,28,16,4,48,0.583,32,0.667,6,2,0.75,4,1,28,20,20,9,19,0.417,0.188,0.396,17.846,12,riffle_perfect
0,19,20,4,43,0.442,23,0.535,3,1,0.75,0,1,23,20,8,21,14,0.186,0.488,0.326,17.909,13,riffle_perfect
0,21,19,4,44,0.477,25,0.568,2,2,0.5,2,0,22,22,14,15,15,0.318,0.341,0.341,17.92,14,riffle_perfect
0,13,31,2,46,0.283,15,0.326,3,4,0.429,3,1,29,17,6,12,28,0.13,0.261,0.609,17.891,15,riffle_perfect
0,21,21,3,45,0.467,24,0.533,2,0,1.0,3,1,27,18,13,13,19,0.289,0.289,0.422,17.839,16,riffle_perfect
0,18,19,5,42,0.429,23,0.548,2,1,0.667,2,0,26,16,12,15,15,0.286,0.357,0.357,17.842,17,riffle_perfect
0,18,20,9,47,0.383,27,0.574,2,3,0.4,4,0,20,27,9,23,15,0.191,0.489,0.319,17.862,18,riffle_perfect
0,18,24,4,46,0.391,22,0.478,4,2,0.667,4,3,28,18,9,11,26,0.196,0.239,0.565,17.855,19,riffle_perfect
0,22,16,7,45,0.489,29,0.644,2,0,1.0,0,1,28,17,10,18,17,0.222,0.4,0.378,17.895,20,riffle_perfect
0,22,21,2,45,0.489,24,0.533,3,0,1.0,3,1,23,22,11,18,16,0.244,0.4,0.356,17.868,21,riffle_perfect
0,18,29,0,47,0.383,18,0.383,1,4,0.2,4,4,26,21,6,19,22,0.128,0.404,0.468,17.864,22,riffle_perfect
0,23,22,3,48,0.479,26,0.542,7,1,0.875,6,1,31,17,7,14,27,0.146,0.292,0.562,17.855,23,riffle_perfect
0,17,24,6,47,0.362,23,0.489,3,3,0.5,4,2,29,18,8,14,25,0.17,0.298,0.532,17.833,24,riffle_perfect
0,19,18,7,44,0.432,26,0.591,2,2,0.5,1,0,24,20,10,16,18,0.227,0.364,0.409,17.844,25,riffle_perfect
0,20,27,3,50,0.4,23,0.46,4,3,0.571,4,1,23,27,9,20,21,0.18,0.4,0.42,17.823,26,riffle_perfect
0,19,21,7,47,0.404,26,0.553,1,1,0.5,2,4,30,17,12,16,19,0.255,0.34,0.404,17.827,27,riffle_perfect
0,20,23,3,46,0.435,23,0.5,1,3,0.25,4,1,19,27,10,16,20,0.217,0.348,0.435,17.778,28,riffle_perfect
0,25,16,3,44,0.568,28,0.636,3,2,0.6,5,0,26,18,8,19,17,0.182,0.432,0.386,17.777,29,riffle_perfect
0,14,27,4,45,0.311,18,0.4,1,4,0.2,1,3,25,20,6,20,19,0.133,0.444,0.422,17.797,30,riffle_perfect
0,21,21,3,45,0.467,24,0.533,3,0,1.0,0,2,28,17,15,12,18,0.333,0.267,0.4,17.793,31,riffle_perfect
0,23,21,3,47,0.489,26,0.553,5,5,0.5,2,1,29,18,13,13,21,0.277,0.277,0.447,17.774,32,riffle_perfect
0,19,25,3,47,0.404,22,0.468,4,3,0.571,2,2,29,18,8,17,22,0.17,0.362,0.468,17.784,33,riffle_perfect
0,18,22,4,44,0.409,22,0.5,3,3,0.5,4,1,23,21,7,20,17,0.159,0.455,0.386,17.78,34,riffle_perfect
0,24,19,2,45,0.533,26,0.578,1,1,0.5,1,3,34,11,11,10,24,0.244,0.222,0.533,17.785,35,riffle_perfect
0,18,28,3,49,0.367,21,0.429,9,4,0.692,1,6,35,14,13,8,28,0.265,0.163,0.571,17.78,36,riffle_perfect
0,22,20,4,46,0.478,26,0.565,4,0,1.0,1,0,28,18,13,20,13,0.283,0.435,0.283,17.788,37,riffle_perfect
0,22,17,6,45,0.489,28,0.622,4,2,0.667,2,3,25,20,13,14,18,0.289,0.311,0.4,17.8,38,riffle_perfect
0,13,24,5,42,0.31,18,0.429,1,4,0.2,1,0,22,20,9,18,15,0.214,0.429,0.357,17.82,39,riffle_perfect
0,18,27,2,47,0.383,20,0.426,7,1,0.875,1,4,27,20,7,21,19,0.149,0.447,0.404,17.818,40,riffle_perfect
0,19,24,2,45,0.422,21,0.467,2,0,1.0,0,3,32,13,10,10,25,0.222,0.222,0.556,17.824,41,riffle_perfect
0,30,12,4,46,0.652,34,0.739,7,0,1.0,4,2,25,21,14,14,18,0.304,0.304,0.391,17.803,42,riffle_perfect
0,23,14,8,45,0.511,31,0.689,4,0,1.0,1,3,30,15,8,18,19,0.178,0.4,0.422,17.82,43,riffle_perfect
0,16,24,5,45,0.356,21,0.467,3,3,0.5,2,2,30,15,8,15,22,0.178,0.333,0.489,17.81,44,riffle_perfect
0,26,19,2,47,0.553,28,0.596,4,1,0.8,3,2,22,25,13,17,17,0.277,0.362,0.362,17.815,45,riffle_perfect
0,19,16,9,44,0.432,28,0.636,6,1,0.857,2,2,30,14,7,15,22,0.159,0.341,0.5,17.829,46,riffle_perfect
0,18,26,3,47,0.383,21,0.447,4,4,0.5,2,2,26,21,10,17,20,0.213,0.362,0.426,17.832,47,riffle_perfect
0,17,22,5,44,0.386,22,0.5,5,4,0.556,4,1,25,19,10,20,14,0.227,0.455,0.318,17.841,48,riffle_perfect
0,24,17,4,45,0.533,28,0.622,7,3,0.7,0,2,24,21,17,12,16,0.378,0.267,0.356,17.837,49,riffle_perfect
0,20,20,5,45,0.444,25,0.556,2,4,0.333,3,4,26,19,10,17,18,0.222,0.378,0.4,17.838,50,riffle_perfect
0,22,15,7,44,0.5,29,0.659,6,2,0.75,1,1,27,17,9,16,19,0.205,0.364,0.432,17.848,51,riffle_perfect
0,24,22,2,48,0.5,26,0.542,3,3,0.5,4,3,32,16,8,13,27,0.167,0.271,0.562,17.85,52,riffle_perfect
0,18,25,4,47,0.383,22,0.468,2,3,0.4,0,3,27,20,11,13,23,0.234,0.277,0.489,17.844,53,riffle_perfect
0,18,24,4,46,0.391,22,0.478,2,4,0.333,1,0,28,18,11,18,17,0.239,0.391,0.37,17.848,54,riffle_perfect
0,22,22,2,46,0.478,24,0.522,4,2,0.667,2,1,32,14,12,13,21,0.261,0.283,0.457,17.839,55,riffle_perfect
0,18,23,2,43,0.419,20,0.465,2,1,0.667,2,3,27,16,9,15,19,0.209,0.349,0.442,17.831,56,riffle_perfect
0,13,27,4,44,0.295,17,0.386,1,0,1.0,2,2,32,12,5,13,26,0.114,0.295,0.591,17.819,57,riffle_perfect
0,21,23,2,46,0.457,23,0.5,2,2,0.5,3,1,28,18,10,14,22,0.217,0.304,0.478,17.803,58,riffle_perfect
0,20,21,4,45,0.444,24,0.533,4,0,1.0,2,4,24,21,12,15,18,0.267,0.333,0.4,17.797,59,riffle_perfect
0,19,24,5,48,0.396,24,0.5,2,4,0.333,2,3,28,20,8,20,20,0.167,0.417,0.417,17.795,60,riffle_perfect
0,14,26,5,45,0.311,19,0.422,2,3,0.4,2,6,32,13,8,10,27,0.178,0.222,0.6,17.802,61,riffle_perfect
0,20,25,4,49,0.408,24,0.49,2,4,0.333,1,4,25,24,12,16,21,0.245,0.327,0.429,17.802,62,riffle_perfect
0,17,26,6,49,0.347,23,0.469,1,1,0.5,2,3,29,20,11,16,22,0.224,0.327,0.449,17.799,63,riffle_perfect
0,21,21,1,43,0.488,22,0.512,5,2,0.714,5,1,25,18,10,13,20,0.233,0.302,0.465,17.789,64,riffle_perfect
0,21,19,4,44,0.477,25,0.568,3,3,0.5,1,1,23,21,12,16,16,0.273,0.364,0.364,17.785,65,riffle_perfect
0,21,22,4,47,0.447,25,0.532,3,2,0.6,2,1,32,15,9,13,25,0.191,0.277,0.532,17.782,66,riffle_perfect
0,22,17,6,45,0.489,28,0.622,1,0,1.0,4,2,25,20,13,13,19,0.289,0.289,0.422,17.77,67,riffle_perfect
0,26,20,1,47,0.553,27,0.574,10,3,0.769,1,1,24,23,13,15,19,0.277,0.319,0.404,17.77,68,riffle_perfect
0,22,20,4,46,0.478,26,0.565,6,3,0.667,2,1,28,18,11,15,20,0.239,0.326,0.435,17.759,69,riffle_perfect
0,22,16,7,45,0.489,29,0.644,2,2,0.5,2,2,28,17,11,14,20,0.244,0.311,0.444,17.754,70,riffle_perfect
0,22,22,2,46,0.478,24,0.522,6,4,0.6,2,6,25,21,14,15,17,0.304,0.326,0.37,17.762,71,riffle_perfect
0,25,20,2,47,0.532,27,0.574,1,3,0.25,2,1,28,19,11,12,24,0.234,0.255,0.511,17.759,72,riffle_perfect
0,20,24,4,48,0.417,24,0.5,8,6,0.571,0,2,28,20,13,10,25,0.271,0.208,0.521,17.757,73,riffle_perfect
0,15,24,4,43,0.349,19,0.442,3,3,0.5,1,2,31,12,9,10,24,0.209,0.233,0.558,17.756,74,riffle_perfect
0,18,22,5,45,0.4,23,0.511,1,4,0.2,2,2,29,16,9,15,21,0.2,0.333,0.467,17.761,75,riffle_perfect
0,24,19,2,45,0.533,26,0.578,3,2,0.6,1,2,25,20,15,15,15,0.333,0.333,0.333,17.758,76,riffle_perfect
0,23,23,1,47,0.489,24,0.511,7,2,0.778,2,4,34,13,15,6,26,0.319,0.128,0.553,17.763,77,riffle_perfect
0,20,25,2,47,0.426,22,0.468,3,2,0.6,5,3,33,14,10,11,26,0.213,0.234,0.553,17.742,78,riffle_perfect
0,15,27,5,47,0.319,20,0.426,1,3,0.25,2,2,24,23,5,20,22,0.106,0.426,0.468,17.745,79,riffle_perfect
0,22,19,4,45,0.489,26,0.578,6,1,0.857,3,2,27,18,11,12,22,0.244,0.267,0.489,17.748,80,riffle_perfect
0,25,18,5,48,0.521,30,0.625,3,1,0.75,2,0,28,20,15,12,21,0.312,0.25,0.438,17.747,81,riffle_perfect
0,22,23,1,46,0.478,23,0.5,3,5,0.375,1,1,25,21,14,13,19,0.304,0.283,0.413,17.743,82,riffle_perfect
0,19,21,5,45,0.422,24,0.533,2,4,0.333,1,4,30,15,11,12,22,0.244,0.267,0.489,17.737,83,riffle_perfect
0,13,28,2,43,0.302,15,0.349,3,0,1.0,2,2,26,17,7,15,21,0.163,0.349,0.488,17.742,84,riffle_perfect
0,15,28,4,47,0.319,19,0.404,1,2,0.333,3,4,30,17,10,12,25,0.213,0.255,0.532,17.742,85,riffle_perfect
0,22,22,2,46,0.478,24,0.522,4,1,0.8,1,0,28,18,9,15,22,0.196,0.326,0.478,17.74,86,riffle_perfect
0,15,25,3,43,0.349,18,0.419,1,4,0.2,1,1,29,14,4,11,28,0.093,0.256,0.651,17.74,87,riffle_perfect
0,20,23,4,47,0.426,24,0.511,3,2,0.6,2,5,28,19,16,10,21,0.34,0.213,0.447,17.741,88,riffle_perfect
0,18,21,5,44,0.409,23,0.523,4,2,0.667,3,3,23,21,10,19,15,0.227,0.432,0.341,17.741,89,riffle_perfect
0,24,22,2,48,0.5,26,0.542,0,1,0.0,3,1,28,20,14,18,16,0.292,0.375,0.333,17.736,90,riffle_perfect
0,24,20,2,46,0.522,26,0.565,5,0,1.0,1,4,30,16,13,10,23,0.283,0.217,0.5,17.738,91,riffle_perfect
0,22,20,4,46,0.478,26,0.565,0,4,0.0,2,4,26,20,11,16,19,0.239,0.348,0.413,17.741,92,riffle_perfect
0,23,19,5,47,0.489,28,0.596,4,3,0.571,4,4,29,18,12,13,22,0.255,0.277,0.468,17.737,93,riffle_perfect
0,22,18,3,43,0.512,25,0.581,3,1,0.75,2,2,32,11,13,14,16,0.302,0.326,0.372,17.735,94,riffle_perfect
0,13,26,7,46,0.283,20,0.435,1,4,0.2,1,2,33,13,8,12,26,0.174,0.261,0.565,17.743,95,riffle_perfect
0,22,20,4,46,0.478,26,0.565,4,0,1.0,3,3,27,19,12,13,21,0.261,0.283,0.457,17.738,96,riffle_perfect
0,17,25,3,45,0.378,20,0.444,2,3,0.4,1,1,29,16,6,19,20,0.133,0.422,0.444,17.485,1,riffle_perfect
0,16,27,3,46,0.348,19,0.413,1,1,0.5,5,0,21,25,9,22,15,0.196,0.478,0.326,17.905,2,riffle_perfect
0,23,19,2,44,0.523,25,0.568,3,4,0.429,3,3,26,18,14,11,19,0.318,0.25,0.432,17.862,3,riffle_perfect
0,16,26,4,46,0.348,20,0.435,3,1,0.75,2,2,31,15,12,10,24,0.261,0.217,0.522,17.877,4,riffle_perfect
0,20,22,2,44,0.455,22,0.5,3,0,1.0,2,2,27,17,10,12,22,0.227,0.273,0.5,17.894,5,riffle_perfect
0,22,18,5,45,0.489,27,0.6,3,1,0.75,2,2,23,22,13,16,16,0.289,0.356,0.356,17.881,6,riffle_perfect
0,18,21,5,44,0.409,23,0.523,4,2,0.667,3,1,24,20,8,16,20,0.182,0.364,0.455,17.79,7,riffle_perfect
0,22,21,2,45,0.489,24,0.533,5,3,0.625,2,1,23,22,17,11,17,0.378,0.244,0.378,17.74,8,riffle_perfect
0,20,19,5,44,0.455,25,0.568,4,3,0.571,1,1,28,16,8,12,24,0.182,0.273,0.545,17.791,9,riffle_perfect
0,24,19,4,47,0.511,28,0.596,4,2,0.667,3,2,31,16,6,16,25,0.128,0.34,0.532,17.772,10,riffle_perfect
0,18,26,3,47,0.383,21,0.447,1,1,0.5,1,7,26,21,12,15,20,0.255,0.319,0.426,17.709,11,riffle_perfect
0,17,22,6,45,0.378,23,0.511,0,1,0.0,4,1,32,13,9,15,21,0.2,0.333,0.467,17.715,12,riffle_perfect
0,15,25,5,45,0.333,20,0.444,1,5,0.167,4,2,30,15,7,16,22,0.156,0.356,0.489,17.743,13,riffle_perfect
0,22,18,5,45,0.489,27,0.6,3,0,1.0,2,2,28,17,12,14,19,0.267,0.311,0.422,17.749,14,riffle_perfect
0,17,24,5,46,0.37,22,0.478,0,5,0.0,2,0,26,20,12,15,19,0.261,0.326,0.413,17.713,15,riffle_perfect
0,21,23,4,48,0.438,25,0.521,6,5,0.545,3,6,35,13,14,12,22,0.292,0.25,0.458,17.734,16,riffle_perfect
0,20,23,2,45,0.444,22,0.489,1,2,0.333,3,2,28,17,10,13,22,0.222,0.289,0.489,17.703,17,riffle_perfect
0,14,25,6,45,0.311,20,0.444,3,5,0.375,2,1,31,14,7,19,19,0.156,0.422,0.422,17.715,18,riffle_perfect
0,20,18,7,45,0.444,27,0.6,2,0,1.0,1,0,23,22,11,18,16,0.244,0.4,0.356,17.726,19,riffle_perfect
0,24,22,0,46,0.522,24,0.522,4,1,0.8,3,1,22,24,14,14,18,0.304,0.304,0.391,17.682,20,riffle_perfect
0,22,22,1,45,0.489,23,0.511,5,2,0.714,0,2,27,18,10,16,19,0.222,0.356,0.422,17.703,21,riffle_perfect
0,20,22,5,47,0.426,25,0.532,3,1,0.75,1,4,28,19,9,21,17,0.191,0.447,0.362,17.724,22,riffle_perfect
0,16,21,6,43,0.372,22,0.512,1,2,0.333,1,1,28,15,6,16,21,0.14,0.372,0.488,17.707,23,riffle_perfect
0,23,20,2,45,0.511,25,0.556,1,1,0.5,3,2,26,19,14,14,17,0.311,0.311,0.378,17.728,24,riffle_perfect
0,17,21,7,45,0.378,24,0.533,4,2,0.667,1,1,27,18,9,15,21,0.2,0.333,0.467,17.759,25,riffle_perfect
0,20,17,6,43,0.465,26,0.605,4,2,0.667,3,2,23,20,9,17,17,0.209,0.395,0.395,17.774,26,riffle_perfect
0,16,22,5,43,0.372,21,0.488,2,2,0.5,0,4,32,11,9,14,20,0.209,0.326,0.465,17.737,27,riffle_perfect
0,15,27,3,45,0.333,18,0.4,2,2,0.5,2,3,28,17,9,14,22,0.2,0.311,0.489,17.709,28,riffle_perfect
0,26,14,6,46,0.565,32,0.696,5,1,0.833,7,2,25,21,13,13,20,0.283,0.283,0.435,17.697,29,riffle_perfect
0,17,22,4,43,0.395,21,0.488,5,4,0.556,1,1,26,17,13,11,19,0.302,0.256,0.442,17.717,30,riffle_perfect
0,23,19,3,45,0.511,26,0.578,3,2,0.6,3,1,32,13,9,13,23,0.2,0.289,0.511,17.723,31,riffle_perfect
0,22,22,3,47,0.468,25,0.532,5,4,0.556,2,2,29,18,13,11,23,0.277,0.234,0.489,17.739,32,riffle_perfect
0,19,25,3,47,0.404,22,0.468,2,3,0.4,2,2,23,24,12,14,21,0.255,0.298,0.447,17.749,33,riffle_perfect
0,14,24,6,44,0.318,20,0.455,3,1,0.75,3,1,24,20,10,14,20,0.227,0.318,0.455,17.725,34,riffle_perfect
0,22,21,2,45,0.489,24,0.533,1,2,0.333,1,5,25,20,13,13,19,0.289,0.289,0.422,17.718,35,riffle_perfect
0,19,25,1,45,0.422,20,0.444,4,1,0.8,1,6,27,18,13,13,19,0.289,0.289,0.422,17.707,36,riffle_perfect
0,22,17,5,44,0.5,27,0.614,4,3,0.571,1,3,23,21,14,12,18,0.318,0.273,0.409,17.723,37,riffle_perfect
0,15,23,6,44,0.341,21,0.477,1,1,0.5,3,3,29,15,9,13,22,0.205,0.295,0.5,17.726,38,riffle_perfect
0,10,29,5,44,0.227,15,0.341,1,3,0.25,0,3,29,15,7,16,21,0.159,0.364,0.477,17.731,39,riffle_perfect
0,17,21,9,47,0.362,26,0.553,1,3,0.25,1,2,32,15,10,15,22,0.213,0.319,0.468,17.718,40,riffle_perfect
0,17,24,7,48,0.354,24,0.5,5,4,0.556,2,2,35,13,6,15,27,0.125,0.312,0.562,17.71,41,riffle_perfect
0,20,18,5,43,0.465,25,0.581,4,2,0.667,0,1,23,20,15,14,14,0.349,0.326,0.326,17.717,42,riffle_perfect
0,17,23,5,45,0.378,22,0.489,3,2,0.6,3,3,28,17,7,14,24,0.156,0.311,0.533,17.725,43,riffle_perfect
0,18,23,4,45,0.4,22,0.489,2,1,0.667,4,4,29,16,10,12,23,0.222,0.267,0.511,17.694,44,riffle_perfect
0,18,22,7,47,0.383,25,0.532,1,3,0.25,2,4,29,18,12,12,23,0.255,0.255,0.489,17.699,45,riffle_perfect
0,27,14,4,45,0.6,31,0.689,3,4,0.429,2,1,26,19,16,13,16,0.356,0.289,0.356,17.706,46,riffle_perfect
0,22,22,3,47,0.468,25,0.532,3,1,0.75,5,3,28,19,11,14,22,0.234,0.298,0.468,17.693,47,riffle_perfect
0,19,21,2,42,0.452,21,0.5,7,1,0.875,1,0,25,17,11,10,21,0.262,0.238,0.5,17.705,48,riffle_perfect
0,16,23,9,48,0.333,25,0.521,3,0,1.0,1,0,27,21,8,19,21,0.167,0.396,0.438,17.708,49,riffle_perfect
0,20,23,3,46,0.435,23,0.5,3,3,0.5,2,2,24,22,6,21,19,0.13,0.457,0.413,17.72,50,riffle_perfect
0,28,13,3,44,0.636,31,0.705,3,0,1.0,4,2,24,20,9,17,18,0.205,0.386,0.409,17.712,51,riffle_perfect
0,20,22,4,46,0.435,24,0.522,4,3,0.571,3,0,26,20,12,13,21,0.261,0.283,0.457,17.727,52,riffle_perfect
0,17,26,2,45,0.378,19,0.422,2,3,0.4,0,4,22,23,13,17,15,0.289,0.378,0.333,17.744,53,riffle_perfect
0,13,24,8,45,0.289,21,0.467,1,2,0.333,2,5,27,18,9,18,18,0.2,0.4,0.4,17.749,54,riffle_perfect
0,23,17,5,45,0.511,28,0.622,3,3,0.5,5,0,28,17,15,9,21,0.333,0.2,0.467,17.732,55,riffle_perfect
0,21,20,4,45,0.467,25,0.556,1,2,0.333,2,3,26,19,11,20,14,0.244,0.444,0.311,17.73,56,riffle_perfect
0,20,22,3,45,0.444,23,0.511,3,2,0.6,2,3,27,18,13,11,21,0.289,0.244,0.467,17.728,57,riffle_perfect
0,19,22,3,44,0.432,22,0.5,3,1,0.75,3,2,30,14,10,8,26,0.227,0.182,0.591,17.724,58,riffle_perfect
0,23,19,4,46,0.5,27,0.587,3,3,0.5,3,3,25,21,12,20,14,0.261,0.435,0.304,17.728,59,riffle_perfect
0,20,23,1,44,0.455,21,0.477,2,1,0.667,2,2,28,16,13,12,19,0.295,0.273,0.432,17.733,60,riffle_perfect
0,21,20,7,48,0.438,28,0.583,4,1,0.8,0,1,28,20,12,18,18,0.25,0.375,0.375,17.736,61,riffle_perfect
0,23,21,3,47,0.489,26,0.553,2,3,0.4,5,1,31,16,9,12,26,0.191,0.255,0.553,17.728,62,riffle_perfect
0,23,20,7,50,0.46,30,0.6,2,3,0.4,3,2,32,18,14,12,24,0.28,0.24,0.48,17.714,63,riffle_perfect
0,21,19,5,45,0.467,26,0.578,3,1,0.75,3,2,22,23,10,15,20,0.222,0.333,0.444,17.715,64,riffle_perfect
0,21,17,7,45,0.467,28,0.622,1,1,0.5,2,3,26,19,14,13,18,0.311,0.289,0.4,17.714,65,riffle_perfect
0,21,18,6,45,0.467,27,0.6,1,4,0.2,5,3,25,20,12,15,18,0.267,0.333,0.4,17.707,66,riffle_perfect
0,20,21,4,45,0.444,24,0.533,3,1,0.75,3,3,30,15,11,11,23,0.244,0.244,0.511,17.714,67,riffle_perfect
0,18,25,4,47,0.383,22,0.468,5,2,0.714,4,4,31,16,9,12,26,0.191,0.255,0.553,17.707,68,riffle_perfect
0,17,23,4,44,0.386,21,0.477,3,2,0.6,5,2,27,17,7,16,21,0.159,0.364,0.477,17.7,69,riffle_perfect
0,22,19,5,46,0.478,27,0.587,5,2,0.714,2,1,25,21,13,16,17,0.283,0.348,0.37,17.705,70,riffle_perfect
0,14,25,7,46,0.304,21,0.457,0,4,0.0,2,3,30,16,6,14,26,0.13,0.304,0.565,17.713,71,riffle_perfect
0,23,23,1,47,0.489,24,0.511,4,3,0.571,4,3,30,17,11,14,22,0.234,0.298,0.468,17.709,72,riffle_perfect
0,20,29,1,50,0.4,21,0.42,1,4,0.2,3,2,32,18,10,14,26,0.2,0.28,0.52,17.704,73,riffle_perfect
0,22,19,5,46,0.478,27,0.587,6,3,0.667,2,2,27,19,13,14,19,0.283,0.304,0.413,17.713,74,riffle_perfect
0,16,22,7,45,0.356,23,0.511,6,1,0.857,1,1,29,16,8,13,24,0.178,0.289,0.533,17.715,75,riffle_perfect
0,20,21,6,47,0.426,26,0.553,1,2,0.333,4,1,22,25,4,19,24,0.085,0.404,0.511,17.704,76,riffle_perfect
0,17,21,7,45,0.378,24,0.533,1,0,1.0,3,3,31,14,8,13,24,0.178,0.289,0.533,17.695,77,riffle_perfect
0,15,25,2,42,0.357,17,0.405,3,2,0.6,0,2,27,15,10,16,16,0.238,0.381,0.381,17.7,78,riffle_perfect
0,17,23,6,46,0.37,23,0.5,4,3,0.571,3,2,28,18,5,19,22,0.109,0.413,0.478,17.708,79,riffle_perfect
0,23,21,0,44,0.523,23,0.523,4,3,0.571,3,1,29,15,14,14,16,0.318,0.318,0.364,17.7,80,riffle_perfect
0,17,28,2,47,0.362,19,0.404,3,4,0.429,3,2,28,19,8,14,25,0.17,0.298,0.532,17.698,81,riffle_perfect
0,19,26,3,48,0.396,22,0.458,2,1,0.667,0,2,35,13,7,15,26,0.146,0.312,0.542,17.705,82,riffle_perfect
0,19,21,4,44,0.432,23,0.523,5,1,0.833,0,4,28,16,12,13,19,0.273,0.295,0.432,17.706,83,riffle_perfect
0,21,20,4,45,0.467,25,0.556,3,2,0.6,0,2,28,17,7,21,17,0.156,0.467,0.378,17.713,84,riffle_perfect
0,22,22,1,45,0.489,23,0.511,3,1,0.75,3,3,27,18,11,14,20,0.244,0.311,0.444,17.709,85,riffle_perfect
0,18,24,4,46,0.391,22,0.478,1,4,0.2,3,3,24,22,9,22,15,0.196,0.478,0.326,17.711,86,riffle_perfect
0,20,25,1,46,0.435,21,0.457,4,4,0.5,0,2,28,18,9,10,27,0.196,0.217,0.587,17.714,87,riffle_perfect
0,20,23,2,45,0.444,22,0.489,2,6,0.25,1,4,24,21,13,15,17,0.289,0.333,0.378,17.708,88,riffle_perfect
0,14,29,4,47,0.298,18,0.383,4,1,0.8,1,5,31,16,7,14,26,0.149,0.298,0.553,17.709,89,riffle_perfect
0,20,27,1,48,0.417,21,0.438,1,0,1.0,6,2,28,20,6,15,27,0.125,0.312,0.562,17.699,90,riffle_perfect
0,18,24,2,44,0.409,20,0.455,3,2,0.6,1,2,27,17,9,15,20,0.205,0.341,0.455,17.702,91,riffle_perfect
0,20,22,4,46,0.435,24,0.522,1,1,0.5,4,0,25,21,11,17,18,0.239,0.37,0.391,17.696,92,riffle_perfect
0,22,20,5,47,0.468,27,0.574,1,3,0.25,3,1,27,20,8,20,19,0.17,0.426,0.404,17.696,93,riffle_perfect
0,16,26,3,45,0.356,19,0.422,2,2,0.5,3,2,32,13,8,13,24,0.178,0.289,0.533,17.691,94,riffle_perfect
0,25,20,2,47,0.532,27,0.574,1,1,0.5,2,2,26,21,11,17,19,0.234,0.362,0.404,17.682,95,riffle_perfect
0,23,20,3,46,0.5,26,0.565,6,2,0.75,4,2,26,20,12,14,20,0.261,0.304,0.435,17.683,96,riffle_perfect
0,25,22,0,47,0.532,25,0.532,4,4,0.5,3,2,29,18,16,8,23,0.34,0.17,0.489,17.115,1,riffle_perfect
0,25,15,4,44,0.568,29,0.659,2,0,1.0,4,1,27,17,15,10,19,0.341,0.227,0.432,17.038,2,riffle_perfect
0,20,20,4,44,0.455,24,0.545,2,1,0.667,3,0,24,20,10,14,20,0.227,0.318,0.455,16.817,3,riffle_perfect
0,23,18,3,44,0.523,26,0.591,3,1,0.75,3,1,29,15,12,18,14,0.273,0.409,0.318,17.168,4,riffle_perfect
0,26,14,3,43,0.605,29,0.674,4,0,1.0,2,4,26,17,18,11,14,0.419,0.256,0.326,17.24,5,riffle_perfect
0,22,20,6,48,0.458,28,0.583,1,0,1.0,3,4,31,17,15,8,25,0.312,0.167,0.521,17.397,6,riffle_perfect
0,16,25,2,43,0.372,18,0.419,7,1,0.875,0,1,22,21,7,16,20,0.163,0.372,0.465,17.59,7,riffle_perfect
0,21,17,5,43,0.488,26,0.605,1,2,0.333,3,2,28,15,11,16,16,0.256,0.372,0.372,17.533,8,riffle_perfect
0,22,17,4,43,0.512,26,0.605,4,0,1.0,1,2,26,17,10,15,18,0.233,0.349,0.419,17.571,9,riffle_perfect
0,25,18,2,45,0.556,27,0.6,4,2,0.667,1,2,21,24,16,18,11,0.356,0.4,0.244,17.628,10,riffle_perfect
0,26,18,2,46,0.565,28,0.609,4,1,0.8,2,4,25,21,12,13,21,0.261,0.283,0.457,17.587,11,riffle_perfect
0,11,32,3,46,0.239,14,0.304,2,5,0.286,2,3,32,14,7,15,24,0.152,0.326,0.522,17.597,12,riffle_perfect
0,16,24,4,44,0.364,20,0.455,3,2,0.6,0,1,26,18,7,17,20,0.159,0.386,0.455,17.651,13,riffle_perfect
0,18,29,1,48,0.375,19,0.396,3,5,0.375,2,0,22,26,7,20,21,0.146,0.417,0.438,17.61,14,riffle_perfect
0,18,23,5,46,0.391,23,0.5,0,1,0.0,1,2,30,16,8,17,21,0.174,0.37,0.457,17.658,15,riffle_perfect
0,22,20,3,45,0.489,25,0.556,3,0,1.0,0,3,27,18,12,14,19,0.267,0.311,0.422,17.671,16,riffle_perfect
0,22,23,1,46,0.478,23,0.5,2,3,0.4,4,1,25,21,9,16,21,0.196,0.348,0.457,17.632,17,riffle_perfect
0,14,25,6,45,0.311,20,0.444,2,3,0.4,2,0,28,17,8,17,20,0.178,0.378,0.444,17.66,18,riffle_perfect
0,19,25,3,47,0.404,22,0.468,2,0,1.0,2,5,27,20,13,11,23,0.277,0.234,0.489,17.644,19,riffle_perfect
0,16,22,8,46,0.348,24,0.522,2,3,0.4,5,5,29,17,4,19,23,0.087,0.413,0.5,17.66,20,riffle_perfect
0,18,23,4,45,0.4,22,0.489,0,0,0,1,4,33,12,14,10,21,0.311,0.222,0.467,17.642,21,riffle_perfect
0,26,11,3,40,0.65,29,0.725,3,0,1.0,1,1,24,16,18,10,12,0.45,0.25,0.3,17.661,22,riffle_perfect
0,22,21,3,46,0.478,25,0.543,4,3,0.571,4,2,20,26,15,11,20,0.326,0.239,0.435,17.624,23,riffle_perfect
0,19,22,5,46,0.413,24,0.522,1,0,1.0,3,4,32,14,5,18,23,0.109,0.391,0.5,17.626,24,riffle_perfect
0,14,23,5,42,0.333,19,0.452,1,2,0.333,0,0,25,17,10,16,16,0.238,0.381,0.381,17.639,25,riffle_perfect
0,20,20,6,46,0.435,26,0.565,0,0,0,3,1,28,18,7,18,21,0.152,0.391,0.457,17.61,26,riffle_perfect
0,26,18,1,45,0.578,27,0.6,3,1,0.75,2,1,25,20,11,14,20,0.244,0.311,0.444,17.596,27,riffle_perfect
0,16,25,2,43,0.372,18,0.419,5,1,0.833,3,1,31,12,5,15,23,0.116,0.349,0.535,17.59,28,riffle_perfect
0,20,23,3,46,0.435,23,0.5,2,0,1.0,5,2,28,18,12,13,21,0.261,0.283,0.457,17.582,29,riffle_perfect
0,22,17,4,43,0.512,26,0.605,6,0,1.0,2,1,24,19,9,17,17,0.209,0.395,0.395,17.576,30,riffle_perfect
0,21,19,5,45,0.467,26,0.578,2,4,0.333,3,1,28,17,12,11,22,0.267,0.244,0.489,17.539,31,riffle_perfect
0,20,24,2,46,0.435,22,0.478,2,1,0.667,2,1,27,19,12,17,17,0.261,0.37,0.37,17.56,32,riffle_perfect
0,24,20,2,46,0.522,26,0.565,6,2,0.75,2,1,29,17,13,13,20,0.283,0.283,0.435,17.571,33,riffle_perfect
0,22,17,5,44,0.5,27,0.614,2,4,0.333,1,2,26,18,13,11,20,0.295,0.25,0.455,17.571,34,riffle_perfect
0,16,26,3,45,0.356,19,0.422,3,2,0.6,1,1,30,15,5,18,22,0.111,0.4,0.489,17.586,35,riffle_perfect
0,17,19,8,44,0.386,25,0.568,2,4,0.333,0,2,26,18,15,11,18,0.341,0.25,0.409,17.566,36,riffle_perfect
0,15,27,5,47,0.319,20,0.426,3,3,0.5,1,2,30,17,8,15,24,0.17,0.319,0.511,17.582,37,riffle_perfect
0,17,27,4,48,0.354,21,0.438,2,2,0.5,4,4,30,18,6,15,27,0.125,0.312,0.562,17.585,38,riffle_perfect
0,20,20,3,43,0.465,23,0.535,1,5,0.167,1,1,26,17,10,13,20,0.233,0.302,0.465,17.602,39,riffle_perfect
0,18,28,1,47,0.383,19,0.404,1,2,0.333,4,3,30,17,10,16,21,0.213,0.34,0.447,17.609,40,riffle_perfect
0,18,24,3,45,0.4,21,0.467,1,1,0.5,1,2,28,17,12,13,20,0.267,0.289,0.444,17.62,41,riffle_perfect
0,23,22,2,47,0.489,25,0.532,3,2,0.6,4,1,27,20,9,18,20,0.191,0.383,0.426,17.615,42,riffle_perfect
0,26,19,5,50,0.52,31,0.62,5,1,0.833,3,1,30,20,15,12,23,0.3,0.24,0.46,17.615,43,riffle_perfect
0,15,23,4,42,0.357,19,0.452,2,2,0.5,1,0,23,19,10,14,18,0.238,0.333,0.429,17.603,44,riffle_perfect
0,23,26,1,50,0.46,24,0.48,5,3,0.625,1,1,25,25,9,20,21,0.18,0.4,0.42,17.615,45,riffle_perfect
0,25,19,2,46,0.543,27,0.587,4,3,0.571,0,3,28,18,13,15,18,0.283,0.326,0.391,17.63,46,riffle_perfect
0,19,23,5,47,0.404,24,0.511,2,2,0.5,1,3,25,22,9,18,20,0.191,0.383,0.426,17.614,47,riffle_perfect
0,18,21,5,44,0.409,23,0.523,2,3,0.4,1,2,28,16,15,10,19,0.341,0.227,0.432,17.63,48,riffle_perfect
0,24,22,2,48,0.5,26,0.542,9,2,0.818,2,2,32,16,15,13,20,0.312,0.271,0.417,17.623,49,riffle_perfect
0,13,29,1,43,0.302,14,0.326,1,5,0.167,1,2,27,16,5,16,22,0.116,0.372,0.512,17.634,50,riffle_perfect
0,20,19,7,46,0.435,27,0.587,5,1,0.833,2,2,28,18,9,13,24,0.196,0.283,0.522,17.635,51,riffle_perfect
0,21,22,4,47,0.447,25,0.532,1,1,0.5,4,2,31,16,9,11,27,0.191,0.234,0.574,17.638,52,riffle_perfect
0,20,21,5,46,0.435,25,0.543,1,3,0.25,1,0,28,18,11,15,20,0.239,0.326,0.435,17.633,53,riffle_perfect
0,27,17,1,45,0.6,28,0.622,3,1,0.75,2,3,27,18,10,10,25,0.222,0.222,0.556,17.622,54,riffle_perfect
0,23,21,2,46,0.5,25,0.543,3,1,0.75,2,4,26,20,18,10,18,0.391,0.217,0.391,17.614,55,riffle_perfect
0,33,12,3,48,0.688,36,0.75,7,0,1.0,3,0,25,23,18,8,22,0.375,0.167,0.458,17.608,56,riffle_perfect
0,24,23,2,49,0.49,26,0.531,6,1,0.857,2,1,28,21,11,17,21,0.224,0.347,0.429,17.605,57,riffle_perfect
0,18,22,4,44,0.409,22,0.5,5,1,0.833,1,4,30,14,7,13,24,0.159,0.295,0.545,17.612,58,riffle_perfect
0,20,23,3,46,0.435,23,0.5,5,1,0.833,0,2,24,22,11,18,17,0.239,0.391,0.37,17.618,59,riffle_perfect
0,13,28,4,45,0.289,17,0.378,3,2,0.6,1,4,33,12,7,15,23,0.156,0.333,0.511,17.616,60,riffle_perfect
0,17,21,7,45,0.378,24,0.533,0,4,0.0,3,3,25,20,10,14,21,0.222,0.311,0.467,17.606,61,riffle_perfect
0,18,19,5,42,0.429,23,0.548,6,3,0.667,1,1,25,17,12,12,18,0.286,0.286,0.429,17.606,62,riffle_perfect
0,18,30,2,50,0.36,20,0.4,2,5,0.286,3,1,24,26,10,23,17,0.2,0.46,0.34,17.602,63,riffle_perfect
0,17,28,3,48,0.354,20,0.417,4,1,0.8,1,1,25,23,9,20,19,0.188,0.417,0.396,17.613,64,riffle_perfect
0,18,26,3,47,0.383,21,0.447,3,7,0.3,1,1,29,18,5,22,20,0.106,0.468,0.426,17.614,65,riffle_perfect
0,18,24,3,45,0.4,21,0.467,2,2,0.5,1,5,24,21,15,11,19,0.333,0.244,0.422,17.618,66,riffle_perfect
0,19,22,4,45,0.422,23,0.511,0,3,0.0,2,2,27,18,11,16,18,0.244,0.356,0.4,17.63,67,riffle_perfect
0,28,18,3,49,0.571,31,0.633,8,1,0.889,3,0,20,29,20,12,17,0.408,0.245,0.347,17.626,68,riffle_perfect
0,22,25,3,50,0.44,25,0.5,12,2,0.857,1,4,27,23,15,15,20,0.3,0.3,0.4,17.633,69,riffle_perfect
0,21,23,2,46,0.457,23,0.5,2,2,0.5,2,3,33,13,13,10,23,0.283,0.217,0.5,17.619,70,riffle_perfect
0,16,27,3,46,0.348,19,0.413,1,3,0.25,4,0,23,23,6,17,23,0.13,0.37,0.5,17.608,71,riffle_perfect
0,23,23,2,48,0.479,25,0.521,1,1,0.5,4,2,30,18,11,13,24,0.229,0.271,0.5,17.592,72,riffle_perfect
0,23,22,1,46,0.5,24,0.522,3,2,0.6,4,0,27,19,9,17,20,0.196,0.37,0.435,17.589,73,riffle_perfect
0,23,19,6,48,0.479,29,0.604,5,1,0.833,3,3,29,19,10,14,24,0.208,0.292,0.5,17.59,74,riffle_perfect
0,20,22,3,45,0.444,23,0.511,2,0,1.0,0,3,22,23,14,16,15,0.311,0.356,0.333,17.594,75,riffle_perfect
0,17,25,2,44,0.386,19,0.432,3,1,0.75,0,3,27,17,9,18,17,0.205,0.409,0.386,17.595,76,riffle_perfect
0,19,22,3,44,0.432,22,0.5,3,3,0.5,3,1,28,16,10,12,22,0.227,0.273,0.5,17.594,77,riffle_perfect
0,21,19,4,44,0.477,25,0.568,1,1,0.5,1,2,25,19,12,11,21,0.273,0.25,0.477,17.594,78,riffle_perfect
0,15,27,6,48,0.312,21,0.438,1,5,0.167,1,2,34,14,8,16,24,0.167,0.333,0.5,17.595,79,riffle_perfect
0,13,26,6,45,0.289,19,0.422,2,3,0.4,2,2,28,17,7,16,22,0.156,0.356,0.489,17.605,80,riffle_perfect
0,22,19,2,43,0.512,24,0.558,4,2,0.667,3,0,29,14,12,10,21,0.279,0.233,0.488,17.6,81,riffle_perfect
0,23,19,3,45,0.511,26,0.578,3,1,0.75,4,1,24,21,13,12,20,0.289,0.267,0.444,17.603,82,riffle_perfect
0,20,24,4,48,0.417,24,0.5,4,2,0.667,4,4,29,19,7,15,26,0.146,0.312,0.542,17.604,83,riffle_perfect
0,15,26,5,46,0.326,20,0.435,0,3,0.0,3,5,27,19,6,19,21,0.13,0.413,0.457,17.602,84,riffle_perfect
0,10,33,3,46,0.217,13,0.283,1,1,0.5,0,1,26,20,9,18,19,0.196,0.391,0.413,17.604,85,riffle_perfect
0,23,16,5,44,0.523,28,0.636,1,3,0.25,3,2,22,22,13,13,18,0.295,0.295,0.409,17.61,86,riffle_perfect
0,15,26,4,45,0.333,19,0.422,2,3,0.4,1,1,30,15,5,18,22,0.111,0.4,0.489,17.615,87,riffle_perfect
0,15,22,7,44,0.341,22,0.5,2,1,0.667,2,0,29,15,6,18,20,0.136,0.409,0.455,17.62,88,riffle_perfect
0,19,22,4,45,0.422,23,0.511,0,2,0.0,4,1,27,18,9,16,20,0.2,0.356,0.444,17.624,89,riffle_perfect
0,23,20,3,46,0.5,26,0.565,4,3,0.571,3,2,24,22,13,15,18,0.283,0.326,0.391,17.617,90,riffle_perfect
0,22,21,4,47,0.468,26,0.553,3,1,0.75,2,2,28,19,11,15,21,0.234,0.319,0.447,17.621,91,riffle_perfect
0,13,33,4,50,0.26,17,0.34,0,5,0.0,1,3,25,25,6,18,26,0.12,0.36,0.52,17.627,92,riffle_perfect
0,24,20,2,46,0.522,26,0.565,4,2,0.667,4,3,28,18,15,13,18,0.326,0.283,0.391,17.618,93,riffle_perfect
0,17,24,3,44,0.386,20,0.455,6,2,0.75,1,2,28,16,13,10,21,0.295,0.227,0.477,17.613,94,riffle_perfect
0,22,19,4,45,0.489,26,0.578,3,4,0.429,3,2,28,17,9,20,16,0.2,0.444,0.356,17.613,95,riffle_perfect
0,20,20,4,44,0.455,24,0.545,3,1,0.75,2,2,26,18,12,18,14,0.273,0.409,0.318,17.614,96,riffle_perfect
0,16,20,7,43,0.372,23,0.535,1,3,0.25,1,1,27,16,8,18,17,0.186,0.419,0.395,18.312,1,riffle_perfect
0,23,20,5,48,0.479,28,0.583,2,3,0.4,1,1,22,26,13,20,15,0.271,0.417,0.312,18.109,2,riffle_perfect
0,29,15,1,45,0.644,30,0.667,1,4,0.2,3,0,30,15,16,13,16,0.356,0.289,0.356,17.933,3,riffle_perfect
0,14,24,8,46,0.304,22,0.478,3,2,0.6,1,4,28,18,10,18,18,0.217,0.391,0.391,17.992,4,riffle_perfect
0,21,22,3,46,0.457,24,0.522,3,1,0.75,5,1,25,21,8,18,20,0.174,0.391,0.435,17.849,5,riffle_perfect
0,22,22,5,49,0.449,27,0.551,2,1,0.667,2,2,31,18,10,12,27,0.204,0.245,0.551,17.741,6,riffle_perfect
0,20,22,3,45,0.444,23,0.511,4,4,0.5,3,0,25,20,11,17,17,0.244,0.378,0.378,17.751,7,riffle_perfect
0,16,26,3,45,0.356,19,0.422,5,5,0.5,2,3,24,21,9,19,17,0.2,0.422,0.378,17.741,8,riffle_perfect
0,18,19,8,45,0.4,26,0.578,1,1,0.5,4,3,28,17,8,13,24,0.178,0.289,0.533,17.769,9,riffle_perfect
0,21,22,2,45,0.467,23,0.511,3,2,0.6,3,5,27,18,14,10,21,0.311,0.222,0.467,17.764,10,riffle_perfect
0,19,25,3,47,0.404,22,0.468,3,6,0.333,3,1,27,20,12,16,19,0.255,0.34,0.404,17.796,11,riffle_perfect
0,22,17,5,44,0.5,27,0.614,2,1,0.667,1,2,25,19,13,13,18,0.295,0.295,0.409,17.806,12,riffle_perfect
0,22,18,5,45,0.489,27,0.6,7,2,0.778,3,1,31,14,14,9,22,0.311,0.2,0.489,17.784,13,riffle_perfect
0,16,21,7,44,0.364,23,0.523,6,4,0.6,0,3,25,19,10,10,24,0.227,0.227,0.545,17.752,14,riffle_perfect
0,21,22,2,45,0.467,23,0.511,3,3,0.5,4,1,28,17,9,18,18,0.2,0.4,0.4,17.739,15,riffle_perfect
0,25,21,4,50,0.5,29,0.58,2,1,0.667,4,2,27,23,14,17,19,0.28,0.34,0.38,17.745,16,riffle_perfect
0,20,22,5,47,0.426,25,0.532,6,3,0.667,1,5,20,27,14,16,17,0.298,0.34,0.362,17.76,17,riffle_perfect
0,18,26,1,45,0.4,19,0.422,3,1,0.75,4,4,33,12,8,10,27,0.178,0.222,0.6,17.738,18,riffle_perfect
0,17,25,4,46,0.37,21,0.457,1,4,0.2,2,2,27,19,11,17,18,0.239,0.37,0.391,17.75,19,riffle_perfect
0,19,26,4,49,0.388,23,0.469,1,0,1.0,3,4,31,18,9,17,23,0.184,0.347,0.469,17.747,20,riffle_perfect
0,21,20,7,48,0.438,28,0.583,3,2,0.6,4,2,33,15,9,14,25,0.188,0.292,0.521,17.747,21,riffle_perfect
0,23,21,2,46,0.5,25,0.543,6,4,0.6,3,2,25,21,17,9,20,0.37,0.196,0.435,17.705,22,riffle_perfect
0,19,24,1,44,0.432,20,0.455,2,3,0.4,4,3,24,20,12,16,16,0.273,0.364,0.364,17.709,23,riffle_perfect
0,23,19,2,44,0.523,25,0.568,2,3,0.4,2,2,26,18,17,12,15,0.386,0.273,0.341,17.728,24,riffle_perfect
0,15,27,4,46,0.326,19,0.413,2,0,1.0,0,1,31,15,9,16,21,0.196,0.348,0.457,17.728,25,riffle_perfect
0,20,23,2,45,0.444,22,0.489,2,2,0.5,2,2,23,22,9,20,16,0.2,0.444,0.356,17.73,26,riffle_perfect
0,23,23,3,49,0.469,26,0.531,6,4,0.6,1,3,30,19,11,11,27,0.224,0.224,0.551,17.709,27,riffle_perfect
0,22,20,3,45,0.489,25,0.556,3,0,1.0,4,3,35,10,11,8,26,0.244,0.178,0.578,17.697,28,riffle_perfect
0,13,27,5,45,0.289,18,0.4,4,2,0.667,0,4,29,16,8,16,21,0.178,0.356,0.467,17.707,29,riffle_perfect
0,19,24,3,46,0.413,22,0.478,4,4,0.5,2,3,21,25,9,19,18,0.196,0.413,0.391,17.703,30,riffle_perfect
0,20,19,5,44,0.455,25,0.568,1,2,0.333,1,0,26,18,8,17,19,0.182,0.386,0.432,17.729,31,riffle_perfect
0,24,15,5,44,0.545,29,0.659,3,1,0.75,6,0,26,18,12,10,22,0.273,0.227,0.5,17.711,32,riffle_perfect
0,23,21,2,46,0.5,25,0.543,4,2,0.667,2,3,26,20,14,12,20,0.304,0.261,0.435,17.713,33,riffle_perfect
0,21,24,3,48,0.438,24,0.5,2,2,0.5,2,1,24,24,12,19,17,0.25,0.396,0.354,17.714,34,riffle_perfect
0,19,24,1,44,0.432,20,0.455,1,2,0.333,2,2,29,15,14,7,23,0.318,0.159,0.523,17.691,35,riffle_perfect
0,22,22,2,46,0.478,24,0.522,4,2,0.667,1,4,31,15,12,12,22,0.261,0.261,0.478,17.692,36,riffle_perfect
0,21,23,2,46,0.457,23,0.5,2,2,0.5,2,4,26,20,12,16,18,0.261,0.348,0.391,17.688,37,riffle_perfect
0,16,28,2,46,0.348,18,0.391,0,4,0.0,4,3,30,16,4,17,25,0.087,0.37,0.543,17.688,38,riffle_perfect
0,15,27,2,44,0.341,17,0.386,4,4,0.5,0,1,30,14,7,17,20,0.159,0.386,0.455,17.684,39,riffle_perfect
0,23,17,6,46,0.5,29,0.63,3,3,0.5,2,1,29,17,11,15,20,0.239,0.326,0.435,17.672,40,riffle_perfect
0,18,24,4,46,0.391,22,0.478,1,2,0.333,2,2,27,19,9,16,21,0.196,0.348,0.457,17.686,41,riffle_perfect
0,22,20,4,46,0.478,26,0.565,1,0,1.0,2,1,26,20,12,16,18,0.261,0.348,0.391,17.672,42,riffle_perfect
0,19,24,3,46,0.413,22,0.478,4,2,0.667,3,2,22,24,10,20,16,0.217,0.435,0.348,17.679,43,riffle_perfect
0,21,21,5,47,0.447,26,0.553,1,1,0.5,2,4,24,23,14,17,16,0.298,0.362,0.34,17.688,44,riffle_perfect
0,20,22,4,46,0.435,24,0.522,2,2,0.5,2,3,27,19,10,14,22,0.217,0.304,0.478,17.689,45,riffle_perfect
0,22,16,5,43,0.512,27,0.628,5,2,0.714,2,2,28,15,11,14,18,0.256,0.326,0.419,17.694,46,riffle_perfect
0,16,22,6,44,0.364,22,0.5,3,2,0.6,1,2,24,20,11,19,14,0.25,0.432,0.318,17.701,47,riffle_perfect
0,24,19,3,46,0.522,27,0.587,1,3,0.25,1,0,24,22,16,16,14,0.348,0.348,0.304,17.692,48,riffle_perfect
0,17,28,3,48,0.354,20,0.417,1,3,0.25,1,5,33,15,7,17,24,0.146,0.354,0.5,17.689,49,riffle_perfect
0,24,16,8,48,0.5,32,0.667,3,1,0.75,3,1,33,15,10,17,21,0.208,0.354,0.438,17.688,50,riffle_perfect
0,24,19,2,45,0.533,26,0.578,7,2,0.778,5,1,27,18,10,10,25,0.222,0.222,0.556,17.667,51,riffle_perfect
0,14,26,4,44,0.318,18,0.409,5,2,0.714,2,1,24,20,6,19,19,0.136,0.432,0.432,17.68,52,riffle_perfect
0,23,21,2,46,0.5,25,0.543,4,2,0.667,3,2,29,17,13,14,19,0.283,0.304,0.413,17.695,53,riffle_perfect
0,21,23,5,49,0.429,26,0.531,6,0,1.0,3,2,33,16,9,14,26,0.184,0.286,0.531,17.689,54,riffle_perfect
0,16,26,4,46,0.348,20,0.435,2,1,0.667,2,3,29,17,10,14,22,0.217,0.304,0.478,17.678,55,riffle_perfect
0,17,22,4,43,0.395,21,0.488,1,0,1.0,1,1,33,10,10,9,24,0.233,0.209,0.558,17.681,56,riffle_perfect
0,14,26,5,45,0.311,19,0.422,0,2,0.0,2,0,34,11,6,16,23,0.133,0.356,0.511,17.681,57,riffle_perfect
0,24,23,1,48,0.5,25,0.521,4,0,1.0,2,4,30,18,17,12,19,0.354,0.25,0.396,17.684,58,riffle_perfect
0,18,24,3,45,0.4,21,0.467,5,2,0.714,0,2,30,15,11,16,18,0.244,0.356,0.4,17.69,59,riffle_perfect
0,14,28,3,45,0.311,17,0.378,1,4,0.2,4,1,30,15,4,14,27,0.089,0.311,0.6,17.686,60,riffle_perfect
0,24,18,2,44,0.545,26,0.591,2,0,1.0,0,0,31,13,12,11,21,0.273,0.25,0.477,17.688,61,riffle_perfect
0,15,27,3,45,0.333,18,0.4,1,2,0.333,0,3,32,13,10,12,23,0.222,0.267,0.511,17.68,62,riffle_perfect
0,23,17,6,46,0.5,29,0.63,2,0,1.0,4,1,29,17,11,13,22,0.239,0.283,0.478,17.684,63,riffle_perfect
0,18,22,4,44,0.409,22,0.5,4,3,0.571,1,3,33,11,12,9,23,0.273,0.205,0.523,17.681,64,riffle_perfect
0,21,21,4,46,0.457,25,0.543,4,3,0.571,4,5,23,23,13,9,24,0.283,0.196,0.522,17.667,65,riffle_perfect
0,20,22,3,45,0.444,23,0.511,5,3,0.625,1,1,26,19,10,18,17,0.222,0.4,0.378,17.674,66,riffle_perfect
0,20,20,4,44,0.455,24,0.545,3,3,0.5,2,1,23,21,11,16,17,0.25,0.364,0.386,17.669,67,riffle_perfect
0,15,27,5,47,0.319,20,0.426,2,5,0.286,4,4,29,18,8,15,24,0.17,0.319,0.511,17.672,68,riffle_perfect
0,23,22,3,48,0.479,26,0.542,4,1,0.8,4,4,23,25,13,14,21,0.271,0.292,0.438,17.663,69,riffle_perfect
0,20,20,10,50,0.4,30,0.6,2,2,0.5,2,1,30,20,7,16,27,0.14,0.32,0.54,17.66,70,riffle_perfect
0,18,24,2,44,0.409,20,0.455,4,2,0.667,1,4,25,19,10,15,19,0.227,0.341,0.432,17.672,71,riffle_perfect
0,23,18,4,45,0.511,27,0.6,3,2,0.6,2,3,27,18,15,9,21,0.333,0.2,0.467,17.676,72,riffle_perfect
0,13,31,3,47,0.277,16,0.34,0,5,0.0,1,2,29,18,9,17,21,0.191,0.362,0.447,17.683,73,riffle_perfect
0,14,29,2,45,0.311,16,0.356,2,2,0.5,2,3,24,21,11,15,19,0.244,0.333,0.422,17.68,74,riffle_perfect
0,16,26,4,46,0.348,20,0.435,2,4,0.333,0,5,26,20,10,16,20,0.217,0.348,0.435,17.684,75,riffle_perfect
0,19,24,5,48,0.396,24,0.5,3,2,0.6,2,2,35,13,5,16,27,0.104,0.333,0.562,17.685,76,riffle_perfect
0,17,25,4,46,0.37,21,0.457,2,1,0.667,1,1,29,17,6,18,22,0.13,0.391,0.478,17.687,77,riffle_perfect
0,22,24,1,47,0.468,23,0.489,3,2,0.6,2,3,33,14,11,13,23,0.234,0.277,0.489,17.682,78,riffle_perfect
0,23,19,1,43,0.535,24,0.558,4,3,0.571,2,1,23,20,12,15,16,0.279,0.349,0.372,17.671,79,riffle_perfect
0,17,23,4,44,0.386,21,0.477,4,5,0.444,1,3,30,14,10,10,24,0.227,0.227,0.545,17.674,80,riffle_perfect
0,15,28,3,46,0.326,18,0.391,2,4,0.333,3,1,30,16,7,17,22,0.152,0.37,0.478,17.674,81,riffle_perfect
0,19,19,5,43,0.442,24,0.558,1,0,1.0,1,1,24,19,12,12,19,0.279,0.279,0.442,17.678,82,riffle_perfect
0,15,27,3,45,0.333,18,0.4,1,4,0.2,0,2,31,14,6,20,19,0.133,0.444,0.422,17.685,83,riffle_perfect
0,19,24,4,47,0.404,23,0.489,1,6,0.143,1,2,33,14,9,14,24,0.191,0.298,0.511,17.674,84,riffle_perfect
0,17,27,1,45,0.378,18,0.4,2,2,0.5,4,1,25,20,10,15,20,0.222,0.333,0.444,17.671,85,riffle_perfect
0,24,17,7,48,0.5,31,0.646,1,2,0.333,4,1,27,21,9,18,21,0.188,0.375,0.438,17.678,86,riffle_perfect
0,20,19,7,46,0.435,27,0.587,1,4,0.2,1,2,33,13,10,12,24,0.217,0.261,0.522,17.677,87,riffle_perfect
0,16,24,4,44,0.364,20,0.455,1,1,0.5,0,1,24,20,9,21,14,0.205,0.477,0.318,17.68,88,riffle_perfect
0,23,18,3,44,0.523,26,0.591,4,4,0.5,1,1,23,21,16,12,16,0.364,0.273,0.364,17.684,89,riffle_perfect
0,14,28,2,44,0.318,16,0.364,0,4,0.0,2,5,28,16,9,12,23,0.205,0.273,0.523,17.679,90,riffle_perfect
0,19,27,1,47,0.404,20,0.426,4,1,0.8,1,1,27,20,10,15,22,0.213,0.319,0.468,17.679,91,riffle_perfect
0,19,23,5,47,0.404,24,0.511,4,1,0.8,5,2,32,15,9,9,29,0.191,0.191,0.617,17.67,92,riffle_perfect
0,21,19,6,46,0.457,27,0.587,5,2,0.714,1,6,31,15,12,11,23,0.261,0.239,0.5,17.671,93,riffle_perfect
0,19,23,3,45,0.422,22,0.489,1,1,0.5,2,2,32,13,3,18,24,0.067,0.4,0.533,17.682,94,riffle_perfect
0,22,22,3,47,0.468,25,0.532,4,2,0.667,4,1,24,23,14,14,19,0.298,0.298,0.404,17.684,95,riffle_perfect
0,25,21,3,49,0.51,28,0.571,6,3,0.667,5,3,23,26,5,27,17,0.102,0.551,0.347,17.683,96,riffle_perfect
0,24,17,4,45,0.533,28,0.622,3,3,0.5,0,1,27,18,17,10,18,0.378,0.222,0.4,18.167,1,riffle_perfect
0,24,19,3,46,0.522,27,0.587,1,2,0.333,1,3,30,16,14,15,17,0.304,0.326,0.37,17.918,2,riffle_perfect
0,27,19,5,51,0.529,32,0.627,3,1,0.75,2,1,28,23,16,11,24,0.314,0.216,0.471,17.775,3,riffle_perfect
0,23,20,3,46,0.5,26,0.565,4,3,0.571,2,3,28,18,13,13,20,0.283,0.283,0.435,17.717,4,riffle_perfect
0,15,22,7,44,0.341,22,0.5,3,3,0.5,1,3,31,13,7,13,24,0.159,0.295,0.545,17.9,5,riffle_perfect
0,19,22,3,44,0.432,22,0.5,5,1,0.833,2,2,32,12,8,15,21,0.182,0.341,0.477,17.911,6,riffle_perfect
0,28,17,2,47,0.596,30,0.638,6,3,0.667,2,5,34,13,15,10,22,0.319,0.213,0.468,17.933,7,riffle_perfect
0,21,20,2,43,0.488,23,0.535,5,1,0.833,1,2,28,15,15,7,21,0.349,0.163,0.488,17.955,8,riffle_perfect
0,19,22,6,47,0.404,25,0.532,2,4,0.333,4,3,28,19,8,17,22,0.17,0.362,0.468,17.949,9,riffle_perfect
0,27,16,3,46,0.587,30,0.652,6,2,0.75,1,3,28,18,14,16,16,0.304,0.348,0.348,17.989,10,riffle_perfect
0,11,28,7,46,0.239,18,0.391,2,6,0.25,0,5,29,17,4,21,21,0.087,0.457,0.457,17.987,11,riffle_perfect
0,16,26,4,46,0.348,20,0.435,3,2,0.6,1,4,32,14,8,13,25,0.174,0.283,0.543,17.965,12,riffle_perfect
0,15,26,5,46,0.326,20,0.435,3,2,0.6,2,2,27,19,11,13,22,0.239,0.283,0.478,17.949,13,riffle_perfect
0,26,18,0,44,0.591,26,0.591,1,2,0.333,1,1,30,14,18,9,17,0.409,0.205,0.386,17.935,14,riffle_perfect
0,23,22,2,47,0.489,25,0.532,2,4,0.333,2,2,32,15,11,12,24,0.234,0.255,0.511,17.907,15,riffle_perfect
0,16,28,0,44,0.364,16,0.364,2,3,0.4,0,3,30,14,11,14,19,0.25,0.318,0.432,17.913,16,riffle_perfect
0,16,25,7,48,0.333,23,0.479,3,2,0.6,2,4,27,21,7,22,19,0.146,0.458,0.396,17.926,17,riffle_perfect
0,17,26,3,46,0.37,20,0.435,3,3,0.5,1,7,33,13,5,12,29,0.109,0.261,0.63,17.94,18,riffle_perfect
0,16,25,4,45,0.356,20,0.444,2,0,1.0,1,2,29,16,8,13,24,0.178,0.289,0.533,17.945,19,riffle_perfect
0,20,23,5,48,0.417,25,0.521,1,0,1.0,1,3,22,26,15,19,14,0.312,0.396,0.292,17.974,20,riffle_perfect
0,17,28,2,47,0.362,19,0.404,3,3,0.5,1,5,25,22,9,15,23,0.191,0.319,0.489,17.934,21,riffle_perfect
0,19,22,3,44,0.432,22,0.5,3,0,1.0,1,2,30,14,12,8,24,0.273,0.182,0.545,17.916,22,riffle_perfect
0,26,19,2,47,0.553,28,0.596,5,2,0.714,2,3,31,16,11,14,22,0.234,0.298,0.468,17.894,23,riffle_perfect
0,17,22,7,46,0.37,24,0.522,2,2,0.5,2,1,25,21,5,22,19,0.109,0.478,0.413,17.875,24,riffle_perfect
0,24,15,6,45,0.533,30,0.667,3,1,0.75,0,1,27,18,11,16,18,0.244,0.356,0.4,17.884,25,riffle_perfect
0,15,28,6,49,0.306,21,0.429,2,4,0.333,5,2,24,25,5,23,21,0.102,0.469,0.429,17.886,26,riffle_perfect
0,17,27,3,47,0.362,20,0.426,5,5,0.5,1,2,25,22,10,17,20,0.213,0.362,0.426,17.898,27,riffle_perfect
0,17,23,4,44,0.386,21,0.477,2,5,0.286,3,0,20,24,12,17,15,0.273,0.386,0.341,17.894,28,riffle_perfect
0,20,16,6,42,0.476,26,0.619,3,1,0.75,2,0,20,22,14,13,15,0.333,0.31,0.357,17.881,29,riffle_perfect
0,19,22,3,44,0.432,22,0.5,4,1,0.8,1,1,19,25,12,19,13,0.273,0.432,0.295,17.882,30,riffle_perfect
0,20,24,2,46,0.435,22,0.478,1,3,0.25,3,1,26,20,10,12,24,0.217,0.261,0.522,17.878,31,riffle_perfect
0,19,21,4,44,0.432,23,0.523,1,1,0.5,0,3,31,13,12,9,23,0.273,0.205,0.523,17.873,32,riffle_perfect
0,13,25,7,45,0.289,20,0.444,0,5,0.0,2,4,30,15,8,16,21,0.178,0.356,0.467,17.879,33,riffle_perfect
0,23,18,3,44,0.523,26,0.591,4,2,0.667,1,3,25,19,13,10,21,0.295,0.227,0.477,17.854,34,riffle_perfect
0,20,20,6,46,0.435,26,0.565,2,2,0.5,3,2,25,21,14,17,15,0.304,0.37,0.326,17.846,35,riffle_perfect
0,20,21,6,47,0.426,26,0.553,3,3,0.5,1,2,32,15,12,14,21,0.255,0.298,0.447,17.841,36,riffle_perfect
0,17,22,6,45,0.378,23,0.511,2,0,1.0,2,5,26,19,11,15,19,0.244,0.333,0.422,17.832,37,riffle_perfect
0,21,22,2,45,0.467,23,0.511,3,1,0.75,3,3,27,18,11,13,21,0.244,0.289,0.467,17.841,38,riffle_perfect
0,19,20,4,43,0.442,23,0.535,3,2,0.6,1,0,29,14,12,14,17,0.279,0.326,0.395,17.844,39,riffle_perfect
0,25,19,4,48,0.521,29,0.604,5,3,0.625,1,3,24,24,18,14,16,0.375,0.292,0.333,17.85,40,riffle_perfect
0,14,26,6,46,0.304,20,0.435,3,2,0.6,2,2,27,19,9,16,21,0.196,0.348,0.457,17.856,41,riffle_perfect
0,16,25,3,44,0.364,19,0.432,3,3,0.5,1,3,29,15,9,12,23,0.205,0.273,0.523,17.839,42,riffle_perfect
0,19,23,4,46,0.413,23,0.5,2,3,0.4,5,1,37,9,5,10,31,0.109,0.217,0.674,17.822,43,riffle_perfect
0,12,23,10,45,0.267,22,0.489,3,2,0.6,2,4,38,7,6,15,24,0.133,0.333,0.533,17.828,44,riffle_perfect
0,26,18,3,47,0.553,29,0.617,4,3,0.571,2,4,25,22,14,14,19,0.298,0.298,0.404,17.827,45,riffle_perfect
0,21,19,3,43,0.488,24,0.558,3,2,0.6,2,1,32,11,10,10,23,0.233,0.233,0.535,17.831,46,riffle_perfect
0,18,20,6,44,0.409,24,0.545,3,3,0.5,0,0,28,16,6,21,17,0.136,0.477,0.386,17.83,47,riffle_perfect
0,20,21,5,46,0.435,25,0.543,4,2,0.667,2,4,34,12,13,11,22,0.283,0.239,0.478,17.826,48,riffle_perfect
0,17,24,5,46,0.37,22,0.478,3,5,0.375,2,2,30,16,7,13,26,0.152,0.283,0.565,17.806,49,riffle_perfect
0,22,17,6,45,0.489,28,0.622,3,0,1.0,4,1,27,18,14,12,19,0.311,0.267,0.422,17.802,50,riffle_perfect
0,19,22,5,46,0.413,24,0.522,2,2,0.5,5,1,29,17,7,14,25,0.152,0.304,0.543,17.797,51,riffle_perfect
0,18,25,3,46,0.391,21,0.457,3,2,0.6,3,4,33,13,8,12,26,0.174,0.261,0.565,17.792,52,riffle_perfect
0,23,21,1,45,0.511,24,0.533,3,1,0.75,0,2,29,16,12,11,22,0.267,0.244,0.489,17.785,53,riffle_perfect
0,17,23,6,46,0.37,23,0.5,4,2,0.667,3,3,26,20,8,15,23,0.174,0.326,0.5,17.776,54,riffle_perfect
0,21,20,4,45,0.467,25,0.556,3,7,0.3,2,0,26,19,6,19,20,0.133,0.422,0.444,17.781,55,riffle_perfect
0,21,22,1,44,0.477,22,0.5,2,1,0.667,1,3,27,17,17,8,19,0.386,0.182,0.432,17.784,56,riffle_perfect
0,18,20,5,43,0.419,23,0.535,0,1,0.0,1,1,30,13,8,15,20,0.186,0.349,0.465,17.785,57,riffle_perfect
0,24,21,2,47,0.511,26,0.553,3,1,0.75,2,2,28,19,14,14,19,0.298,0.298,0.404,17.776,58,riffle_perfect
0,18,28,4,50,0.36,22,0.44,2,3,0.4,1,3,28,22,13,11,26,0.26,0.22,0.52,17.777,59,riffle_perfect
0,20,22,3,45,0.444,23,0.511,2,2,0.5,2,5,30,15,10,14,21,0.222,0.311,0.467,17.774,60,riffle_perfect
0,21,17,8,46,0.457,29,0.63,4,0,1.0,4,3,29,17,13,11,22,0.283,0.239,0.478,17.773,61,riffle_perfect
0,24,18,3,45,0.533,27,0.6,1,4,0.2,2,1,31,14,14,8,23,0.311,0.178,0.511,17.768,62,riffle_perfect
0,22,23,3,48,0.458,25,0.521,1,3,0.25,3,2,25,23,14,11,23,0.292,0.229,0.479,17.762,63,riffle_perfect
0,25,17,6,48,0.521,31,0.646,2,3,0.4,5,1,29,19,10,18,20,0.208,0.375,0.417,17.758,64,riffle_perfect
0,27,19,2,48,0.562,29,0.604,5,1,0.833,4,5,32,16,16,12,20,0.333,0.25,0.417,17.761,65,riffle_perfect
0,18,21,5,44,0.409,23,0.523,2,4,0.333,2,2,25,19,8,18,18,0.182,0.409,0.409,17.76,66,riffle_perfect
0,15,26,4,45,0.333,19,0.422,4,1,0.8,2,3,26,19,8,17,20,0.178,0.378,0.444,17.759,67,riffle_perfect
0,20,20,5,45,0.444,25,0.556,1,1,0.5,1,2,19,26,11,22,12,0.244,0.489,0.267,17.762,68,riffle_perfect
0,25,18,2,45,0.556,27,0.6,7,2,0.778,1,1,31,14,15,11,19,0.333,0.244,0.422,17.758,69,riffle_perfect
0,21,21,4,46,0.457,25,0.543,1,3,0.25,4,4,28,18,10,13,23,0.217,0.283,0.5,17.751,70,riffle_perfect
0,15,24,5,44,0.341,20,0.455,1,3,0.25,3,3,30,14,9,13,22,0.205,0.295,0.5,17.743,71,riffle_perfect
0,18,23,3,44,0.409,21,0.477,3,1,0.75,1,0,17,27,8,22,14,0.182,0.5,0.318,17.747,72,riffle_perfect
0,27,15,4,46,0.587,31,0.674,3,3,0.5,1,0,28,18,16,13,17,0.348,0.283,0.37,17.743,73,riffle_perfect
0,27,17,4,48,0.562,31,0.646,2,1,0.667,2,0,22,26,14,16,18,0.292,0.333,0.375,17.741,74,riffle_perfect
0,16,24,6,46,0.348,22,0.478,0,4,0.0,1,1,33,13,9,14,23,0.196,0.304,0.5,17.725,75,riffle_perfect
0,23,20,1,44,0.523,24,0.545,4,0,1.0,0,4,30,14,14,8,22,0.318,0.182,0.5,17.725,76,riffle_perfect
0,23,20,2,45,0.511,25,0.556,5,3,0.625,1,1,30,15,11,12,22,0.244,0.267,0.489,17.723,77,riffle_perfect
0,18,24,5,47,0.383,23,0.489,1,1,0.5,2,4,26,21,11,17,19,0.234,0.362,0.404,17.708,78,riffle_perfect
0,21,22,4,47,0.447,25,0.532,2,2,0.5,2,2,32,15,11,12,24,0.234,0.255,0.511,17.703,79,riffle_perfect
0,21,20,4,45,0.467,25,0.556,1,1,0.5,1,1,25,20,14,12,19,0.311,0.267,0.422,17.702,80,riffle_perfect
0,19,20,5,44,0.432,24,0.545,3,1,0.75,2,2,26,18,11,14,19,0.25,0.318,0.432,17.697,81,riffle_perfect
0,15,25,5,45,0.333,20,0.444,1,2,0.333,2,1,30,15,9,17,19,0.2,0.378,0.422,17.692,82,riffle_perfect
0,14,29,1,44,0.318,15,0.341,3,0,1.0,1,4,26,18,8,15,21,0.182,0.341,0.477,17.691,83,riffle_perfect
0,19,25,2,46,0.413,21,0.457,3,2,0.6,3,4,33,13,5,14,27,0.109,0.304,0.587,17.684,84,riffle_perfect
0,17,25,3,45,0.378,20,0.444,2,2,0.5,1,1,31,14,12,11,22,0.267,0.244,0.489,17.687,85,riffle_perfect
0,16,24,5,45,0.356,21,0.467,4,1,0.8,0,3,32,13,15,11,19,0.333,0.244,0.422,17.691,86,riffle_perfect
0,17,26,3,46,0.37,20,0.435,2,1,0.667,1,2,28,18,13,9,24,0.283,0.196,0.522,17.691,87,riffle_perfect
0,14,27,5,46,0.304,19,0.413,1,2,0.333,2,6,30,16,4,16,26,0.087,0.348,0.565,17.691,88,riffle_perfect
0,20,19,3,42,0.476,23,0.548,2,1,0.667,1,0,21,21,16,12,14,0.381,0.286,0.333,17.692,89,riffle_perfect
0,21,23,1,45,0.467,22,0.489,1,3,0.25,4,2,30,15,8,13,24,0.178,0.289,0.533,17.678,90,riffle_perfect
0,18,24,3,45,0.4,21,0.467,0,0,0,2,4,33,12,10,14,21,0.222,0.311,0.467,17.682,91,riffle_perfect
0,16,25,4,45,0.356,20,0.444,3,1,0.75,3,2,28,17,4,19,22,0.089,0.422,0.489,17.682,92,riffle_perfect
0,21,18,7,46,0.457,28,0.609,5,0,1.0,5,2,33,13,10,12,24,0.217,0.261,0.522,17.682,93,riffle_perfect
0,15,23,5,43,0.349,20,0.465,3,3,0.5,0,2,24,19,9,14,20,0.209,0.326,0.465,17.682,94,riffle_perfect
0,18,26,5,49,0.367,23,0.469,2,3,0.4,4,2,27,22,5,19,25,0.102,0.388,0.51,17.688,95,riffle_perfect
0,15,24,5,44,0.341,20,0.455,2,3,0.4,1,2,27,17,9,15,20,0.205,0.341,0.455,17.687,96,riffle_perfect
0,20,20,3,43,0.465,23,0.535,2,3,0.4,1,2,30,13,10,9,24,0.233,0.209,0.558,18.867,1,riffle_perfect
0,18,20,6,44,0.409,24,0.545,3,2,0.6,0,4,28,16,14,15,15,0.318,0.341,0.341,18.34,2,riffle_perfect
0,18,23,2,43,0.419,20,0.465,2,2,0.5,4,3,31,12,9,9,25,0.209,0.209,0.581,17.711,3,riffle_perfect
0,17,22,7,46,0.37,24,0.522,1,2,0.333,3,2,25,21,5,20,21,0.109,0.435,0.457,17.689,4,riffle_perfect
0,20,28,2,50,0.4,22,0.44,3,3,0.5,1,2,36,14,9,14,27,0.18,0.28,0.54,17.789,5,riffle_perfect
0,20,20,5,45,0.444,25,0.556,1,5,0.167,5,2,24,21,9,19,17,0.2,0.422,0.378,17.71,6,riffle_perfect
0,17,26,4,47,0.362,21,0.447,2,0,1.0,2,5,37,10,7,11,29,0.149,0.234,0.617,17.638,7,riffle_perfect
0,20,26,2,48,0.417,22,0.458,3,2,0.6,1,4,26,22,9,17,22,0.188,0.354,0.458,17.739,8,riffle_perfect
0,22,18,6,46,0.478,28,0.609,5,3,0.625,0,2,24,22,17,17,12,0.37,0.37,0.261,17.773,9,riffle_perfect
0,24,19,2,45,0.533,26,0.578,5,1,0.833,5,1,25,20,11,14,20,0.244,0.311,0.444,17.763,10,riffle_perfect
0,22,23,1,46,0.478,23,0.5,4,2,0.667,1,1,23,23,12,12,22,0.261,0.261,0.478,17.794,11,riffle_perfect
0,17,24,5,46,0.37,22,0.478,2,4,0.333,2,2,26,20,6,17,23,0.13,0.37,0.5,17.754,12,riffle_perfect
0,20,22,6,48,0.417,26,0.542,5,4,0.556,2,4,25,23,13,17,18,0.271,0.354,0.375,17.777,13,riffle_perfect
0,24,18,5,47,0.511,29,0.617,4,2,0.667,1,4,26,21,17,11,19,0.362,0.234,0.404,17.765,14,riffle_perfect
0,24,20,4,48,0.5,28,0.583,3,1,0.75,4,4,32,16,8,15,25,0.167,0.312,0.521,17.767,15,riffle_perfect
0,20,21,4,45,0.444,24,0.533,2,2,0.5,1,1,25,20,12,16,17,0.267,0.356,0.378,17.728,16,riffle_perfect
0,17,22,5,44,0.386,22,0.5,2,1,0.667,1,3,26,18,11,15,18,0.25,0.341,0.409,17.718,17,riffle_perfect
0,21,19,3,43,0.488,24,0.558,4,2,0.667,1,1,27,16,10,14,19,0.233,0.326,0.442,17.702,18,riffle_perfect
0,15,29,3,47,0.319,18,0.383,1,2,0.333,3,0,29,18,5,15,27,0.106,0.319,0.574,17.696,19,riffle_perfect
0,19,20,5,44,0.432,24,0.545,5,2,0.714,3,0,27,17,10,12,22,0.227,0.273,0.5,17.672,20,riffle_perfect
0,15,26,7,48,0.312,22,0.458,1,3,0.25,2,4,25,23,5,21,22,0.104,0.438,0.458,17.694,21,riffle_perfect
0,17,24,4,45,0.378,21,0.467,6,2,0.75,3,5,27,18,10,15,20,0.222,0.333,0.444,17.667,22,riffle_perfect
0,20,21,3,44,0.455,23,0.523,1,3,0.25,1,3,29,15,13,15,16,0.295,0.341,0.364,17.664,23,riffle_perfect
0,17,25,3,45,0.378,20,0.444,3,2,0.6,1,0,30,15,5,20,20,0.111,0.444,0.444,17.654,24,riffle_perfect
0,19,22,2,43,0.442,21,0.488,2,1,0.667,3,2,28,15,11,12,20,0.256,0.279,0.465,17.63,25,riffle_perfect
0,19,20,6,45,0.422,25,0.556,0,2,0.0,2,2,37,8,7,12,26,0.156,0.267,0.578,17.627,26,riffle_perfect
0,22,19,3,44,0.5,25,0.568,0,1,0.0,2,1,33,11,8,13,23,0.182,0.295,0.523,17.64,27,riffle_perfect
0,24,17,5,46,0.522,29,0.63,2,1,0.667,5,0,27,19,13,11,22,0.283,0.239,0.478,17.645,28,riffle_perfect
0,18,23,5,46,0.391,23,0.5,2,4,0.333,1,2,26,20,11,19,16,0.239,0.413,0.348,17.641,29,riffle_perfect
0,24,18,3,45,0.533,27,0.6,1,2,0.333,4,0,26,19,10,18,17,0.222,0.4,0.378,17.645,30,riffle_perfect
0,20,24,2,46,0.435,22,0.478,2,0,1.0,4,1,30,16,9,13,24,0.196,0.283,0.522,17.643,31,riffle_perfect
0,19,21,5,45,0.422,24,0.533,3,4,0.429,4,1,29,16,9,12,24,0.2,0.267,0.533,17.621,32,riffle_perfect
0,17,24,5,46,0.37,22,0.478,3,4,0.429,1,1,23,23,11,19,16,0.239,0.413,0.348,17.635,33,riffle_perfect
0,15,29,2,46,0.326,17,0.37,2,3,0.4,0,2,32,14,8,14,24,0.174,0.304,0.522,17.621,34,riffle_perfect
0,21,19,6,46,0.457,27,0.587,2,1,0.667,1,3,33,13,9,17,20,0.196,0.37,0.435,17.645,35,riffle_perfect
0,17,26,2,45,0.378,19,0.422,1,2,0.333,2,4,32,13,11,12,22,0.244,0.267,0.489,17.652,36,riffle_perfect
0,21,20,3,44,0.477,24,0.545,2,2,0.5,3,2,26,18,12,14,18,0.273,0.318,0.409,17.666,37,riffle_perfect
0,18,20,6,44,0.409,24,0.545,2,1,0.667,5,2,28,16,6,17,21,0.136,0.386,0.477,17.671,38,riffle_perfect
0,20,24,2,46,0.435,22,0.478,4,1,0.8,3,4,30,16,11,12,23,0.239,0.261,0.5,17.654,39,riffle_perfect
0,26,16,3,45,0.578,29,0.644,6,1,0.857,1,2,27,18,16,10,19,0.356,0.222,0.422,17.664,40,riffle_perfect
0,21,21,2,44,0.477,23,0.523,3,2,0.6,2,3,33,11,5,18,21,0.114,0.409,0.477,17.674,41,riffle_perfect
0,21,19,5,45,0.467,26,0.578,3,1,0.75,2,1,23,22,12,14,19,0.267,0.311,0.422,17.675,42,riffle_perfect
0,18,22,4,44,0.409,22,0.5,2,1,0.667,2,3,28,16,10,13,21,0.227,0.295,0.477,17.667,43,riffle_perfect
0,24,18,3,45,0.533,27,0.6,0,2,0.0,2,1,28,17,11,15,19,0.244,0.333,0.422,17.655,44,riffle_perfect
0,23,24,2,49,0.469,25,0.51,4,5,0.444,3,2,26,23,12,17,20,0.245,0.347,0.408,17.629,45,riffle_perfect
0,24,20,3,47,0.511,27,0.574,4,3,0.571,2,1,33,14,9,13,25,0.191,0.277,0.532,17.623,46,riffle_perfect
0,19,22,4,45,0.422,23,0.511,0,3,0.0,1,2,27,18,11,17,17,0.244,0.378,0.378,17.633,47,riffle_perfect
0,16,25,4,45,0.356,20,0.444,0,2,0.0,2,3,31,14,10,12,23,0.222,0.267,0.511,17.633,48,riffle_perfect
0,23,24,4,51,0.451,27,0.529,4,4,0.5,3,2,27,24,13,21,17,0.255,0.412,0.333,17.641,49,riffle_perfect
0,20,29,2,51,0.392,22,0.431,5,2,0.714,4,0,30,21,9,22,20,0.176,0.431,0.392,17.641,50,riffle_perfect
0,24,17,4,45,0.533,28,0.622,2,2,0.5,2,0,25,20,14,13,18,0.311,0.289,0.4,17.643,51,riffle_perfect
0,15,26,4,45,0.333,19,0.422,3,2,0.6,2,4,24,21,7,19,19,0.156,0.422,0.422,17.639,52,riffle_perfect
0,22,19,5,46,0.478,27,0.587,2,3,0.4,2,2,28,18,16,12,18,0.348,0.261,0.391,17.641,53,riffle_perfect
0,20,24,1,45,0.444,21,0.467,3,1,0.75,2,0,25,20,10,15,20,0.222,0.333,0.444,17.629,54,riffle_perfect
0,18,25,4,47,0.383,22,0.468,2,5,0.286,1,1,25,22,9,20,18,0.191,0.426,0.383,17.635,55,riffle_perfect
0,23,20,1,44,0.523,24,0.545,4,0,1.0,2,1,28,16,15,8,21,0.341,0.182,0.477,17.636,56,riffle_perfect
0,22,18,6,46,0.478,28,0.609,3,4,0.429,2,1,24,22,12,11,23,0.261,0.239,0.5,17.631,57,riffle_perfect
0,17,21,6,44,0.386,23,0.523,4,4,0.5,2,0,21,23,9,21,14,0.205,0.477,0.318,17.634,58,riffle_perfect
0,20,19,8,47,0.426,28,0.596,5,3,0.625,4,1,28,19,6,19,22,0.128,0.404,0.468,17.641,59,riffle_perfect
0,18,25,2,45,0.4,20,0.444,4,1,0.8,1,1,25,20,10,20,15,0.222,0.444,0.333,17.638,60,riffle_perfect
0,20,22,4,46,0.435,24,0.522,2,2,0.5,2,1,24,22,13,17,16,0.283,0.37,0.348,17.649,61,riffle_perfect
0,25,19,3,47,0.532,28,0.596,1,1,0.5,3,4,26,21,13,12,22,0.277,0.255,0.468,17.642,62,riffle_perfect
0,14,26,5,45,0.311,19,0.422,0,2,0.0,0,1,22,23,9,20,16,0.2,0.444,0.356,17.651,63,riffle_perfect
0,18,22,4,44,0.409,22,0.5,0,3,0.0,0,3,23,21,11,14,19,0.25,0.318,0.432,17.655,64,riffle_perfect
0,25,15,7,47,0.532,32,0.681,2,3,0.4,2,0,27,20,14,15,18,0.298,0.319,0.383,17.659,65,riffle_perfect
0,23,21,5,49,0.469,28,0.571,9,3,0.75,2,1,29,20,14,13,22,0.286,0.265,0.449,17.657,66,riffle_perfect
0,20,23,2,45,0.444,22,0.489,1,0,1.0,1,2,30,15,11,13,21,0.244,0.289,0.467,17.655,67,riffle_perfect
0,19,20,6,45,0.422,25,0.556,3,0,1.0,0,1,25,20,11,15,19,0.244,0.333,0.422,17.665,68,riffle_perfect
0,23,23,1,47,0.489,24,0.511,4,2,0.667,4,5,25,22,14,14,19,0.298,0.298,0.404,17.658,69,riffle_perfect
0,21,15,8,44,0.477,29,0.659,6,0,1.0,1,2,24,20,17,10,17,0.386,0.227,0.386,17.662,70,riffle_perfect
0,26,13,5,44,0.591,31,0.705,5,4,0.556,4,2,23,21,17,14,13,0.386,0.318,0.295,17.657,71,riffle_perfect
0,21,19,5,45,0.467,26,0.578,1,0,1.0,0,3,27,18,12,13,20,0.267,0.289,0.444,17.659,72,riffle_perfect
0,19,22,4,45,0.422,23,0.511,3,4,0.429,0,5,28,17,10,15,20,0.222,0.333,0.444,17.675,73,riffle_perfect
0,20,24,1,45,0.444,21,0.467,4,0,1.0,1,3,31,14,10,18,17,0.222,0.4,0.378,17.678,74,riffle_perfect
0,17,21,6,44,0.386,23,0.523,4,1,0.8,1,1,29,15,7,15,22,0.159,0.341,0.5,17.692,75,riffle_perfect
0,21,22,1,44,0.477,22,0.5,8,5,0.615,2,2,26,18,14,15,15,0.318,0.341,0.341,17.699,76,riffle_perfect
0,26,19,1,46,0.565,27,0.587,4,2,0.667,4,3,24,22,13,18,15,0.283,0.391,0.326,17.7,77,riffle_perfect
0,20,22,4,46,0.435,24,0.522,2,0,1.0,4,0,32,14,10,14,22,0.217,0.304,0.478,17.694,78,riffle_perfect
0,16,22,5,43,0.372,21,0.488,4,3,0.571,0,0,26,17,9,17,17,0.209,0.395,0.395,17.692,79,riffle_perfect
0,17,22,4,43,0.395,21,0.488,3,2,0.6,1,3,26,17,12,14,17,0.279,0.326,0.395,17.698,80,riffle_perfect
0,21,23,4,48,0.438,25,0.521,5,3,0.625,1,1,28,20,10,16,22,0.208,0.333,0.458,17.7,81,riffle_perfect
0,24,19,3,46,0.522,27,0.587,2,2,0.5,0,5,32,14,13,11,22,0.283,0.239,0.478,17.7,82,riffle_perfect
0,24,18,3,45,0.533,27,0.6,5,1,0.833,1,3,31,14,18,9,18,0.4,0.2,0.4,17.699,83,riffle_perfect
0,16,24,4,44,0.364,20,0.455,3,5,0.375,1,2,23,21,8,17,19,0.182,0.386,0.432,17.708,84,riffle_perfect
0,18,24,3,45,0.4,21,0.467,1,3,0.25,4,4,27,18,11,9,25,0.244,0.2,0.556,17.709,85,riffle_perfect
0,21,23,2,46,0.457,23,0.5,3,3,0.5,0,0,30,16,14,21,11,0.304,0.457,0.239,17.712,86,riffle_perfect
0,14,31,1,46,0.304,15,0.326,1,7,0.125,1,2,26,20,6,19,21,0.13,0.413,0.457,17.716,87,riffle_perfect
0,18,24,3,45,0.4,21,0.467,2,4,0.333,2,3,25,20,11,12,22,0.244,0.267,0.489,17.709,88,riffle_perfect
0,17,24,5,46,0.37,22,0.478,2,4,0.333,3,1,32,14,11,9,26,0.239,0.196,0.565,17.701,89,riffle_perfect
0,19,23,5,47,0.404,24,0.511,3,3,0.5,3,2,29,18,7,15,25,0.149,0.319,0.532,17.702,90,riffle_perfect
0,22,19,3,44,0.5,25,0.568,4,2,0.667,2,0,23,21,15,15,14,0.341,0.341,0.318,17.695,91,riffle_perfect
0,25,18,4,47,0.532,29,0.617,3,2,0.6,5,2,30,17,15,11,21,0.319,0.234,0.447,17.687,92,riffle_perfect
0,21,23,3,47,0.447,24,0.511,4,1,0.8,3,0,28,19,7,21,19,0.149,0.447,0.404,17.685,93,riffle_perfect
0,23,18,3,44,0.523,26,0.591,5,2,0.714,2,3,29,15,10,17,17,0.227,0.386,0.386,17.688,94,riffle_perfect
0,16,26,4,46,0.348,20,0.435,2,4,0.333,3,2,28,18,7,15,24,0.152,0.326,0.522,17.684,95,riffle_perfect
0,17,27,3,47,0.362,20,0.426,1,3,0.25,2,8,32,15,11,10,26,0.234,0.213,0.553,17.672,96,riffle_perfect
0,21,22,3,46,0.457,24,0.522,3,2,0.6,2,0,30,16,9,9,28,0.196,0.196,0.609,18.061,1,riffle_perfect
0,21,20,3,44,0.477,24,0.545,3,0,1.0,3,0,25,19,11,18,15,0.25,0.409,0.341,18.016,2,riffle_perfect
0,21,23,1,45,0.467,22,0.489,7,0,1.0,1,2,25,20,13,10,22,0.289,0.222,0.489,17.622,3,riffle_perfect
0,21,21,3,45,0.467,24,0.533,2,2,0.5,5,3,28,17,10,10,25,0.222,0.222,0.556,17.388,4,riffle_perfect
0,23,16,5,44,0.523,28,0.636,4,2,0.667,2,1,27,17,11,15,18,0.25,0.341,0.409,17.474,5,riffle_perfect
0,23,19,3,45,0.511,26,0.578,6,4,0.6,4,2,24,21,11,19,15,0.244,0.422,0.333,17.516,6,riffle_perfect
0,22,21,2,45,0.489,24,0.533,2,3,0.4,3,3,27,18,11,17,17,0.244,0.378,0.378,17.49,7,riffle_perfect
0,16,25,4,45,0.356,20,0.444,1,0,1.0,1,4,33,12,6,13,26,0.133,0.289,0.578,17.573,8,riffle_perfect
0,16,23,6,45,0.356,22,0.489,2,0,1.0,3,6,29,16,9,13,23,0.2,0.289,0.511,17.522,9,riffle_perfect
0,18,21,6,45,0.4,24,0.533,4,0,1.0,3,3,27,18,7,17,21,0.156,0.378,0.467,17.502,10,riffle_perfect
0,20,20,5,45,0.444,25,0.556,5,2,0.714,0,4,26,19,13,12,20,0.289,0.267,0.444,17.589,11,riffle_perfect
0,25,21,2,48,0.521,27,0.562,3,0,1.0,0,2,26,22,15,11,22,0.312,0.229,0.458,17.582,12,riffle_perfect
0,21,24,2,47,0.447,23,0.489,3,2,0.6,3,4,30,17,11,11,25,0.234,0.234,0.532,17.581,13,riffle_perfect
0,16,25,5,46,0.348,21,0.457,3,2,0.6,3,2,29,17,6,14,26,0.13,0.304,0.565,17.584,14,riffle_perfect
0,24,21,2,47,0.511,26,0.553,6,3,0.667,6,3,28,19,12,12,23,0.255,0.255,0.489,17.592,15,riffle_perfect
0,19,23,1,43,0.442,20,0.465,8,1,0.889,1,5,33,10,13,9,21,0.302,0.209,0.488,17.613,16,riffle_perfect
0,24,16,7,47,0.511,31,0.66,3,2,0.6,2,1,26,21,15,12,20,0.319,0.255,0.426,17.642,17,riffle_perfect
0,14,26,5,45,0.311,19,0.422,4,3,0.571,3,5,28,17,7,15,23,0.156,0.333,0.511,17.628,18,riffle_perfect
0,19,24,3,46,0.413,22,0.478,1,3,0.25,3,1,24,22,8,16,22,0.174,0.348,0.478,17.65,19,riffle_perfect
0,23,22,3,48,0.479,26,0.542,4,2,0.667,1,5,28,20,14,11,23,0.292,0.229,0.479,17.646,20,riffle_perfect
0,13,29,2,44,0.295,15,0.341,0,3,0.0,4,1,30,14,8,15,21,0.182,0.341,0.477,17.659,21,riffle_perfect
0,20,22,1,43,0.465,21,0.488,4,2,0.667,1,1,24,19,14,11,18,0.326,0.256,0.419,17.645,22,riffle_perfect
0,19,24,4,47,0.404,23,0.489,0,2,0.0,3,2,24,23,9,17,21,0.191,0.362,0.447,17.611,23,riffle_perfect
0,17,26,4,47,0.362,21,0.447,2,2,0.5,3,5,33,14,10,10,27,0.213,0.213,0.574,17.554,24,riffle_perfect
0,23,22,3,48,0.479,26,0.542,2,0,1.0,4,3,32,16,11,15,22,0.229,0.312,0.458,17.553,25,riffle_perfect
0,18,22,6,46,0.391,24,0.522,2,2,0.5,1,2,26,20,12,13,21,0.261,0.283,0.457,17.556,26,riffle_perfect
0,24,15,6,45,0.533,30,0.667,3,1,0.75,3,2,23,22,15,15,15,0.333,0.333,0.333,17.562,27,riffle_perfect
0,22,21,4,47,0.468,26,0.553,3,1,0.75,2,2,25,22,12,17,18,0.255,0.362,0.383,17.578,28,riffle_perfect
0,23,17,8,48,0.479,31,0.646,4,1,0.8,2,1,32,16,15,17,16,0.312,0.354,0.333,17.582,29,riffle_perfect
0,21,22,4,47,0.447,25,0.532,4,1,0.8,1,2,34,13,10,16,21,0.213,0.34,0.447,17.574,30,riffle_perfect
0,22,19,2,43,0.512,24,0.558,5,0,1.0,1,5,33,10,11,10,22,0.256,0.233,0.512,17.583,31,riffle_perfect
0,17,24,4,45,0.378,21,0.467,2,3,0.4,3,3,26,19,9,13,23,0.2,0.289,0.511,17.548,32,riffle_perfect
0,24,19,2,45,0.533,26,0.578,6,2,0.75,2,1,27,18,12,11,22,0.267,0.244,0.489,17.528,33,riffle_perfect
0,23,23,3,49,0.469,26,0.531,8,5,0.615,3,2,26,23,10,17,22,0.204,0.347,0.449,17.533,34,riffle_perfect
0,9,27,10,46,0.196,19,0.413,2,1,0.667,0,2,30,16,7,18,21,0.152,0.391,0.457,17.548,35,riffle_perfect
0,17,28,2,47,0.362,19,0.404,0,3,0.0,3,3,25,22,11,12,24,0.234,0.255,0.511,17.539,36,riffle_perfect
0,21,23,1,45,0.467,22,0.489,3,2,0.6,3,1,30,15,11,16,18,0.244,0.356,0.4,17.522,37,riffle_perfect
0,19,26,3,48,0.396,22,0.458,5,3,0.625,3,2,29,19,11,15,22,0.229,0.312,0.458,17.545,38,riffle_perfect
0,17,24,2,43,0.395,19,0.442,5,5,0.5,1,2,20,23,10,18,15,0.233,0.419,0.349,17.558,39,riffle_perfect
0,29,15,3,47,0.617,32,0.681,6,2,0.75,3,0,29,18,17,10,20,0.362,0.213,0.426,17.555,40,riffle_perfect
0,25,20,3,48,0.521,28,0.583,2,2,0.5,1,2,26,22,10,19,19,0.208,0.396,0.396,17.56,41,riffle_perfect
0,20,22,5,47,0.426,25,0.532,6,2,0.75,1,2,29,18,12,15,20,0.255,0.319,0.426,17.559,42,riffle_perfect
0,17,18,8,43,0.395,25,0.581,4,0,1.0,2,2,24,19,11,14,18,0.256,0.326,0.419,17.562,43,riffle_perfect
0,15,26,4,45,0.333,19,0.422,2,3,0.4,2,2,28,17,12,14,19,0.267,0.311,0.422,17.56,44,riffle_perfect
0,17,23,6,46,0.37,23,0.5,1,2,0.333,0,4,29,17,12,13,21,0.261,0.283,0.457,17.583,45,riffle_perfect
0,17,25,4,46,0.37,21,0.457,2,0,1.0,1,2,28,18,9,12,25,0.196,0.261,0.543,17.574,46,riffle_perfect
0,24,18,3,45,0.533,27,0.6,3,2,0.6,2,4,25,20,15,10,20,0.333,0.222,0.444,17.578,47,riffle_perfect
0,24,19,4,47,0.511,28,0.596,3,0,1.0,3,0,34,13,12,15,20,0.255,0.319,0.426,17.583,48,riffle_perfect
0,21,21,2,44,0.477,23,0.523,4,0,1.0,0,5,26,18,14,11,19,0.318,0.25,0.432,17.58,49,riffle_perfect
0,24,17,4,45,0.533,28,0.622,4,2,0.667,3,3,24,21,9,16,20,0.2,0.356,0.444,17.571,50,riffle_perfect
0,23,18,5,46,0.5,28,0.609,2,2,0.5,1,3,23,23,14,13,19,0.304,0.283,0.413,17.574,51,riffle_perfect
0,21,21,4,46,0.457,25,0.543,1,1,0.5,2,3,27,19,14,11,21,0.304,0.239,0.457,17.574,52,riffle_perfect
0,20,23,3,46,0.435,23,0.5,3,2,0.6,0,2,30,16,12,14,20,0.261,0.304,0.435,17.58,53,riffle_perfect
0,17,24,5,46,0.37,22,0.478,3,2,0.6,1,4,25,21,10,14,22,0.217,0.304,0.478,17.59,54,riffle_perfect
0,18,20,5,43,0.419,23,0.535,2,4,0.333,1,2,28,15,7,16,20,0.163,0.372,0.465,17.602,55,riffle_perfect
0,22,18,4,44,0.5,26,0.591,2,2,0.5,3,1,23,21,12,16,16,0.273,0.364,0.364,17.594,56,riffle_perfect
0,18,21,6,45,0.4,24,0.533,0,2,0.0,2,2,27,18,7,17,21,0.156,0.378,0.467,17.6,57,riffle_perfect
0,23,20,2,45,0.511,25,0.556,3,5,0.375,3,2,26,19,8,14,23,0.178,0.311,0.511,17.605,58,riffle_perfect
0,17,25,3,45,0.378,20,0.444,2,1,0.667,0,4,26,19,10,14,21,0.222,0.311,0.467,17.611,59,riffle_perfect
0,17,24,8,49,0.347,25,0.51,2,6,0.25,3,2,33,16,7,20,22,0.143,0.408,0.449,17.624,60,riffle_perfect
0,16,26,4,46,0.348,20,0.435,1,0,1.0,0,4,29,17,6,15,25,0.13,0.326,0.543,17.63,61,riffle_perfect
0,22,20,4,46,0.478,26,0.565,3,2,0.6,2,2,29,17,13,11,22,0.283,0.239,0.478,17.632,62,riffle_perfect
0,19,22,5,46,0.413,24,0.522,5,3,0.625,0,0,20,26,9,23,14,0.196,0.5,0.304,17.64,63,riffle_perfect
0,23,17,3,43,0.535,26,0.605,6,1,0.857,1,1,24,19,13,14,16,0.302,0.326,0.372,17.655,64,riffle_perfect
0,20,26,1,47,0.426,21,0.447,2,4,0.333,2,2,22,25,11,16,20,0.234,0.34,0.426,17.647,65,riffle_perfect
0,20,18,4,42,0.476,24,0.571,6,3,0.667,1,0,26,16,14,10,18,0.333,0.238,0.429,17.648,66,riffle_perfect
0,24,16,4,44,0.545,28,0.636,1,3,0.25,3,3,30,14,16,10,18,0.364,0.227,0.409,17.645,67,riffle_perfect
0,20,19,8,47,0.426,28,0.596,2,1,0.667,4,1,30,17,7,16,24,0.149,0.34,0.511,17.639,68,riffle_perfect
0,25,20,2,47,0.532,27,0.574,3,2,0.6,0,2,26,21,14,17,16,0.298,0.362,0.34,17.648,69,riffle_perfect
0,16,24,4,44,0.364,20,0.455,5,2,0.714,3,3,27,17,9,15,20,0.205,0.341,0.455,17.654,70,riffle_perfect
0,21,20,4,45,0.467,25,0.556,1,0,1.0,2,2,31,14,11,13,21,0.244,0.289,0.467,17.656,71,riffle_perfect
0,20,23,5,48,0.417,25,0.521,7,3,0.7,0,1,26,22,11,20,17,0.229,0.417,0.354,17.665,72,riffle_perfect
0,21,20,3,44,0.477,24,0.545,1,3,0.25,1,0,22,22,13,15,16,0.295,0.341,0.364,17.673,73,riffle_perfect
0,20,21,3,44,0.455,23,0.523,5,3,0.625,2,1,24,20,11,14,19,0.25,0.318,0.432,17.685,74,riffle_perfect
0,16,24,3,43,0.372,19,0.442,3,1,0.75,2,1,22,21,9,18,16,0.209,0.419,0.372,17.683,75,riffle_perfect
0,17,28,2,47,0.362,19,0.404,7,3,0.7,1,1,33,14,10,8,29,0.213,0.17,0.617,17.683,76,riffle_perfect
0,19,20,5,44,0.432,24,0.545,5,2,0.714,2,2,20,24,12,15,17,0.273,0.341,0.386,17.691,77,riffle_perfect
0,22,19,4,45,0.489,26,0.578,2,2,0.5,1,3,28,17,13,15,17,0.289,0.333,0.378,17.688,78,riffle_perfect
0,17,24,3,44,0.386,20,0.455,4,1,0.8,1,3,30,14,12,9,23,0.273,0.205,0.523,17.685,79,riffle_perfect
0,19,21,6,46,0.413,25,0.543,3,4,0.429,5,2,32,14,8,11,27,0.174,0.239,0.587,17.683,80,riffle_perfect
0,18,22,5,45,0.4,23,0.511,3,1,0.75,0,3,33,12,11,10,24,0.244,0.222,0.533,17.691,81,riffle_perfect
0,20,23,2,45,0.444,22,0.489,1,1,0.5,3,2,26,19,10,13,22,0.222,0.289,0.489,17.685,82,riffle_perfect
0,17,25,5,47,0.362,22,0.468,3,3,0.5,3,4,25,22,8,21,18,0.17,0.447,0.383,17.691,83,riffle_perfect
0,22,23,3,48,0.458,25,0.521,5,3,0.625,5,2,33,15,12,9,27,0.25,0.188,0.562,17.679,84,riffle_perfect
0,20,19,4,43,0.465,24,0.558,1,4,0.2,1,2,23,20,15,13,15,0.349,0.302,0.349,17.681,85,riffle_perfect
0,21,19,3,43,0.488,24,0.558,2,4,0.333,2,1,25,18,10,15,18,0.233,0.349,0.419,17.675,86,riffle_perfect
0,18,24,2,44,0.409,20,0.455,4,1,0.8,4,2,28,16,8,11,25,0.182,0.25,0.568,17.672,87,riffle_perfect
0,18,24,2,44,0.409,20,0.455,2,2,0.5,3,0,26,18,7,14,23,0.159,0.318,0.523,17.664,88,riffle_perfect
0,28,13,5,46,0.609,33,0.717,1,1,0.5,2,0,29,17,16,12,18,0.348,0.261,0.391,17.662,89,riffle_perfect
0,22,20,2,44,0.5,24,0.545,3,1,0.75,4,0,31,13,10,10,24,0.227,0.227,0.545,17.659,90,riffle_perfect
0,22,19,5,46,0.478,27,0.587,3,5,0.375,3,3,30,16,13,14,19,0.283,0.304,0.413,17.668,91,riffle_perfect
0,18,23,3,44,0.409,21,0.477,4,1,0.8,4,2,35,9,7,9,28,0.159,0.205,0.636,17.669,92,riffle_perfect
0,23,22,0,45,0.511,23,0.511,2,3,0.4,4,1,25,20,12,13,20,0.267,0.289,0.444,17.666,93,riffle_perfect
0,23,18,4,45,0.511,27,0.6,3,3,0.5,0,0,20,25,13,15,17,0.289,0.333,0.378,17.676,94,riffle_perfect
0,19,18,6,43,0.442,25,0.581,1,1,0.5,0,4,27,16,13,12,18,0.302,0.279,0.419,17.672,95,riffle_perfect
0,25,17,2,44,0.568,27,0.614,6,2,0.75,1,2,26,18,12,13,19,0.273,0.295,0.432,17.672,96,riffle_perfect
0,17,24,5,46,0.37,22,0.478,3,3,0.5,1,3,30,16,7,13,26,0.152,0.283,0.565,18.412,1,riffle_perfect
0,21,23,3,47,0.447,24,0.511,3,2,0.6,1,6,31,16,15,9,23,0.319,0.191,0.489,17.965,2,riffle_perfect
0,17,27,1,45,0.378,18,0.4,1,1,0.5,2,3,32,13,9,12,24,0.2,0.267,0.533,17.54,3,riffle_perfect
0,20,22,4,46,0.435,24,0.522,2,1,0.667,2,4,31,15,10,13,23,0.217,0.283,0.5,17.47,4,riffle_perfect
0,23,14,6,43,0.535,29,0.674,6,0,1.0,2,3,27,16,13,12,18,0.302,0.279,0.419,17.514,5,riffle_perfect
0,26,14,5,45,0.578,31,0.689,7,2,0.778,6,0,27,18,10,14,21,0.222,0.311,0.467,17.457,6,riffle_perfect
0,21,18,6,45,0.467,27,0.6,5,2,0.714,1,3,30,15,13,14,18,0.289,0.311,0.4,17.554,7,riffle_perfect
0,21,21,6,48,0.438,27,0.562,5,7,0.417,2,2,29,19,9,18,21,0.188,0.375,0.438,17.506,8,riffle_perfect
0,17,24,3,44,0.386,20,0.455,2,3,0.4,3,2,27,17,9,15,20,0.205,0.341,0.455,17.517,9,riffle_perfect
0,20,25,3,48,0.417,23,0.479,3,1,0.75,2,3,32,16,11,14,23,0.229,0.292,0.479,17.43,10,riffle_perfect
0,20,23,2,45,0.444,22,0.489,4,1,0.8,5,0,30,15,8,13,24,0.178,0.289,0.533,17.376,11,riffle_perfect
0,20,25,3,48,0.417,23,0.479,4,5,0.444,2,3,28,20,9,16,23,0.188,0.333,0.479,17.443,12,riffle_perfect
0,19,27,2,48,0.396,21,0.438,3,1,0.75,1,5,27,21,9,19,20,0.188,0.396,0.417,17.455,13,riffle_perfect
0,23,14,6,43,0.535,29,0.674,2,0,1.0,1,1,28,15,16,11,16,0.372,0.256,0.372,17.442,14,riffle_perfect
0,25,15,4,44,0.568,29,0.659,3,1,0.75,1,1,24,20,20,9,15,0.455,0.205,0.341,17.495,15,riffle_perfect
0,23,20,0,43,0.535,23,0.535,4,3,0.571,3,1,24,19,10,17,16,0.233,0.395,0.372,17.525,16,riffle_perfect
0,25,15,2,42,0.595,27,0.643,4,3,0.571,0,1,30,12,14,11,17,0.333,0.262,0.405,17.555,17,riffle_perfect
0,18,22,6,46,0.391,24,0.522,4,3,0.571,5,3,27,19,9,12,25,0.196,0.261,0.543,17.565,18,riffle_perfect
0,22,21,3,46,0.478,25,0.543,4,1,0.8,2,4,30,16,12,12,22,0.261,0.261,0.478,17.532,19,riffle_perfect
0,19,23,5,47,0.404,24,0.511,2,2,0.5,5,3,37,10,9,11,27,0.191,0.234,0.574,17.535,20,riffle_perfect
0,17,21,6,44,0.386,23,0.523,2,1,0.667,0,2,24,20,6,20,18,0.136,0.455,0.409,17.55,21,riffle_perfect
0,15,23,6,44,0.341,21,0.477,5,0,1.0,2,4,32,12,6,15,23,0.136,0.341,0.523,17.56,22,riffle_perfect
0,17,25,5,47,0.362,22,0.468,3,3,0.5,1,2,27,20,11,13,23,0.234,0.277,0.489,17.558,23,riffle_perfect
0,19,25,4,48,0.396,23,0.479,3,1,0.75,3,3,30,18,9,20,19,0.188,0.417,0.396,17.56,24,riffle_perfect
0,23,20,3,46,0.5,26,0.565,1,0,1.0,4,4,30,16,6,15,25,0.13,0.326,0.543,17.582,25,riffle_perfect
0,15,24,6,45,0.333,21,0.467,1,1,0.5,2,5,31,14,7,12,26,0.156,0.267,0.578,17.568,26,riffle_perfect
0,27,17,2,46,0.587,29,0.63,3,3,0.5,6,2,29,17,13,9,24,0.283,0.196,0.522,17.57,27,riffle_perfect
0,21,19,4,44,0.477,25,0.568,4,1,0.8,0,2,27,17,17,13,14,0.386,0.295,0.318,17.579,28,riffle_perfect
0,14,27,3,44,0.318,17,0.386,4,2,0.667,0,2,25,19,13,12,19,0.295,0.273,0.432,17.583,29,riffle_perfect
0,18,24,3,45,0.4,21,0.467,1,3,0.25,0,1,28,17,9,15,21,0.2,0.333,0.467,17.603,30,riffle_perfect
0,28,14,4,46,0.609,32,0.696,5,2,0.714,5,1,29,17,12,13,21,0.261,0.283,0.457,17.62,31,riffle_perfect
0,20,23,4,47,0.426,24,0.511,1,2,0.333,2,4,28,19,12,18,17,0.255,0.383,0.362,17.61,32,riffle_perfect
0,16,25,3,44,0.364,19,0.432,3,4,0.429,2,3,28,16,9,11,24,0.205,0.25,0.545,17.63,33,riffle_perfect
0,20,21,4,45,0.444,24,0.533,7,3,0.7,2,3,21,24,11,15,19,0.244,0.333,0.422,17.607,34,riffle_perfect
0,27,15,4,46,0.587,31,0.674,4,1,0.8,1,1,33,13,16,12,18,0.348,0.261,0.391,17.617,35,riffle_perfect
0,17,21,5,43,0.395,22,0.512,0,2,0.0,4,0,30,13,4,13,26,0.093,0.302,0.605,17.632,36,riffle_perfect
0,19,23,3,45,0.422,22,0.489,0,2,0.0,3,2,26,19,7,18,20,0.156,0.4,0.444,17.626,37,riffle_perfect
0,19,23,3,45,0.422,22,0.489,2,1,0.667,1,3,28,17,12,11,22,0.267,0.244,0.489,17.603,38,riffle_perfect
0,20,25,2,47,0.426,22,0.468,2,1,0.667,5,1,28,19,6,18,23,0.128,0.383,0.489,17.593,39,riffle_perfect
0,17,26,5,48,0.354,22,0.458,1,4,0.2,3,4,33,15,5,15,28,0.104,0.312,0.583,17.578,40,riffle_perfect
0,19,23,4,46,0.413,23,0.5,2,1,0.667,3,3,34,12,8,10,28,0.174,0.217,0.609,17.598,41,riffle_perfect
0,24,18,4,46,0.522,28,0.609,3,2,0.6,3,3,27,19,13,11,22,0.283,0.239,0.478,17.589,42,riffle_perfect
0,16,26,3,45,0.356,19,0.422,3,1,0.75,2,4,31,14,10,12,23,0.222,0.267,0.511,17.589,43,riffle_perfect
0,21,21,4,46,0.457,25,0.543,4,5,0.444,4,2,30,16,12,10,24,0.261,0.217,0.522,17.584,44,riffle_perfect
0,20,19,4,43,0.465,24,0.558,3,4,0.429,2,2,27,16,16,9,18,0.372,0.209,0.419,17.59,45,riffle_perfect
0,16,26,5,47,0.34,21,0.447,3,0,1.0,3,4,31,16,6,13,28,0.128,0.277,0.596,17.588,46,riffle_perfect
0,22,20,2,44,0.5,24,0.545,4,0,1.0,0,4,28,16,14,8,22,0.318,0.182,0.5,17.593,47,riffle_perfect
0,23,15,7,45,0.511,30,0.667,0,0,0,3,1,31,14,14,12,19,0.311,0.267,0.422,17.594,48,riffle_perfect
0,16,29,4,49,0.327,20,0.408,1,1,0.5,2,4,28,21,10,17,22,0.204,0.347,0.449,17.605,49,riffle_perfect
0,11,27,7,45,0.244,18,0.4,1,0,1.0,2,1,30,15,5,17,23,0.111,0.378,0.511,17.606,50,riffle_perfect
0,20,25,3,48,0.417,23,0.479,3,2,0.6,4,2,28,20,10,11,27,0.208,0.229,0.562,17.587,51,riffle_perfect
0,16,20,6,42,0.381,22,0.524,3,1,0.75,0,0,28,14,10,13,19,0.238,0.31,0.452,17.576,52,riffle_perfect
0,28,20,0,48,0.583,28,0.583,10,3,0.769,2,0,22,26,18,13,17,0.375,0.271,0.354,17.583,53,riffle_perfect
0,17,22,4,43,0.395,21,0.488,2,1,0.667,2,3,30,13,10,9,24,0.233,0.209,0.558,17.589,54,riffle_perfect
0,19,23,5,47,0.404,24,0.511,2,2,0.5,3,1,30,17,8,17,22,0.17,0.362,0.468,17.579,55,riffle_perfect
0,17,20,9,46,0.37,26,0.565,2,1,0.667,1,1,33,13,6,16,24,0.13,0.348,0.522,17.59,56,riffle_perfect
0,26,18,3,47,0.553,29,0.617,3,0,1.0,0,2,26,21,19,8,20,0.404,0.17,0.426,17.583,57,riffle_perfect
0,21,21,2,44,0.477,23,0.523,4,1,0.8,4,1,27,17,11,8,25,0.25,0.182,0.568,17.573,58,riffle_perfect
0,20,24,4,48,0.417,24,0.5,2,2,0.5,3,2,28,20,11,12,25,0.229,0.25,0.521,17.563,59,riffle_perfect
0,17,25,5,47,0.362,22,0.468,5,3,0.625,3,1,27,20,9,15,23,0.191,0.319,0.489,17.566,60,riffle_perfect
0,24,18,4,46,0.522,28,0.609,4,1,0.8,1,0,29,17,13,11,22,0.283,0.239,0.478,17.567,61,riffle_perfect
0,19,22,5,46,0.413,24,0.522,4,2,0.667,4,2,31,15,10,12,24,0.217,0.261,0.522,17.57,62,riffle_perfect
0,24,18,1,43,0.558,25,0.581,3,4,0.429,2,2,27,16,13,8,22,0.302,0.186,0.512,17.566,63,riffle_perfect
0,21,18,6,45,0.467,27,0.6,2,1,0.667,2,2,25,20,11,13,21,0.244,0.289,0.467,17.564,64,riffle_perfect
0,18,24,3,45,0.4,21,0.467,1,4,0.2,2,3,34,11,10,11,24,0.222,0.244,0.533,17.573,65,riffle_perfect
0,17,29,4,50,0.34,21,0.42,5,1,0.833,2,2,30,20,10,13,27,0.2,0.26,0.54,17.559,66,riffle_perfect
0,23,16,4,43,0.535,27,0.628,4,0,1.0,1,2,28,15,10,14,19,0.233,0.326,0.442,17.568,67,riffle_perfect
0,17,23,3,43,0.395,20,0.465,6,3,0.667,2,3,30,13,11,12,20,0.256,0.279,0.465,17.555,68,riffle_perfect
0,21,23,3,47,0.447,24,0.511,5,0,1.0,1,3,32,15,12,15,20,0.255,0.319,0.426,17.554,69,riffle_perfect
0,16,28,4,48,0.333,20,0.417,3,1,0.75,2,5,36,12,6,10,32,0.125,0.208,0.667,17.555,70,riffle_perfect
0,19,22,4,45,0.422,23,0.511,0,4,0.0,1,5,29,16,13,15,17,0.289,0.333,0.378,17.554,71,riffle_perfect
0,21,22,3,46,0.457,24,0.522,1,2,0.333,1,1,29,17,11,12,23,0.239,0.261,0.5,17.558,72,riffle_perfect
0,20,21,4,45,0.444,24,0.533,4,3,0.571,0,0,26,19,13,13,19,0.289,0.289,0.422,17.559,73,riffle_perfect
0,19,21,5,45,0.422,24,0.533,2,2,0.5,0,2,29,16,9,19,17,0.2,0.422,0.378,17.572,74,riffle_perfect
0,27,18,1,46,0.587,28,0.609,4,6,0.4,0,0,25,21,12,14,20,0.261,0.304,0.435,17.574,75,riffle_perfect
0,20,23,3,46,0.435,23,0.5,3,2,0.6,4,3,27,19,10,14,22,0.217,0.304,0.478,17.571,76,riffle_perfect
0,21,22,1,44,0.477,22,0.5,3,4,0.429,0,4,26,18,8,18,18,0.182,0.409,0.409,17.585,77,riffle_perfect
0,22,19,4,45,0.489,26,0.578,5,2,0.714,2,3,31,14,14,10,21,0.311,0.222,0.467,17.591,78,riffle_perfect
0,18,25,1,44,0.409,19,0.432,4,6,0.4,2,1,26,18,6,16,22,0.136,0.364,0.5,17.596,79,riffle_perfect
0,19,22,6,47,0.404,25,0.532,0,1,0.0,0,1,25,22,11,19,17,0.234,0.404,0.362,17.593,80,riffle_perfect
0,21,19,4,44,0.477,25,0.568,5,1,0.833,2,1,29,15,10,12,22,0.227,0.273,0.5,17.577,81,riffle_perfect
0,24,15,5,44,0.545,29,0.659,5,0,1.0,3,0,21,23,15,15,14,0.341,0.341,0.318,17.575,82,riffle_perfect
0,15,28,3,46,0.326,18,0.391,4,5,0.444,1,1,25,21,8,20,18,0.174,0.435,0.391,17.586,83,riffle_perfect
0,17,23,4,44,0.386,21,0.477,2,3,0.4,0,3,26,18,10,15,19,0.227,0.341,0.432,17.586,84,riffle_perfect
0,23,23,1,47,0.489,24,0.511,1,3,0.25,3,0,32,15,10,18,19,0.213,0.383,0.404,17.575,85,riffle_perfect
0,17,24,3,44,0.386,20,0.455,2,2,0.5,0,0,29,15,11,11,22,0.25,0.25,0.5,17.587,86,riffle_perfect
0,26,17,2,45,0.578,28,0.622,6,1,0.857,4,3,27,18,11,11,23,0.244,0.244,0.511,17.582,87,riffle_perfect
0,19,24,4,47,0.404,23,0.489,4,2,0.667,2,3,29,18,11,10,26,0.234,0.213,0.553,17.58,88,riffle_perfect
0,18,21,4,43,0.419,22,0.512,3,2,0.6,1,1,25,18,10,18,15,0.233,0.419,0.349,17.586,89,riffle_perfect
0,26,18,4,48,0.542,30,0.625,5,1,0.833,1,1,27,21,13,15,20,0.271,0.312,0.417,17.591,90,riffle_perfect
0,16,26,5,47,0.34,21,0.447,2,0,1.0,2,4,31,16,9,15,23,0.191,0.319,0.489,17.601,91,riffle_perfect
0,19,24,1,44,0.432,20,0.455,2,2,0.5,2,4,25,19,10,16,18,0.227,0.364,0.409,17.607,92,riffle_perfect
0,24,21,1,46,0.522,25,0.543,4,2,0.667,3,2,28,18,16,9,21,0.348,0.196,0.457,17.603,93,riffle_perfect
0,19,20,4,43,0.442,23,0.535,4,0,1.0,1,2,32,11,9,14,20,0.209,0.326,0.465,17.602,94,riffle_perfect
0,21,23,1,45,0.467,22,0.489,4,2,0.667,3,2,27,18,11,14,20,0.244,0.311,0.444,17.602,95,riffle_perfect
0,19,21,3,43,0.442,22,0.512,2,2,0.5,3,1,32,11,7,13,23,0.163,0.302,0.535,17.608,96,riffle_perfect
0,21,22,2,45,0.467,23,0.511,2,4,0.333,1,1,30,15,11,12,22,0.244,0.267,0.489,18.276,1,riffle_perfect
0,15,28,2,45,0.333,17,0.378,5,1,0.833,1,4,29,16,11,11,23,0.244,0.244,0.511,18.228,2,riffle_perfect
0,17,22,3,42,0.405,20,0.476,3,3,0.5,1,3,28,14,7,17,18,0.167,0.405,0.429,18.233,3,riffle_perfect
0,25,19,4,48,0.521,29,0.604,4,3,0.571,2,1,25,23,17,13,18,0.354,0.271,0.375,17.982,4,riffle_perfect
0,18,30,1,49,0.367,19,0.388,2,3,0.4,5,3,29,20,8,13,28,0.163,0.265,0.571,17.932,5,riffle_perfect
0,19,22,6,47,0.404,25,0.532,4,4,0.5,1,2,30,17,8,14,25,0.17,0.298,0.532,17.939,6,riffle_perfect
0,17,23,5,45,0.378,22,0.489,1,1,0.5,2,4,32,13,11,10,24,0.244,0.222,0.533,17.861,7,riffle_perfect
0,21,22,2,45,0.467,23,0.511,4,1,0.8,0,3,30,15,9,13,23,0.2,0.289,0.511,17.908,8,riffle_perfect
0,13,32,3,48,0.271,16,0.333,0,8,0.0,2,3,30,18,6,17,25,0.125,0.354,0.521,17.882,9,riffle_perfect
0,12,29,3,44,0.273,15,0.341,0,5,0.0,1,1,36,8,5,11,28,0.114,0.25,0.636,17.857,10,riffle_perfect
0,22,21,4,47,0.468,26,0.553,2,2,0.5,2,0,23,24,12,20,15,0.255,0.426,0.319,17.879,11,riffle_perfect
0,24,18,3,45,0.533,27,0.6,4,0,1.0,1,0,26,19,14,14,17,0.311,0.311,0.378,17.907,12,riffle_perfect
0,16,24,5,45,0.356,21,0.467,3,2,0.6,3,2,27,18,8,14,23,0.178,0.311,0.511,17.889,13,riffle_perfect
0,27,18,0,45,0.6,27,0.6,4,1,0.8,2,3,26,19,17,13,15,0.378,0.289,0.333,17.888,14,riffle_perfect
0,15,25,4,44,0.341,19,0.432,5,3,0.625,2,1,31,13,7,13,24,0.159,0.295,0.545,17.925,15,riffle_perfect
0,16,23,6,45,0.356,22,0.489,1,0,1.0,2,1,32,13,8,15,22,0.178,0.333,0.489,17.913,16,riffle_perfect
0,28,15,3,46,0.609,31,0.674,6,1,0.857,3,2,28,18,18,9,19,0.391,0.196,0.413,17.859,17,riffle_perfect
0,22,21,3,46,0.478,25,0.543,0,2,0.0,3,4,32,14,11,12,23,0.239,0.261,0.5,17.855,18,riffle_perfect
0,18,22,3,43,0.419,21,0.488,2,1,0.667,2,0,26,17,9,17,17,0.209,0.395,0.395,17.816,19,riffle_perfect
0,20,19,4,43,0.465,24,0.558,3,3,0.5,2,3,27,16,10,14,19,0.233,0.326,0.442,17.824,20,riffle_perfect
0,22,15,8,45,0.489,30,0.667,6,3,0.667,1,3,27,18,10,15,20,0.222,0.333,0.444,17.836,21,riffle_perfect
0,17,23,2,42,0.405,19,0.452,6,3,0.667,0,1,27,15,8,14,20,0.19,0.333,0.476,17.822,22,riffle_perfect
0,17,27,5,49,0.347,22,0.449,1,3,0.25,3,3,32,17,8,15,26,0.163,0.306,0.531,17.777,23,riffle_perfect
0,18,25,3,46,0.391,21,0.457,0,2,0.0,1,1,29,17,7,16,23,0.152,0.348,0.5,17.77,24,riffle_perfect
0,18,22,4,44,0.409,22,0.5,2,3,0.4,2,1,26,18,13,15,16,0.295,0.341,0.364,17.759,25,riffle_perfect
0,21,24,3,48,0.438,24,0.5,4,0,1.0,5,0,31,17,7,13,28,0.146,0.271,0.583,17.779,26,riffle_perfect
0,22,19,5,46,0.478,27,0.587,3,1,0.75,6,1,25,21,9,13,24,0.196,0.283,0.522,17.77,27,riffle_perfect
0,19,26,2,47,0.404,21,0.447,1,2,0.333,2,1,24,23,12,17,18,0.255,0.362,0.383,17.771,28,riffle_perfect
0,25,16,3,44,0.568,28,0.636,2,3,0.4,2,2,25,19,13,13,18,0.295,0.295,0.409,17.76,29,riffle_perfect
0,18,20,6,44,0.409,24,0.545,1,3,0.25,2,1,25,19,8,17,19,0.182,0.386,0.432,17.76,30,riffle_perfect
0,25,21,3,49,0.51,28,0.571,2,1,0.667,4,2,24,25,14,14,21,0.286,0.286,0.429,17.729,31,riffle_perfect
0,19,22,5,46,0.413,24,0.522,5,2,0.714,3,3,27,19,5,14,27,0.109,0.304,0.587,17.732,32,riffle_perfect
0,17,22,6,45,0.378,23,0.511,4,0,1.0,1,2,29,16,9,16,20,0.2,0.356,0.444,17.702,33,riffle_perfect
0,17,23,6,46,0.37,23,0.5,1,0,1.0,4,5,31,15,8,10,28,0.174,0.217,0.609,17.674,34,riffle_perfect
0,23,21,6,50,0.46,29,0.58,5,5,0.5,2,0,29,21,14,17,19,0.28,0.34,0.38,17.677,35,riffle_perfect
0,21,21,6,48,0.438,27,0.562,2,3,0.4,2,2,31,17,8,18,22,0.167,0.375,0.458,17.69,36,riffle_perfect
0,21,22,2,45,0.467,23,0.511,4,1,0.8,3,1,26,19,13,15,17,0.289,0.333,0.378,17.684,37,riffle_perfect
0,18,24,4,46,0.391,22,0.478,4,3,0.571,2,2,26,20,9,15,22,0.196,0.326,0.478,17.677,38,riffle_perfect
0,23,20,4,47,0.489,27,0.574,2,0,1.0,3,4,33,14,12,12,23,0.255,0.255,0.489,17.68,39,riffle_perfect
0,19,29,2,50,0.38,21,0.42,3,2,0.6,2,1,29,21,13,18,19,0.26,0.36,0.38,17.679,40,riffle_perfect
0,20,22,2,44,0.455,22,0.5,2,2,0.5,3,3,25,19,10,15,19,0.227,0.341,0.432,17.659,41,riffle_perfect
0,17,28,1,46,0.37,18,0.391,3,1,0.75,2,3,29,17,8,17,21,0.174,0.37,0.457,17.654,42,riffle_perfect
0,20,23,2,45,0.444,22,0.489,2,0,1.0,5,2,23,22,8,17,20,0.178,0.378,0.444,17.639,43,riffle_perfect
0,14,26,5,45,0.311,19,0.422,1,3,0.25,2,3,27,18,6,18,21,0.133,0.4,0.467,17.634,44,riffle_perfect
0,26,17,2,45,0.578,28,0.622,3,4,0.429,3,0,23,22,15,12,18,0.333,0.267,0.4,17.64,45,riffle_perfect
0,20,22,3,45,0.444,23,0.511,2,4,0.333,5,4,25,20,7,15,23,0.156,0.333,0.511,17.632,46,riffle_perfect
0,21,24,1,46,0.457,22,0.478,3,2,0.6,2,5,29,17,13,7,26,0.283,0.152,0.565,17.631,47,riffle_perfect
0,24,18,3,45,0.533,27,0.6,3,3,0.5,1,1,19,26,18,15,12,0.4,0.333,0.267,17.631,48,riffle_perfect
0,15,27,3,45,0.333,18,0.4,6,2,0.75,2,3,26,19,9,14,22,0.2,0.311,0.489,17.629,49,riffle_perfect
0,24,19,1,44,0.545,25,0.568,6,1,0.857,2,3,28,16,13,12,19,0.295,0.273,0.432,17.634,50,riffle_perfect
0,22,22,2,46,0.478,24,0.522,3,5,0.375,1,3,28,18,15,14,17,0.326,0.304,0.37,17.642,51,riffle_perfect
0,26,24,1,51,0.51,27,0.529,1,1,0.5,1,1,21,30,13,19,19,0.255,0.373,0.373,17.638,52,riffle_perfect
0,18,25,5,48,0.375,23,0.479,2,3,0.4,1,3,29,19,8,16,24,0.167,0.333,0.5,17.648,53,riffle_perfect
0,18,28,2,48,0.375,20,0.417,3,4,0.429,2,3,26,22,10,17,21,0.208,0.354,0.438,17.632,54,riffle_perfect
0,21,20,7,48,0.438,28,0.583,3,1,0.75,5,1,28,20,9,12,27,0.188,0.25,0.562,17.615,55,riffle_perfect
0,24,17,3,44,0.545,27,0.614,3,3,0.5,1,3,26,18,11,12,21,0.25,0.273,0.477,17.617,56,riffle_perfect
0,17,21,6,44,0.386,23,0.523,2,3,0.4,4,0,31,13,6,17,21,0.136,0.386,0.477,17.612,57,riffle_perfect
0,15,27,3,45,0.333,18,0.4,2,2,0.5,1,3,33,12,8,11,26,0.178,0.244,0.578,17.614,58,riffle_perfect
0,25,14,3,42,0.595,28,0.667,2,3,0.4,1,0,26,16,16,11,15,0.381,0.262,0.357,17.622,59,riffle_perfect
0,17,24,4,45,0.378,21,0.467,0,2,0.0,2,3,33,12,5,14,26,0.111,0.311,0.578,17.628,60,riffle_perfect
0,19,23,3,45,0.422,22,0.489,1,1,0.5,4,1,33,12,5,12,28,0.111,0.267,0.622,17.607,61,riffle_perfect
0,28,17,2,47,0.596,30,0.638,3,2,0.6,2,2,30,17,13,12,22,0.277,0.255,0.468,17.613,62,riffle_perfect
0,18,23,8,49,0.367,26,0.531,1,4,0.2,3,4,26,23,7,22,20,0.143,0.449,0.408,17.616,63,riffle_perfect
0,22,21,3,46,0.478,25,0.543,4,5,0.444,1,2,29,17,11,15,20,0.239,0.326,0.435,17.622,64,riffle_perfect
0,12,31,5,48,0.25,17,0.354,5,4,0.556,3,5,32,16,7,15,26,0.146,0.312,0.542,17.629,65,riffle_perfect
0,17,28,3,48,0.354,20,0.417,2,4,0.333,7,3,25,23,6,16,26,0.125,0.333,0.542,17.614,66,riffle_perfect
0,21,22,1,44,0.477,22,0.5,4,1,0.8,2,3,30,14,8,15,21,0.182,0.341,0.477,17.606,67,riffle_perfect
0,21,18,7,46,0.457,28,0.609,3,1,0.75,4,4,26,20,9,17,20,0.196,0.37,0.435,17.607,68,riffle_perfect
0,17,26,6,49,0.347,23,0.469,2,4,0.333,2,5,30,19,11,13,25,0.224,0.265,0.51,17.614,69,riffle_perfect
0,13,23,9,45,0.289,22,0.489,1,2,0.333,3,3,30,15,7,16,22,0.156,0.356,0.489,17.617,70,riffle_perfect
0,27,14,5,46,0.587,32,0.696,5,0,1.0,3,1,24,22,15,17,14,0.326,0.37,0.304,17.623,71,riffle_perfect
0,17,27,3,47,0.362,20,0.426,1,1,0.5,1,4,31,16,8,11,28,0.17,0.234,0.596,17.622,72,riffle_perfect
0,18,23,3,44,0.409,21,0.477,4,2,0.667,1,1,31,13,7,14,23,0.159,0.318,0.523,17.635,73,riffle_perfect
0,21,20,6,47,0.447,27,0.574,3,1,0.75,1,2,28,19,11,14,22,0.234,0.298,0.468,17.633,74,riffle_perfect
0,25,18,4,47,0.532,29,0.617,3,3,0.5,3,2,29,18,13,11,23,0.277,0.234,0.489,17.63,75,riffle_perfect
0,15,26,4,45,0.333,19,0.422,3,1,0.75,2,3,30,15,8,12,25,0.178,0.267,0.556,17.629,76,riffle_perfect
0,22,22,0,44,0.5,22,0.5,4,2,0.667,0,2,27,17,15,11,18,0.341,0.25,0.409,17.625,77,riffle_perfect
0,23,16,4,43,0.535,27,0.628,8,1,0.889,0,0,27,16,15,14,14,0.349,0.326,0.326,17.627,78,riffle_perfect
0,12,25,8,45,0.267,20,0.444,1,2,0.333,0,4,33,12,6,12,27,0.133,0.267,0.6,17.629,79,riffle_perfect
0,16,23,6,45,0.356,22,0.489,4,3,0.571,1,2,27,18,9,17,19,0.2,0.378,0.422,17.629,80,riffle_perfect
0,20,22,3,45,0.444,23,0.511,4,2,0.667,2,4,30,15,10,13,22,0.222,0.289,0.489,17.616,81,riffle_perfect
0,19,21,7,47,0.404,26,0.553,5,3,0.625,2,3,25,22,8,19,20,0.17,0.404,0.426,17.62,82,riffle_perfect
0,17,22,7,46,0.37,24,0.522,4,3,0.571,4,4,28,18,11,12,23,0.239,0.261,0.5,17.624,83,riffle_perfect
0,19,23,2,44,0.432,21,0.477,3,0,1.0,3,1,27,17,11,12,21,0.25,0.273,0.477,17.606,84,riffle_perfect
0,20,22,2,44,0.455,22,0.5,4,4,0.5,4,3,29,15,8,17,19,0.182,0.386,0.432,17.603,85,riffle_perfect
0,20,20,5,45,0.444,25,0.556,4,2,0.667,3,2,27,18,10,13,22,0.222,0.289,0.489,17.606,86,riffle_perfect
0,21,22,5,48,0.438,26,0.542,2,1,0.667,4,3,29,19,10,15,23,0.208,0.312,0.479,17.602,87,riffle_perfect
0,14,29,2,45,0.311,16,0.356,1,4,0.2,1,1,26,19,7,16,22,0.156,0.356,0.489,17.608,88,riffle_perfect
0,18,23,3,44,0.409,21,0.477,1,2,0.333,1,3,25,19,6,17,21,0.136,0.386,0.477,17.616,89,riffle_perfect
0,18,20,7,45,0.4,25,0.556,2,3,0.4,3,2,21,24,11,16,18,0.244,0.356,0.4,17.621,90,riffle_perfect
0,20,22,4,46,0.435,24,0.522,3,4,0.429,5,1,27,19,10,14,22,0.217,0.304,0.478,17.619,91,riffle_perfect
0,24,17,3,44,0.545,27,0.614,0,2,0.0,3,1,30,14,13,8,23,0.295,0.182,0.523,17.619,92,riffle_perfect
0,22,16,5,43,0.512,27,0.628,4,3,0.571,1,0,25,18,9,15,19,0.209,0.349,0.442,17.618,93,riffle_perfect
0,24,19,2,45,0.533,26,0.578,3,0,1.0,4,1,28,17,7,15,23,0.156,0.333,0.511,17.62,94,riffle_perfect
0,24,16,5,45,0.533,29,0.644,2,0,1.0,2,5,30,15,12,14,19,0.267,0.311,0.422,17.623,95,riffle_perfect
0,23,21,2,46,0.5,25,0.543,5,1,0.833,4,1,21,25,10,21,15,0.217,0.457,0.326,17.623,96,riffle_perfect
0,18,21,8,47,0.383,26,0.553,3,4,0.429,4,0,30,17,8,17,22,0.17,0.362,0.468,17.865,1,riffle_perfect
0,22,21,2,45,0.489,24,0.533,3,5,0.375,3,1,27,18,12,12,21,0.267,0.267,0.467,17.701,2,riffle_perfect
0,22,21,6,49,0.449,28,0.571,1,2,0.333,5,0,31,18,10,10,29,0.204,0.204,0.592,17.612,3,riffle_perfect
0,19,22,5,46,0.413,24,0.522,1,4,0.2,7,1,25,21,6,18,22,0.13,0.391,0.478,17.555,4,riffle_perfect
0,20,20,4,44,0.455,24,0.545,6,0,1.0,1,1,27,17,8,14,22,0.182,0.318,0.5,17.518,5,riffle_perfect
0,25,16,4,45,0.556,29,0.644,2,3,0.4,5,2,30,15,13,8,24,0.289,0.178,0.533,17.5,6,riffle_perfect
0,19,22,7,48,0.396,26,0.542,3,2,0.6,3,1,24,24,9,17,22,0.188,0.354,0.458,17.446,7,riffle_perfect
0,20,21,4,45,0.444,24,0.533,5,6,0.455,2,4,29,16,11,13,21,0.244,0.289,0.467,17.521,8,riffle_perfect
0,13,21,11,45,0.289,24,0.533,4,1,0.8,3,2,28,17,6,20,19,0.133,0.444,0.422,17.505,9,riffle_perfect
0,22,18,3,43,0.512,25,0.581,1,3,0.25,2,1,22,21,11,18,14,0.256,0.419,0.326,17.511,10,riffle_perfect
0,20,17,7,44,0.455,27,0.614,4,5,0.444,0,0,22,22,13,16,15,0.295,0.364,0.341,17.562,11,riffle_perfect
0,21,19,7,47,0.447,28,0.596,1,3,0.25,2,2,30,17,15,13,19,0.319,0.277,0.404,17.562,12,riffle_perfect
0,17,26,2,45,0.378,19,0.422,4,4,0.5,2,5,26,19,8,15,22,0.178,0.333,0.489,17.576,13,riffle_perfect
0,23,17,6,46,0.5,29,0.63,3,2,0.6,1,1,32,14,8,15,23,0.174,0.326,0.5,17.585,14,riffle_perfect
0,18,27,4,49,0.367,22,0.449,3,3,0.5,2,1,40,9,7,14,28,0.143,0.286,0.571,17.613,15,riffle_perfect
0,24,19,3,46,0.522,27,0.587,2,1,0.667,3,1,27,19,15,14,17,0.326,0.304,0.37,17.595,16,riffle_perfect
0,21,17,6,44,0.477,27,0.614,2,2,0.5,1,4,26,18,15,14,15,0.341,0.318,0.341,17.62,17,riffle_perfect
0,17,22,7,46,0.37,24,0.522,5,4,0.556,4,1,27,19,7,16,23,0.152,0.348,0.5,17.598,18,riffle_perfect
0,20,23,4,47,0.426,24,0.511,2,3,0.4,5,2,24,23,7,18,22,0.149,0.383,0.468,17.63,19,riffle_perfect
0,18,23,5,46,0.391,23,0.5,2,4,0.333,2,1,28,18,7,15,24,0.152,0.326,0.522,17.656,20,riffle_perfect
0,19,24,3,46,0.413,22,0.478,6,1,0.857,2,0,28,18,7,18,21,0.152,0.391,0.457,17.614,21,riffle_perfect
0,22,21,3,46,0.478,25,0.543,3,2,0.6,1,1,28,18,13,12,21,0.283,0.261,0.457,17.603,22,riffle_perfect
0,19,19,4,42,0.452,23,0.548,3,1,0.75,2,2,25,17,12,14,16,0.286,0.333,0.381,17.634,23,riffle_perfect
0,20,17,7,44,0.455,27,0.614,3,3,0.5,5,2,26,18,9,15,20,0.205,0.341,0.455,17.653,24,riffle_perfect
0,17,25,5,47,0.362,22,0.468,2,0,1.0,3,4,30,17,9,11,27,0.191,0.234,0.574,17.629,25,riffle_perfect
0,20,19,6,45,0.444,26,0.578,3,3,0.5,2,2,27,18,9,12,24,0.2,0.267,0.533,17.636,26,riffle_perfect
0,25,19,3,47,0.532,28,0.596,5,2,0.714,2,2,29,18,13,13,21,0.277,0.277,0.447,17.637,27,riffle_perfect
0,18,23,5,46,0.391,23,0.5,2,1,0.667,1,3,25,21,9,17,20,0.196,0.37,0.435,17.665,28,riffle_perfect
0,25,17,1,43,0.581,26,0.605,2,1,0.667,1,1,23,20,16,10,17,0.372,0.233,0.395,17.667,29,riffle_perfect
0,17,26,4,47,0.362,21,0.447,1,2,0.333,2,4,32,15,12,14,21,0.255,0.298,0.447,17.648,30,riffle_perfect
0,24,19,3,46,0.522,27,0.587,4,3,0.571,2,2,27,19,16,11,19,0.348,0.239,0.413,17.656,31,riffle_perfect
0,22,22,2,46,0.478,24,0.522,5,0,1.0,0,0,26,20,11,16,19,0.239,0.348,0.413,17.641,32,riffle_perfect
0,22,24,2,48,0.458,24,0.5,3,2,0.6,3,3,35,13,11,11,26,0.229,0.229,0.542,17.611,33,riffle_perfect
0,21,24,0,45,0.467,21,0.467,2,2,0.5,2,5,29,16,13,12,20,0.289,0.267,0.444,17.61,34,riffle_perfect
0,17,22,5,44,0.386,22,0.5,4,3,0.571,1,2,31,13,10,13,21,0.227,0.295,0.477,17.613,35,riffle_perfect
0,21,21,4,46,0.457,25,0.543,4,1,0.8,4,4,18,28,13,17,16,0.283,0.37,0.348,17.607,36,riffle_perfect
0,18,24,3,45,0.4,21,0.467,0,2,0.0,1,4,27,18,12,12,21,0.267,0.267,0.467,17.617,37,riffle_perfect
0,22,24,1,47,0.468,23,0.489,0,3,0.0,2,0,29,18,6,22,19,0.128,0.468,0.404,17.628,38,riffle_perfect
0,21,21,2,44,0.477,23,0.523,4,0,1.0,1,2,31,13,10,13,21,0.227,0.295,0.477,17.636,39,riffle_perfect
0,20,20,5,45,0.444,25,0.556,7,2,0.778,1,1,26,19,6,17,22,0.133,0.378,0.489,17.63,40,riffle_perfect
0,19,21,6,46,0.413,25,0.543,3,2,0.6,4,0,32,14,9,11,26,0.196,0.239,0.565,17.628,41,riffle_perfect
0,20,23,2,45,0.444,22,0.489,5,3,0.625,5,2,22,23,10,17,18,0.222,0.378,0.4,17.619,42,riffle_perfect
0,28,20,1,49,0.571,29,0.592,7,2,0.778,2,2,24,25,20,12,17,0.408,0.245,0.347,17.617,43,riffle_perfect
0,22,18,4,44,0.5,26,0.591,3,2,0.6,2,3,29,15,11,10,23,0.25,0.227,0.523,17.614,44,riffle_perfect
0,17,24,4,45,0.378,21,0.467,1,1,0.5,1,2,28,17,11,15,19,0.244,0.333,0.422,17.607,45,riffle_perfect
0,16,24,5,45,0.356,21,0.467,1,2,0.333,1,4,28,17,7,15,23,0.156,0.333,0.511,17.618,46,riffle_perfect
0,18,26,2,46,0.391,20,0.435,4,4,0.5,1,3,22,24,11,16,19,0.239,0.348,0.413,17.613,47,riffle_perfect
0,20,25,2,47,0.426,22,0.468,2,2,0.5,1,2,27,20,9,19,19,0.191,0.404,0.404,17.613,48,riffle_perfect
0,14,29,3,46,0.304,17,0.37,2,4,0.333,2,0,31,15,6,17,23,0.13,0.37,0.5,17.626,49,riffle_perfect
0,19,20,4,43,0.442,23,0.535,3,2,0.6,2,0,24,19,12,12,19,0.279,0.279,0.442,17.64,50,riffle_perfect
0,21,19,4,44,0.477,25,0.568,2,1,0.667,1,0,22,22,12,18,14,0.273,0.409,0.318,17.642,51,riffle_perfect
0,17,21,6,44,0.386,23,0.523,1,2,0.333,1,2,23,21,10,15,19,0.227,0.341,0.432,17.633,52,riffle_perfect
0,18,23,2,43,0.419,20,0.465,1,1,0.5,0,0,30,13,11,14,18,0.256,0.326,0.419,17.633,53,riffle_perfect
0,13,26,5,44,0.295,18,0.409,4,2,0.667,2,1,26,18,6,16,22,0.136,0.364,0.5,17.634,54,riffle_perfect
0,23,19,5,47,0.489,28,0.596,6,2,0.75,4,0,35,12,11,15,21,0.234,0.319,0.447,17.629,55,riffle_perfect
0,22,18,6,46,0.478,28,0.609,5,3,0.625,3,4,26,20,8,14,24,0.174,0.304,0.522,17.624,56,riffle_perfect
0,28,16,3,47,0.596,31,0.66,7,2,0.778,4,1,24,23,20,8,19,0.426,0.17,0.404,17.605,57,riffle_perfect
0,21,21,5,47,0.447,26,0.553,5,5,0.5,1,2,23,24,11,19,17,0.234,0.404,0.362,17.612,58,riffle_perfect
0,15,26,2,43,0.349,17,0.395,4,1,0.8,3,0,30,13,8,14,21,0.186,0.326,0.488,17.604,59,riffle_perfect
0,20,20,8,48,0.417,28,0.583,0,2,0.0,3,1,32,16,11,15,22,0.229,0.312,0.458,17.607,60,riffle_perfect
0,14,26,5,45,0.311,19,0.422,1,3,0.25,1,2,33,12,9,11,25,0.2,0.244,0.556,17.61,61,riffle_perfect
0,13,25,5,43,0.302,18,0.419,4,4,0.5,2,1,26,17,9,12,22,0.209,0.279,0.512,17.613,62,riffle_perfect
0,26,18,1,45,0.578,27,0.6,4,1,0.8,3,5,28,17,15,7,23,0.333,0.156,0.511,17.601,63,riffle_perfect
0,15,27,3,45,0.333,18,0.4,3,4,0.429,4,5,37,8,6,11,28,0.133,0.244,0.622,17.598,64,riffle_perfect
0,14,28,4,46,0.304,18,0.391,2,2,0.5,2,3,28,18,8,11,27,0.174,0.239,0.587,17.596,65,riffle_perfect
0,19,25,3,47,0.404,22,0.468,0,4,0.0,1,3,26,21,9,17,21,0.191,0.362,0.447,17.601,66,riffle_perfect
0,18,20,5,43,0.419,23,0.535,2,1,0.667,2,3,31,12,8,15,20,0.186,0.349,0.465,17.605,67,riffle_perfect
0,26,20,1,47,0.553,27,0.574,6,0,1.0,6,6,30,17,13,11,23,0.277,0.234,0.489,17.6,68,riffle_perfect
0,23,25,0,48,0.479,23,0.479,6,4,0.6,2,3,23,25,18,15,15,0.375,0.312,0.312,17.611,69,riffle_perfect
0,17,24,7,48,0.354,24,0.5,1,1,0.5,3,0,24,24,8,25,15,0.167,0.521,0.312,17.629,70,riffle_perfect
0,18,25,3,46,0.391,21,0.457,5,3,0.625,2,4,28,18,8,13,25,0.174,0.283,0.543,17.627,71,riffle_perfect
0,26,16,5,47,0.553,31,0.66,3,4,0.429,4,1,28,19,14,12,21,0.298,0.255,0.447,17.623,72,riffle_perfect
0,21,25,2,48,0.438,23,0.479,3,2,0.6,2,3,30,18,13,9,26,0.271,0.188,0.542,17.627,73,riffle_perfect
0,22,22,2,46,0.478,24,0.522,6,2,0.75,2,3,24,22,11,16,19,0.239,0.348,0.413,17.62,74,riffle_perfect
0,18,27,3,48,0.375,21,0.438,6,1,0.857,2,3,28,20,13,11,24,0.271,0.229,0.5,17.61,75,riffle_perfect
0,19,23,4,46,0.413,23,0.5,2,0,1.0,2,1,26,20,12,13,21,0.261,0.283,0.457,17.616,76,riffle_perfect
0,15,26,6,47,0.319,21,0.447,1,3,0.25,2,4,24,23,11,17,19,0.234,0.362,0.404,17.615,77,riffle_perfect
0,17,21,6,44,0.386,23,0.523,3,4,0.429,2,3,35,9,8,15,21,0.182,0.341,0.477,17.613,78,riffle_perfect
0,19,25,2,46,0.413,21,0.457,2,3,0.4,5,3,32,14,8,13,25,0.174,0.283,0.543,17.613,79,riffle_perfect
0,17,19,8,44,0.386,25,0.568,1,1,0.5,2,2,30,14,8,15,21,0.182,0.341,0.477,17.616,80,riffle_perfect
0,21,24,2,47,0.447,23,0.489,4,2,0.667,2,3,29,18,12,13,22,0.255,0.277,0.468,17.611,81,riffle_perfect
0,15,28,6,49,0.306,21,0.429,0,1,0.0,4,2,28,21,3,20,26,0.061,0.408,0.531,17.604,82,riffle_perfect
0,17,24,3,44,0.386,20,0.455,2,3,0.4,1,4,29,15,7,18,19,0.159,0.409,0.432,17.594,83,riffle_perfect
0,27,19,4,50,0.54,31,0.62,4,2,0.667,1,2,28,22,15,14,21,0.3,0.28,0.42,17.597,84,riffle_perfect
0,20,19,6,45,0.444,26,0.578,4,1,0.8,2,2,27,18,12,15,18,0.267,0.333,0.4,17.601,85,riffle_perfect
0,20,20,7,47,0.426,27,0.574,3,2,0.6,0,4,26,21,12,15,20,0.255,0.319,0.426,17.598,86,riffle_perfect
0,17,24,3,44,0.386,20,0.455,4,3,0.571,1,2,30,14,5,17,22,0.114,0.386,0.5,17.596,87,riffle_perfect
0,30,11,6,47,0.638,36,0.766,4,0,1.0,3,0,37,10,11,14,22,0.234,0.298,0.468,17.601,88,riffle_perfect
0,16,22,6,44,0.364,22,0.5,1,5,0.167,0,0,24,20,9,17,18,0.205,0.386,0.409,17.61,89,riffle_perfect
0,27,15,2,44,0.614,29,0.659,4,3,0.571,3,3,28,16,15,15,14,0.341,0.341,0.318,17.609,90,riffle_perfect
0,14,26,4,44,0.318,18,0.409,4,1,0.8,1,2,28,16,7,18,19,0.159,0.409,0.432,17.61,91,riffle_perfect
0,24,19,4,47,0.511,28,0.596,4,6,0.4,3,2,29,18,10,20,17,0.213,0.426,0.362,17.612,92,riffle_perfect
0,24,17,5,46,0.522,29,0.63,5,2,0.714,1,0,23,23,17,12,17,0.37,0.261,0.37,17.614,93,riffle_perfect
0,16,22,7,45,0.356,23,0.511,2,4,0.333,0,4,29,16,11,12,22,0.244,0.267,0.489,17.625,94,riffle_perfect
0,23,20,4,47,0.489,27,0.574,2,5,0.286,2,3,30,17,11,11,25,0.234,0.234,0.532,17.617,95,riffle_perfect
0,16,25,7,48,0.333,23,0.479,0,1,0.0,2,4,29,19,9,17,22,0.188,0.354,0.458,17.615,96,riffle_perfect
0,24,18,2,44,0.545,26,0.591,4,2,0.667,1,2,26,18,14,13,17,0.318,0.295,0.386,17.346,1,riffle_perfect
0,19,18,7,44,0.432,26,0.591,2,2,0.5,1,2,28,16,9,16,19,0.205,0.364,0.432,17.879,2,riffle_perfect
0,23,21,2,46,0.5,25,0.543,4,1,0.8,5,3,25,21,10,15,21,0.217,0.326,0.457,17.575,3,riffle_perfect
0,23,16,5,44,0.523,28,0.636,3,1,0.75,0,2,25,19,16,13,15,0.364,0.295,0.341,17.67,4,riffle_perfect
0,17,26,3,46,0.37,20,0.435,2,3,0.4,0,3,28,18,9,15,22,0.196,0.326,0.478,17.763,5,riffle_perfect
0,22,18,5,45,0.489,27,0.6,4,2,0.667,4,3,28,17,13,11,21,0.289,0.244,0.467,17.754,6,riffle_perfect
0,18,23,5,46,0.391,23,0.5,1,1,0.5,3,1,26,20,10,17,19,0.217,0.37,0.413,17.739,7,riffle_perfect
0,16,23,5,44,0.364,21,0.477,3,0,1.0,1,1,28,16,8,20,16,0.182,0.455,0.364,17.737,8,riffle_perfect
0,20,24,3,47,0.426,23,0.489,3,5,0.375,1,2,32,15,8,12,27,0.17,0.255,0.574,17.797,9,riffle_perfect
0,15,26,2,43,0.349,17,0.395,2,2,0.5,0,3,31,12,10,11,22,0.233,0.256,0.512,17.903,10,riffle_perfect
0,22,20,3,45,0.489,25,0.556,1,1,0.5,6,3,30,15,10,13,22,0.222,0.289,0.489,17.791,11,riffle_perfect
0,20,20,5,45,0.444,25,0.556,6,1,0.857,0,1,25,20,12,16,17,0.267,0.356,0.378,17.809,12,riffle_perfect
0,16,27,3,46,0.348,19,0.413,3,4,0.429,2,1,31,15,7,12,27,0.152,0.261,0.587,17.757,13,riffle_perfect
0,20,25,4,49,0.408,24,0.49,0,3,0.0,3,4,29,20,11,16,22,0.224,0.327,0.449,17.694,14,riffle_perfect
0,17,23,7,47,0.362,24,0.511,0,1,0.0,1,2,28,19,7,19,21,0.149,0.404,0.447,17.694,15,riffle_perfect
0,21,20,5,46,0.457,26,0.565,2,1,0.667,4,3,30,16,11,16,19,0.239,0.348,0.413,17.686,16,riffle_perfect
0,22,20,3,45,0.489,25,0.556,3,0,1.0,1,3,26,19,16,12,17,0.356,0.267,0.378,17.696,17,riffle_perfect
0,22,20,3,45,0.489,25,0.556,1,2,0.333,6,1,26,19,12,10,23,0.267,0.222,0.511,17.667,18,riffle_perfect
0,18,27,1,46,0.391,19,0.413,4,1,0.8,2,1,34,12,8,13,25,0.174,0.283,0.543,17.636,19,riffle_perfect
0,20,20,5,45,0.444,25,0.556,6,2,0.75,1,3,30,15,12,9,24,0.267,0.2,0.533,17.675,20,riffle_perfect
0,16,21,8,45,0.356,24,0.533,2,2,0.5,2,2,30,15,8,16,21,0.178,0.356,0.467,17.694,21,riffle_perfect
0,20,18,7,45,0.444,27,0.6,4,2,0.667,3,1,25,20,11,14,20,0.244,0.311,0.444,17.67,22,riffle_perfect
0,25,19,1,45,0.556,26,0.578,4,1,0.8,4,3,24,21,15,10,20,0.333,0.222,0.444,17.653,23,riffle_perfect
0,22,22,3,47,0.468,25,0.532,2,3,0.4,2,1,24,23,13,17,17,0.277,0.362,0.362,17.676,24,riffle_perfect
0,20,21,4,45,0.444,24,0.533,3,2,0.6,3,1,22,23,9,15,21,0.2,0.333,0.467,17.662,25,riffle_perfect
0,20,22,5,47,0.426,25,0.532,2,0,1.0,2,3,28,19,12,12,23,0.255,0.255,0.489,17.642,26,riffle_perfect
0,21,24,3,48,0.438,24,0.5,2,3,0.4,4,2,30,18,9,16,23,0.188,0.333,0.479,17.655,27,riffle_perfect
0,14,26,4,44,0.318,18,0.409,1,3,0.25,1,3,26,18,8,14,22,0.182,0.318,0.5,17.667,28,riffle_perfect
0,20,19,7,46,0.435,27,0.587,3,1,0.75,2,2,29,17,14,14,18,0.304,0.304,0.391,17.666,29,riffle_perfect
0,18,23,5,46,0.391,23,0.5,5,3,0.625,3,1,27,19,9,14,23,0.196,0.304,0.5,17.693,30,riffle_perfect
0,24,21,2,47,0.511,26,0.553,3,2,0.6,1,4,27,20,18,9,20,0.383,0.191,0.426,17.703,31,riffle_perfect
0,18,20,7,45,0.4,25,0.556,1,3,0.25,2,1,28,17,11,12,22,0.244,0.267,0.489,17.696,32,riffle_perfect
0,22,14,8,44,0.5,30,0.682,3,0,1.0,1,0,26,18,13,17,14,0.295,0.386,0.318,17.723,33,riffle_perfect
0,16,27,3,46,0.348,19,0.413,2,2,0.5,1,3,29,17,6,23,17,0.13,0.5,0.37,17.738,34,riffle_perfect
0,24,19,5,48,0.5,29,0.604,7,0,1.0,0,1,19,29,13,21,14,0.271,0.438,0.292,17.749,35,riffle_perfect
0,14,30,3,47,0.298,17,0.362,3,4,0.429,1,3,27,20,9,16,22,0.191,0.34,0.468,17.759,36,riffle_perfect
0,13,28,3,44,0.295,16,0.364,3,1,0.75,0,2,25,19,8,14,22,0.182,0.318,0.5,17.783,37,riffle_perfect
0,23,16,6,45,0.511,29,0.644,3,2,0.6,5,1,28,17,7,16,22,0.156,0.356,0.489,17.781,38,riffle_perfect
0,26,14,5,45,0.578,31,0.689,3,1,0.75,2,1,28,17,14,15,16,0.311,0.333,0.356,17.766,39,riffle_perfect
0,23,21,4,48,0.479,27,0.562,4,1,0.8,2,2,36,12,12,5,31,0.25,0.104,0.646,17.767,40,riffle_perfect
0,19,24,6,49,0.388,25,0.51,4,3,0.571,1,2,23,26,7,21,21,0.143,0.429,0.429,17.762,41,riffle_perfect
0,21,21,4,46,0.457,25,0.543,3,0,1.0,3,2,27,19,16,11,19,0.348,0.239,0.413,17.746,42,riffle_perfect
0,18,24,6,48,0.375,24,0.5,2,0,1.0,3,3,20,28,9,20,19,0.188,0.417,0.396,17.733,43,riffle_perfect
0,21,20,3,44,0.477,24,0.545,3,2,0.6,4,0,30,14,9,12,23,0.205,0.273,0.523,17.739,44,riffle_perfect
0,23,24,2,49,0.469,25,0.51,0,5,0.0,1,1,28,21,11,19,19,0.224,0.388,0.388,17.752,45,riffle_perfect
0,15,25,5,45,0.333,20,0.444,1,2,0.333,1,0,33,12,10,14,21,0.222,0.311,0.467,17.743,46,riffle_perfect
0,21,18,5,44,0.477,26,0.591,5,1,0.833,1,1,27,17,15,11,18,0.341,0.25,0.409,17.75,47,riffle_perfect
0,24,18,2,44,0.545,26,0.591,5,2,0.714,1,1,25,19,17,12,15,0.386,0.273,0.341,17.756,48,riffle_perfect
0,25,19,4,48,0.521,29,0.604,3,3,0.5,3,0,30,18,11,16,21,0.229,0.333,0.438,17.75,49,riffle_perfect
0,23,21,3,47,0.489,26,0.553,3,1,0.75,4,1,25,22,9,19,19,0.191,0.404,0.404,17.757,50,riffle_perfect
0,17,26,5,48,0.354,22,0.458,3,6,0.333,6,1,29,19,7,18,23,0.146,0.375,0.479,17.731,51,riffle_perfect
0,18,24,4,46,0.391,22,0.478,3,0,1.0,1,5,29,17,13,10,23,0.283,0.217,0.5,17.728,52,riffle_perfect
0,17,26,2,45,0.378,19,0.422,4,1,0.8,1,2,25,20,11,13,21,0.244,0.289,0.467,17.734,53,riffle_perfect
0,19,24,4,47,0.404,23,0.489,1,1,0.5,5,1,27,20,9,12,26,0.191,0.255,0.553,17.728,54,riffle_perfect
0,17,24,6,47,0.362,23,0.489,4,6,0.4,2,2,29,18,10,12,25,0.213,0.255,0.532,17.724,55,riffle_perfect
0,16,24,5,45,0.356,21,0.467,3,2,0.6,1,0,30,15,6,15,24,0.133,0.333,0.533,17.712,56,riffle_perfect
0,12,31,1,44,0.273,13,0.295,2,3,0.4,0,4,33,11,5,12,27,0.114,0.273,0.614,17.724,57,riffle_perfect
0,21,23,4,48,0.438,25,0.521,1,1,0.5,2,1,27,21,10,17,21,0.208,0.354,0.438,17.721,58,riffle_perfect
0,25,15,4,44,0.568,29,0.659,5,1,0.833,4,1,25,19,12,15,17,0.273,0.341,0.386,17.707,59,riffle_perfect
0,25,20,1,46,0.543,26,0.565,2,5,0.286,4,2,29,17,13,10,23,0.283,0.217,0.5,17.699,60,riffle_perfect
0,14,32,2,48,0.292,16,0.333,3,4,0.429,1,0,28,20,7,16,25,0.146,0.333,0.521,17.719,61,riffle_perfect
0,19,21,3,43,0.442,22,0.512,6,2,0.75,1,4,29,14,12,13,18,0.279,0.302,0.419,17.722,62,riffle_perfect
0,24,18,2,44,0.545,26,0.591,3,5,0.375,2,1,25,19,15,12,17,0.341,0.273,0.386,17.717,63,riffle_perfect
0,19,20,5,44,0.432,24,0.545,2,1,0.667,3,1,30,14,9,11,24,0.205,0.25,0.545,17.708,64,riffle_perfect
0,16,22,6,44,0.364,22,0.5,3,1,0.75,2,0,29,15,6,21,17,0.136,0.477,0.386,17.707,65,riffle_perfect
0,18,24,2,44,0.409,20,0.455,3,1,0.75,1,4,25,19,10,15,19,0.227,0.341,0.432,17.711,66,riffle_perfect
0,25,16,5,46,0.543,30,0.652,6,2,0.75,3,0,19,27,13,15,18,0.283,0.326,0.391,17.698,67,riffle_perfect
0,23,16,5,44,0.523,28,0.636,4,1,0.8,4,2,24,20,12,15,17,0.273,0.341,0.386,17.691,68,riffle_perfect
0,18,23,4,45,0.4,22,0.489,0,3,0.0,0,2,30,15,10,14,21,0.222,0.311,0.467,17.692,69,riffle_perfect
0,19,24,1,44,0.432,20,0.455,3,2,0.6,1,2,30,14,9,12,23,0.205,0.273,0.523,17.685,70,riffle_perfect
0,17,24,5,46,0.37,22,0.478,1,0,1.0,1,5,32,14,8,12,26,0.174,0.261,0.565,17.687,71,riffle_perfect
0,14,30,3,47,0.298,17,0.362,2,4,0.333,1,1,29,18,8,13,26,0.17,0.277,0.553,17.681,72,riffle_perfect
0,19,23,4,46,0.413,23,0.5,1,3,0.25,2,2,31,15,10,14,22,0.217,0.304,0.478,17.682,73,riffle_perfect
0,24,22,1,47,0.511,25,0.532,0,5,0.0,3,3,25,22,13,15,19,0.277,0.319,0.404,17.678,74,riffle_perfect
0,22,21,3,46,0.478,25,0.543,4,2,0.667,3,3,26,20,11,14,21,0.239,0.304,0.457,17.677,75,riffle_perfect
0,20,21,2,43,0.465,22,0.512,2,1,0.667,1,1,24,19,15,9,19,0.349,0.209,0.442,17.684,76,riffle_perfect
0,23,21,1,45,0.511,24,0.533,4,0,1.0,0,0,23,22,18,10,17,0.4,0.222,0.378,17.678,77,riffle_perfect
0,19,22,5,46,0.413,24,0.522,4,0,1.0,2,4,30,16,10,14,22,0.217,0.304,0.478,17.673,78,riffle_perfect
0,19,22,3,44,0.432,22,0.5,2,1,0.667,1,4,27,17,9,15,20,0.205,0.341,0.455,17.677,79,riffle_perfect
0,16,26,4,46,0.348,20,0.435,4,2,0.667,4,4,26,20,3,19,24,0.065,0.413,0.522,17.678,80,riffle_perfect
0,17,26,2,45,0.378,19,0.422,4,2,0.667,1,3,30,15,8,13,24,0.178,0.289,0.533,17.678,81,riffle_perfect
0,16,21,6,43,0.372,22,0.512,2,5,0.286,2,1,25,18,10,16,17,0.233,0.372,0.395,17.677,82,riffle_perfect
0,21,23,2,46,0.457,23,0.5,1,4,0.2,2,3,34,12,10,13,23,0.217,0.283,0.5,17.673,83,riffle_perfect
0,20,29,0,49,0.408,20,0.408,2,2,0.5,1,4,28,21,11,16,22,0.224,0.327,0.449,17.67,84,riffle_perfect
0,16,26,7,49,0.327,23,0.469,2,3,0.4,2,5,34,15,7,15,27,0.143,0.306,0.551,17.659,85,riffle_perfect
0,24,17,3,44,0.545,27,0.614,4,2,0.667,1,0,30,14,12,12,20,0.273,0.273,0.455,17.66,86,riffle_perfect
0,20,20,7,47,0.426,27,0.574,1,3,0.25,2,2,25,22,11,17,19,0.234,0.362,0.404,17.663,87,riffle_perfect
0,22,23,3,48,0.458,25,0.521,4,0,1.0,4,1,34,14,7,18,23,0.146,0.375,0.479,17.662,88,riffle_perfect
0,22,23,5,50,0.44,27,0.54,2,0,1.0,4,2,23,27,8,19,23,0.16,0.38,0.46,17.657,89,riffle_perfect
0,22,22,2,46,0.478,24,0.522,4,0,1.0,4,1,27,19,8,14,24,0.174,0.304,0.522,17.652,90,riffle_perfect
0,20,24,2,46,0.435,22,0.478,4,4,0.5,2,1,26,20,11,17,18,0.239,0.37,0.391,17.659,91,riffle_perfect
0,23,19,7,49,0.469,30,0.612,2,2,0.5,3,3,24,25,14,16,19,0.286,0.327,0.388,17.663,92,riffle_perfect
0,17,25,4,46,0.37,21,0.457,2,2,0.5,0,3,28,18,11,13,22,0.239,0.283,0.478,17.66,93,riffle_perfect
0,21,20,3,44,0.477,24,0.545,4,4,0.5,0,3,25,19,15,13,16,0.341,0.295,0.364,17.663,94,riffle_perfect
0,19,24,4,47,0.404,23,0.489,4,1,0.8,3,1,30,17,8,13,26,0.17,0.277,0.553,17.659,95,riffle_perfect
0,24,19,2,45,0.533,26,0.578,6,1,0.857,5,2,25,20,14,11,20,0.311,0.244,0.444,17.658,96,riffle_perfect
0,23,24,3,50,0.46,26,0.52,8,0,1.0,4,1,38,12,12,7,31,0.24,0.14,0.62,17.229,1,riffle_perfect
0,21,20,5,46,0.457,26,0.565,3,3,0.5,0,5,28,18,15,10,21,0.326,0.217,0.457,17.39,2,riffle_perfect
0,22,24,1,47,0.468,23,0.489,2,4,0.333,1,2,28,19,16,11,20,0.34,0.234,0.426,17.494,3,riffle_perfect
0,15,26,5,46,0.326,20,0.435,1,4,0.2,3,2,23,23,8,17,21,0.174,0.37,0.457,17.638,4,riffle_perfect
0,13,24,6,43,0.302,19,0.442,2,1,0.667,0,4,23,20,7,15,21,0.163,0.349,0.488,17.524,5,riffle_perfect
0,23,23,2,48,0.479,25,0.521,4,1,0.8,3,3,28,20,13,13,22,0.271,0.271,0.458,17.547,6,riffle_perfect
0,18,27,2,47,0.383,20,0.426,1,2,0.333,1,3,30,17,8,16,23,0.17,0.34,0.489,17.493,7,riffle_perfect
0,21,19,4,44,0.477,25,0.568,6,2,0.75,4,1,23,21,12,16,16,0.273,0.364,0.364,17.352,8,riffle_perfect
0,19,22,3,44,0.432,22,0.5,2,3,0.4,1,1,26,18,11,15,18,0.25,0.341,0.409,17.447,9,riffle_perfect
0,18,20,7,45,0.4,25,0.556,2,1,0.667,1,2,28,17,8,15,22,0.178,0.333,0.489,17.474,10,riffle_perfect
0,27,17,2,46,0.587,29,0.63,7,2,0.778,3,2,27,19,16,11,19,0.348,0.239,0.413,17.495,11,riffle_perfect
0,18,24,1,43,0.419,19,0.442,1,3,0.25,1,2,28,15,10,15,18,0.233,0.349,0.419,17.528,12,riffle_perfect
0,22,22,1,45,0.489,23,0.511,5,3,0.625,4,2,28,17,12,8,25,0.267,0.178,0.556,17.515,13,riffle_perfect
0,25,16,3,44,0.568,28,0.636,0,3,0.0,2,1,26,18,16,13,15,0.364,0.295,0.341,17.589,14,riffle_perfect
0,25,18,4,47,0.532,29,0.617,4,0,1.0,2,3,30,17,13,14,20,0.277,0.298,0.426,17.594,15,riffle_perfect
0,21,23,3,47,0.447,24,0.511,2,1,0.667,1,1,27,20,11,16,20,0.234,0.34,0.426,17.609,16,riffle_perfect
0,21,22,4,47,0.447,25,0.532,6,1,0.857,2,5,25,22,11,19,17,0.234,0.404,0.362,17.622,17,riffle_perfect
0,20,24,1,45,0.444,21,0.467,3,3,0.5,3,3,26,19,11,13,21,0.244,0.289,0.467,17.618,18,riffle_perfect
0,16,25,6,47,0.34,22,0.468,2,3,0.4,0,2,25,22,9,16,22,0.191,0.34,0.468,17.609,19,riffle_perfect
0,20,20,5,45,0.444,25,0.556,2,1,0.667,2,1,28,17,12,9,24,0.267,0.2,0.533,17.607,20,riffle_perfect
0,23,17,4,44,0.523,27,0.614,4,1,0.8,2,1,27,17,12,12,20,0.273,0.273,0.455,17.609,21,riffle_perfect
0,16,28,2,46,0.348,18,0.391,1,4,0.2,2,0,29,17,7,17,22,0.152,0.37,0.478,17.626,22,riffle_perfect
0,21,19,6,46,0.457,27,0.587,2,5,0.286,3,2,27,19,11,13,22,0.239,0.283,0.478,17.64,23,riffle_perfect
0,21,20,2,43,0.488,23,0.535,5,1,0.833,1,3,27,16,18,8,17,0.419,0.186,0.395,17.628,24,riffle_perfect
0,23,21,3,47,0.489,26,0.553,1,2,0.333,4,1,26,21,11,21,15,0.234,0.447,0.319,17.648,25,riffle_perfect
0,21,23,2,46,0.457,23,0.5,4,3,0.571,2,3,27,19,14,13,19,0.304,0.283,0.413,17.635,26,riffle_perfect
0,15,31,0,46,0.326,15,0.326,2,2,0.5,4,2,33,13,8,19,19,0.174,0.413,0.413,17.634,27,riffle_perfect
0,23,21,5,49,0.469,28,0.571,3,4,0.429,0,2,28,21,14,11,24,0.286,0.224,0.49,17.643,28,riffle_perfect
0,24,20,2,46,0.522,26,0.565,1,0,1.0,3,2,23,23,13,16,17,0.283,0.348,0.37,17.653,29,riffle_perfect
0,23,21,4,48,0.479,27,0.562,4,2,0.667,2,4,25,23,13,17,18,0.271,0.354,0.375,17.636,30,riffle_perfect
0,16,23,3,42,0.381,19,0.452,5,1,0.833,0,0,20,22,7,22,13,0.167,0.524,0.31,17.655,31,riffle_perfect
0,19,25,2,46,0.413,21,0.457,3,1,0.75,3,1,28,18,5,19,22,0.109,0.413,0.478,17.654,32,riffle_perfect
0,18,24,5,47,0.383,23,0.489,1,4,0.2,1,4,29,18,8,15,24,0.17,0.319,0.511,17.668,33,riffle_perfect
0,12,28,6,46,0.261,18,0.391,3,1,0.75,2,4,33,13,3,14,29,0.065,0.304,0.63,17.662,34,riffle_perfect
0,23,17,5,45,0.511,28,0.622,4,1,0.8,2,1,26,19,9,17,19,0.2,0.378,0.422,17.666,35,riffle_perfect
0,19,23,3,45,0.422,22,0.489,6,0,1.0,1,2,26,19,14,12,19,0.311,0.267,0.422,17.647,36,riffle_perfect
0,13,25,6,44,0.295,19,0.432,1,3,0.25,0,3,24,20,9,16,19,0.205,0.364,0.432,17.652,37,riffle_perfect
0,13,29,3,45,0.289,16,0.356,3,4,0.429,1,3,29,16,8,15,22,0.178,0.333,0.489,17.66,38,riffle_perfect
0,18,23,4,45,0.4,22,0.489,1,3,0.25,2,3,32,13,9,10,26,0.2,0.222,0.578,17.642,39,riffle_perfect
0,24,21,4,49,0.49,28,0.571,4,0,1.0,5,2,31,18,11,12,26,0.224,0.245,0.531,17.63,40,riffle_perfect
0,17,27,5,49,0.347,22,0.449,1,3,0.25,2,5,31,18,10,14,25,0.204,0.286,0.51,17.64,41,riffle_perfect
0,21,24,1,46,0.457,22,0.478,2,3,0.4,2,1,26,20,11,16,19,0.239,0.348,0.413,17.637,42,riffle_perfect
0,21,23,1,45,0.467,22,0.489,2,1,0.667,3,4,27,18,5,17,23,0.111,0.378,0.511,17.644,43,riffle_perfect
0,16,25,3,44,0.364,19,0.432,1,2,0.333,2,2,29,15,10,12,22,0.227,0.273,0.5,17.653,44,riffle_perfect
0,19,21,5,45,0.422,24,0.533,3,3,0.5,1,5,30,15,11,12,22,0.244,0.267,0.489,17.66,45,riffle_perfect
0,17,26,5,48,0.354,22,0.458,5,2,0.714,4,1,26,22,10,17,21,0.208,0.354,0.438,17.66,46,riffle_perfect
0,14,30,4,48,0.292,18,0.375,2,6,0.25,3,2,28,20,7,19,22,0.146,0.396,0.458,17.659,47,riffle_perfect
0,17,24,6,47,0.362,23,0.489,1,4,0.2,3,3,36,11,8,13,26,0.17,0.277,0.553,17.657,48,riffle_perfect
0,20,24,3,47,0.426,23,0.489,5,0,1.0,2,3,30,17,8,19,20,0.17,0.404,0.426,17.657,49,riffle_perfect
0,23,20,1,44,0.523,24,0.545,4,0,1.0,2,3,28,16,14,11,19,0.318,0.25,0.432,17.662,50,riffle_perfect
0,23,20,3,46,0.5,26,0.565,5,4,0.556,5,3,27,19,10,16,20,0.217,0.348,0.435,17.658,51,riffle_perfect
0,21,25,1,47,0.447,22,0.468,0,3,0.0,2,3,34,13,10,17,20,0.213,0.362,0.426,17.654,52,riffle_perfect
0,21,19,5,45,0.467,26,0.578,4,1,0.8,2,3,29,16,7,19,19,0.156,0.422,0.422,17.664,53,riffle_perfect
0,22,19,5,46,0.478,27,0.587,4,1,0.8,2,0,25,21,11,13,22,0.239,0.283,0.478,17.667,54,riffle_perfect
0,19,22,3,44,0.432,22,0.5,2,1,0.667,1,0,26,18,9,17,18,0.205,0.386,0.409,17.67,55,riffle_perfect
0,26,14,3,43,0.605,29,0.674,6,0,1.0,2,1,25,18,15,14,14,0.349,0.326,0.326,17.665,56,riffle_perfect
0,13,24,7,44,0.295,20,0.455,2,2,0.5,0,1,25,19,9,17,18,0.205,0.386,0.409,17.671,57,riffle_perfect
0,19,23,3,45,0.422,22,0.489,3,1,0.75,3,1,24,21,13,15,17,0.289,0.333,0.378,17.67,58,riffle_perfect
0,24,19,2,45,0.533,26,0.578,7,3,0.7,1,5,30,15,12,9,24,0.267,0.2,0.533,17.672,59,riffle_perfect
0,17,23,5,45,0.378,22,0.489,2,4,0.333,1,1,27,18,11,16,18,0.244,0.356,0.4,17.683,60,riffle_perfect
0,19,19,4,42,0.452,23,0.548,2,3,0.4,1,0,29,13,10,15,17,0.238,0.357,0.405,17.69,61,riffle_perfect
0,18,26,2,46,0.391,20,0.435,1,2,0.333,4,3,26,20,6,15,25,0.13,0.326,0.543,17.687,62,riffle_perfect
0,26,16,5,47,0.553,31,0.66,1,1,0.5,2,1,22,25,10,19,18,0.213,0.404,0.383,17.689,63,riffle_perfect
0,20,20,5,45,0.444,25,0.556,3,3,0.5,4,4,28,17,13,16,16,0.289,0.356,0.356,17.698,64,riffle_perfect
0,19,25,6,50,0.38,25,0.5,1,5,0.167,5,2,22,28,12,20,18,0.24,0.4,0.36,17.702,65,riffle_perfect
0,17,26,3,46,0.37,20,0.435,3,2,0.6,1,1,22,24,6,20,20,0.13,0.435,0.435,17.696,66,riffle_perfect
0,15,22,7,44,0.341,22,0.5,0,2,0.0,0,2,27,17,10,16,18,0.227,0.364,0.409,17.696,67,riffle_perfect
0,19,22,5,46,0.413,24,0.522,2,3,0.4,2,2,35,11,8,13,25,0.174,0.283,0.543,17.704,68,riffle_perfect
0,15,22,6,43,0.349,21,0.488,4,5,0.444,0,3,17,26,11,19,13,0.256,0.442,0.302,17.715,69,riffle_perfect
0,26,16,5,47,0.553,31,0.66,3,2,0.6,5,2,27,20,11,15,21,0.234,0.319,0.447,17.709,70,riffle_perfect
0,19,24,3,46,0.413,22,0.478,3,0,1.0,2,2,27,19,10,17,19,0.217,0.37,0.413,17.717,71,riffle_perfect
0,25,16,4,45,0.556,29,0.644,3,1,0.75,2,1,32,13,10,13,22,0.222,0.289,0.489,17.714,72,riffle_perfect
0,19,24,0,43,0.442,19,0.442,1,3,0.25,2,1,28,15,11,17,15,0.256,0.395,0.349,17.716,73,riffle_perfect
0,16,26,3,45,0.356,19,0.422,3,10,0.231,1,0,29,16,6,17,22,0.133,0.378,0.489,17.71,74,riffle_perfect
0,17,21,7,45,0.378,24,0.533,1,5,0.167,1,0,26,19,6,19,20,0.133,0.422,0.444,17.715,75,riffle_perfect
0,22,24,2,48,0.458,24,0.5,3,2,0.6,2,4,26,22,13,16,19,0.271,0.333,0.396,17.709,76,riffle_perfect
0,17,20,7,44,0.386,24,0.545,1,1,0.5,1,2,29,15,9,18,17,0.205,0.409,0.386,17.703,77,riffle_perfect
0,25,20,0,45,0.556,25,0.556,1,2,0.333,2,2,25,20,11,16,18,0.244,0.356,0.4,17.705,78,riffle_perfect
0,22,20,2,44,0.5,24,0.545,4,2,0.667,0,1,24,20,16,13,15,0.364,0.295,0.341,17.705,79,riffle_perfect
0,21,23,0,44,0.477,21,0.477,2,2,0.5,3,3,28,16,10,13,21,0.227,0.295,0.477,17.702,80,riffle_perfect
0,22,20,5,47,0.468,27,0.574,1,1,0.5,6,3,33,14,11,15,21,0.234,0.319,0.447,17.701,81,riffle_perfect
0,18,24,6,48,0.375,24,0.5,1,3,0.25,4,3,36,12,8,13,27,0.167,0.271,0.562,17.699,82,riffle_perfect
0,17,23,5,45,0.378,22,0.489,0,3,0.0,3,2,31,14,12,13,20,0.267,0.289,0.444,17.702,83,riffle_perfect
0,20,19,4,43,0.465,24,0.558,2,3,0.4,2,3,22,21,12,13,18,0.279,0.302,0.419,17.693,84,riffle_perfect
0,29,14,2,45,0.644,31,0.689,4,1,0.8,3,0,25,20,15,14,16,0.333,0.311,0.356,17.691,85,riffle_perfect
0,25,18,2,45,0.556,27,0.6,3,2,0.6,5,2,24,21,14,10,21,0.311,0.222,0.467,17.689,86,riffle_perfect
0,19,19,4,42,0.452,23,0.548,1,2,0.333,1,0,23,19,11,17,14,0.262,0.405,0.333,17.692,87,riffle_perfect
0,20,19,6,45,0.444,26,0.578,4,2,0.667,3,3,26,19,9,15,21,0.2,0.333,0.467,17.694,88,riffle_perfect
0,23,20,3,46,0.5,26,0.565,1,3,0.25,3,1,27,19,12,15,19,0.261,0.326,0.413,17.692,89,riffle_perfect
0,16,24,6,46,0.348,22,0.478,1,3,0.25,1,5,28,18,7,16,23,0.152,0.348,0.5,17.693,90,riffle_perfect
0,24,19,1,44,0.545,25,0.568,4,2,0.667,4,2,29,15,13,12,19,0.295,0.273,0.432,17.698,91,riffle_perfect
0,21,20,4,45,0.467,25,0.556,3,0,1.0,2,2,25,20,10,16,19,0.222,0.356,0.422,17.699,92,riffle_perfect
0,20,18,8,46,0.435,28,0.609,0,3,0.0,4,1,28,18,7,16,23,0.152,0.348,0.5,17.701,93,riffle_perfect
0,23,22,6,51,0.451,29,0.569,2,3,0.4,3,2,35,16,14,16,21,0.275,0.314,0.412,17.702,94,riffle_perfect
0,22,22,2,46,0.478,24,0.522,1,3,0.25,5,1,21,25,6,18,22,0.13,0.391,0.478,17.694,95,riffle_perfect
0,27,22,2,51,0.529,29,0.569,1,1,0.5,3,1,29,22,20,14,17,0.392,0.275,0.333,17.69,96,riffle_perfect
0,18,26,3,47,0.383,21,0.447,2,2,0.5,2,1,21,26,9,20,18,0.191,0.426,0.383,17.875,1,riffle_perfect
0,17,26,6,49,0.347,23,0.469,3,2,0.6,4,2,30,19,11,17,21,0.224,0.347,0.429,17.794,2,riffle_perfect
0,14,26,6,46,0.304,20,0.435,1,2,0.333,2,3,29,17,8,15,23,0.174,0.326,0.5,17.835,3,riffle_perfect
0,27,17,3,47,0.574,30,0.638,6,1,0.857,1,3,25,22,16,12,19,0.34,0.255,0.404,17.589,4,riffle_perfect
0,23,18,5,46,0.5,28,0.609,3,0,1.0,6,3,24,22,13,13,20,0.283,0.283,0.435,17.434,5,riffle_perfect
0,14,28,3,45,0.311,17,0.378,1,3,0.25,2,2,26,19,5,21,19,0.111,0.467,0.422,17.513,6,riffle_perfect
0,24,16,6,46,0.522,30,0.652,6,1,0.857,3,1,18,28,13,19,14,0.283,0.413,0.304,17.537,7,riffle_perfect
0,17,24,6,47,0.362,23,0.489,5,5,0.5,1,4,26,21,8,21,18,0.17,0.447,0.383,17.565,8,riffle_perfect
0,17,29,1,47,0.362,18,0.383,4,3,0.571,1,4,25,22,9,18,20,0.191,0.383,0.426,17.571,9,riffle_perfect
0,22,21,3,46,0.478,25,0.543,5,2,0.714,0,6,31,15,8,14,24,0.174,0.304,0.522,17.61,10,riffle_perfect
0,19,22,2,43,0.442,21,0.488,1,1,0.5,1,2,27,16,13,11,19,0.302,0.256,0.442,17.574,11,riffle_perfect
0,17,20,5,42,0.405,22,0.524,2,3,0.4,1,0,23,19,13,14,15,0.31,0.333,0.357,17.588,12,riffle_perfect
0,21,19,7,47,0.447,28,0.596,4,2,0.667,1,0,29,18,12,14,21,0.255,0.298,0.447,17.606,13,riffle_perfect
0,18,26,3,47,0.383,21,0.447,2,5,0.286,4,4,31,16,4,14,29,0.085,0.298,0.617,17.605,14,riffle_perfect
0,26,18,2,46,0.565,28,0.609,4,5,0.444,2,2,27,19,20,9,17,0.435,0.196,0.37,17.632,15,riffle_perfect
0,19,22,4,45,0.422,23,0.511,3,2,0.6,1,0,33,12,12,14,19,0.267,0.311,0.422,17.632,16,riffle_perfect
0,22,19,4,45,0.489,26,0.578,1,0,1.0,4,4,35,10,10,6,29,0.222,0.133,0.644,17.56,17,riffle_perfect
0,21,23,5,49,0.429,26,0.531,4,2,0.667,2,3,28,21,10,12,27,0.204,0.245,0.551,17.55,18,riffle_perfect
0,18,23,3,44,0.409,21,0.477,3,1,0.75,2,2,29,15,9,14,21,0.205,0.318,0.477,17.542,19,riffle_perfect
0,13,28,7,48,0.271,20,0.417,3,0,1.0,2,4,29,19,8,22,18,0.167,0.458,0.375,17.563,20,riffle_perfect
0,20,20,4,44,0.455,24,0.545,4,4,0.5,0,1,22,22,11,15,18,0.25,0.341,0.409,17.587,21,riffle_perfect
0,19,21,6,46,0.413,25,0.543,1,4,0.2,1,3,31,15,11,15,20,0.239,0.326,0.435,17.592,22,riffle_perfect
0,21,19,5,45,0.467,26,0.578,3,0,1.0,4,0,28,17,9,12,24,0.2,0.267,0.533,17.586,23,riffle_perfect
0,23,22,1,46,0.5,24,0.522,5,2,0.714,3,4,25,21,14,14,18,0.304,0.304,0.391,17.586,24,riffle_perfect
0,24,17,3,44,0.545,27,0.614,5,1,0.833,7,0,25,19,10,13,21,0.227,0.295,0.477,17.574,25,riffle_perfect
0,21,21,3,45,0.467,24,0.533,3,3,0.5,4,1,31,14,9,14,22,0.2,0.311,0.489,17.584,26,riffle_perfect
0,24,17,6,47,0.511,30,0.638,1,1,0.5,1,1,23,24,18,9,20,0.383,0.191,0.426,17.581,27,riffle_perfect
0,19,20,6,45,0.422,25,0.556,3,2,0.6,2,2,30,15,11,14,20,0.244,0.311,0.444,17.6,28,riffle_perfect
0,20,20,4,44,0.455,24,0.545,3,2,0.6,2,1,28,16,8,16,20,0.182,0.364,0.455,17.596,29,riffle_perfect
0,20,24,2,46,0.435,22,0.478,4,2,0.667,1,1,28,18,9,18,19,0.196,0.391,0.413,17.614,30,riffle_perfect
0,21,19,6,46,0.457,27,0.587,3,1,0.75,4,2,30,16,10,15,21,0.217,0.326,0.457,17.592,31,riffle_perfect
0,19,21,7,47,0.404,26,0.553,3,3,0.5,1,1,31,16,7,18,22,0.149,0.383,0.468,17.59,32,riffle_perfect
0,20,21,2,43,0.465,22,0.512,5,0,1.0,0,3,31,12,13,12,18,0.302,0.279,0.419,17.58,33,riffle_perfect
0,16,27,2,45,0.356,18,0.4,3,3,0.5,2,3,29,16,11,14,20,0.244,0.311,0.444,17.579,34,riffle_perfect
0,23,16,4,43,0.535,27,0.628,3,1,0.75,2,0,27,16,14,14,15,0.326,0.326,0.349,17.564,35,riffle_perfect
0,14,24,4,42,0.333,18,0.429,3,3,0.5,0,2,27,15,9,12,21,0.214,0.286,0.5,17.579,36,riffle_perfect
0,21,21,4,46,0.457,25,0.543,2,4,0.333,3,1,30,16,10,14,22,0.217,0.304,0.478,17.599,37,riffle_perfect
0,22,23,2,47,0.468,24,0.511,3,0,1.0,2,2,28,19,9,19,19,0.191,0.404,0.404,17.602,38,riffle_perfect
0,21,22,5,48,0.438,26,0.542,1,2,0.333,3,0,29,19,8,15,25,0.167,0.312,0.521,17.594,39,riffle_perfect
0,15,26,4,45,0.333,19,0.422,1,2,0.333,3,1,31,14,9,13,23,0.2,0.289,0.511,17.594,40,riffle_perfect
0,22,20,3,45,0.489,25,0.556,4,2,0.667,3,0,23,22,13,15,17,0.289,0.333,0.378,17.597,41,riffle_perfect
0,25,15,3,43,0.581,28,0.651,2,1,0.667,2,1,21,22,18,14,11,0.419,0.326,0.256,17.605,42,riffle_perfect
0,28,14,1,43,0.651,29,0.674,6,0,1.0,1,0,27,16,16,11,16,0.372,0.256,0.372,17.617,43,riffle_perfect
0,21,20,5,46,0.457,26,0.565,3,3,0.5,2,1,25,21,13,16,17,0.283,0.348,0.37,17.599,44,riffle_perfect
0,16,26,5,47,0.34,21,0.447,2,2,0.5,0,3,32,15,7,15,25,0.149,0.319,0.532,17.607,45,riffle_perfect
0,21,21,2,44,0.477,23,0.523,6,0,1.0,0,0,24,20,12,14,18,0.273,0.318,0.409,17.616,46,riffle_perfect
0,16,25,5,46,0.348,21,0.457,4,1,0.8,1,1,31,15,8,15,23,0.174,0.326,0.5,17.609,47,riffle_perfect
0,18,24,2,44,0.409,20,0.455,3,6,0.333,2,1,26,18,9,12,23,0.205,0.273,0.523,17.61,48,riffle_perfect
0,17,22,6,45,0.378,23,0.511,2,1,0.667,1,2,27,18,10,14,21,0.222,0.311,0.467,17.61,49,riffle_perfect
0,17,21,8,46,0.37,25,0.543,2,3,0.4,2,0,24,22,9,17,20,0.196,0.37,0.435,17.59,50,riffle_perfect
0,24,23,1,48,0.5,25,0.521,2,0,1.0,5,2,35,13,15,10,23,0.312,0.208,0.479,17.584,51,riffle_perfect
0,20,21,3,44,0.455,23,0.523,4,4,0.5,1,1,28,16,12,12,20,0.273,0.273,0.455,17.592,52,riffle_perfect
0,24,16,5,45,0.533,29,0.644,2,3,0.4,3,0,22,23,16,11,18,0.356,0.244,0.4,17.591,53,riffle_perfect
0,18,24,2,44,0.409,20,0.455,1,3,0.25,1,2,26,18,8,19,17,0.182,0.432,0.386,17.601,54,riffle_perfect
0,21,19,6,46,0.457,27,0.587,3,4,0.429,5,2,22,24,7,20,19,0.152,0.435,0.413,17.602,55,riffle_perfect
0,20,25,6,51,0.392,26,0.51,3,0,1.0,4,2,28,23,8,19,24,0.157,0.373,0.471,17.598,56,riffle_perfect
0,26,18,2,46,0.565,28,0.609,1,3,0.25,3,1,30,16,11,14,21,0.239,0.304,0.457,17.599,57,riffle_perfect
0,25,20,3,48,0.521,28,0.583,8,1,0.889,1,1,29,19,13,16,19,0.271,0.333,0.396,17.608,58,riffle_perfect
0,18,24,2,44,0.409,20,0.455,3,1,0.75,2,1,31,13,11,17,16,0.25,0.386,0.364,17.607,59,riffle_perfect
0,24,18,5,47,0.511,29,0.617,3,2,0.6,2,2,27,20,17,14,16,0.362,0.298,0.34,17.621,60,riffle_perfect
0,16,24,6,46,0.348,22,0.478,1,7,0.125,1,3,35,11,7,14,25,0.152,0.304,0.543,17.63,61,riffle_perfect
0,19,27,4,50,0.38,23,0.46,2,4,0.333,3,3,26,24,13,18,19,0.26,0.36,0.38,17.626,62,riffle_perfect
0,24,20,1,45,0.533,25,0.556,7,1,0.875,2,2,26,19,12,11,22,0.267,0.244,0.489,17.623,63,riffle_perfect
0,22,19,2,43,0.512,24,0.558,6,1,0.857,3,2,24,19,14,13,16,0.326,0.302,0.372,17.619,64,riffle_perfect
0,14,31,4,49,0.286,18,0.367,3,3,0.5,3,6,33,16,2,18,29,0.041,0.367,0.592,17.607,65,riffle_perfect
0,20,21,3,44,0.455,23,0.523,4,4,0.5,2,1,20,24,14,16,14,0.318,0.364,0.318,17.606,66,riffle_perfect
0,20,25,1,46,0.435,21,0.457,2,0,1.0,4,6,35,11,8,8,30,0.174,0.174,0.652,17.585,67,riffle_perfect
0,29,14,3,46,0.63,32,0.696,6,2,0.75,3,2,25,21,20,14,12,0.435,0.304,0.261,17.585,68,riffle_perfect
0,19,27,2,48,0.396,21,0.438,2,1,0.667,0,4,32,16,8,12,28,0.167,0.25,0.583,17.583,69,riffle_perfect
0,20,20,7,47,0.426,27,0.574,3,2,0.6,4,5,33,14,12,8,27,0.255,0.17,0.574,17.583,70,riffle_perfect
0,23,17,6,46,0.5,29,0.63,4,3,0.571,4,2,33,13,10,11,25,0.217,0.239,0.543,17.582,71,riffle_perfect
0,18,25,3,46,0.391,21,0.457,7,1,0.875,0,5,27,19,11,16,19,0.239,0.348,0.413,17.581,72,riffle_perfect
0,22,22,3,47,0.468,25,0.532,2,3,0.4,3,2,25,22,12,18,17,0.255,0.383,0.362,17.587,73,riffle_perfect
0,26,19,2,47,0.553,28,0.596,3,2,0.6,5,3,24,23,13,16,18,0.277,0.34,0.383,17.591,74,riffle_perfect
0,18,23,5,46,0.391,23,0.5,5,3,0.625,2,2,28,18,12,13,21,0.261,0.283,0.457,17.597,75,riffle_perfect
0,25,15,2,42,0.595,27,0.643,4,0,1.0,3,1,25,17,14,11,17,0.333,0.262,0.405,17.59,76,riffle_perfect
0,20,24,3,47,0.426,23,0.489,4,3,0.571,1,3,24,23,10,17,20,0.213,0.362,0.426,17.591,77,riffle_perfect
0,26,14,4,44,0.591,30,0.682,5,0,1.0,3,0,26,18,14,16,14,0.318,0.364,0.318,17.59,78,riffle_perfect
0,19,21,5,45,0.422,24,0.533,2,3,0.4,1,2,26,19,14,14,17,0.311,0.311,0.378,17.591,79,riffle_perfect
0,21,20,4,45,0.467,25,0.556,4,4,0.5,3,4,23,22,12,13,20,0.267,0.289,0.444,17.598,80,riffle_perfect
0,23,21,0,44,0.523,23,0.523,3,4,0.429,2,3,30,14,11,14,19,0.25,0.318,0.432,17.602,81,riffle_perfect
0,24,19,3,46,0.522,27,0.587,2,1,0.667,1,3,25,21,14,16,16,0.304,0.348,0.348,17.596,82,riffle_perfect
0,16,23,7,46,0.348,23,0.5,3,0,1.0,1,4,31,15,9,15,22,0.196,0.326,0.478,17.603,83,riffle_perfect
0,22,22,4,48,0.458,26,0.542,3,6,0.333,1,2,26,22,13,18,17,0.271,0.375,0.354,17.609,84,riffle_perfect
0,22,15,6,43,0.512,28,0.651,2,3,0.4,1,0,25,18,13,18,12,0.302,0.419,0.279,17.62,85,riffle_perfect
0,16,23,7,46,0.348,23,0.5,1,2,0.333,2,1,25,21,8,18,20,0.174,0.391,0.435,17.624,86,riffle_perfect
0,16,28,2,46,0.348,18,0.391,4,2,0.667,2,4,25,21,9,15,22,0.196,0.326,0.478,17.622,87,riffle_perfect
0,19,22,5,46,0.413,24,0.522,2,2,0.5,2,1,30,16,8,13,25,0.174,0.283,0.543,17.627,88,riffle_perfect
0,17,24,4,45,0.378,21,0.467,2,5,0.286,3,0,25,20,7,20,18,0.156,0.444,0.4,17.622,89,riffle_perfect
0,14,25,6,45,0.311,20,0.444,2,5,0.286,0,2,29,16,6,15,24,0.133,0.333,0.533,17.632,90,riffle_perfect
0,23,22,1,46,0.5,24,0.522,4,3,0.571,4,2,28,18,12,13,21,0.261,0.283,0.457,17.623,91,riffle_perfect
0,19,24,2,45,0.422,21,0.467,4,5,0.444,5,2,25,20,9,12,24,0.2,0.267,0.533,17.623,92,riffle_perfect
0,21,22,4,47,0.447,25,0.532,5,1,0.833,3,4,24,23,12,16,19,0.255,0.34,0.404,17.624,93,riffle_perfect
0,26,19,3,48,0.542,29,0.604,1,3,0.25,1,1,28,20,15,17,16,0.312,0.354,0.333,17.632,94,riffle_perfect
0,21,21,5,47,0.447,26,0.553,3,4,0.429,3,2,34,13,12,9,26,0.255,0.191,0.553,17.633,95,riffle_perfect
0,16,25,4,45,0.356,20,0.444,0,3,0.0,2,1,30,15,9,18,18,0.2,0.4,0.4,17.637,96,riffle_perfect
0,24,20,3,47,0.511,27,0.574,3,2,0.6,2,1,30,17,13,12,22,0.277,0.255,0.468,17.429,1,riffle_perfect
0,20,22,1,43,0.465,21,0.488,3,1,0.75,1,0,25,18,11,10,22,0.256,0.233,0.512,17.439,2,riffle_perfect
0,28,16,0,44,0.636,28,0.636,2,2,0.5,2,1,29,15,16,14,14,0.364,0.318,0.318,17.395,3,riffle_perfect
0,22,21,2,45,0.489,24,0.533,1,0,1.0,1,5,26,19,9,16,20,0.2,0.356,0.444,17.33,4,riffle_perfect
0,17,26,2,45,0.378,19,0.422,1,2,0.333,0,2,26,19,13,19,13,0.289,0.422,0.289,17.481,5,riffle_perfect
0,23,19,3,45,0.511,26,0.578,5,1,0.833,1,4,27,18,16,12,17,0.356,0.267,0.378,17.389,6,riffle_perfect
0,20,24,1,45,0.444,21,0.467,1,1,0.5,1,1,25,20,11,13,21,0.244,0.289,0.467,17.33,7,riffle_perfect
0,17,29,2,48,0.354,19,0.396,2,0,1.0,3,0,28,20,6,16,26,0.125,0.333,0.542,17.335,8,riffle_perfect
0,23,20,3,46,0.5,26,0.565,5,3,0.625,1,3,30,16,13,12,21,0.283,0.261,0.457,17.363,9,riffle_perfect
0,21,24,2,47,0.447,23,0.489,0,1,0.0,3,0,28,19,12,15,20,0.255,0.319,0.426,17.354,10,riffle_perfect
0,17,26,2,45,0.378,19,0.422,6,0,1.0,1,4,20,25,12,18,15,0.267,0.4,0.333,17.422,11,riffle_perfect
0,21,15,7,43,0.488,28,0.651,3,0,1.0,1,2,25,18,13,12,18,0.302,0.279,0.419,17.459,12,riffle_perfect
0,21,18,5,44,0.477,26,0.591,5,1,0.833,2,2,31,13,11,11,22,0.25,0.25,0.5,17.467,13,riffle_perfect
0,13,27,5,45,0.289,18,0.4,1,2,0.333,2,3,25,20,6,16,23,0.133,0.356,0.511,17.463,14,riffle_perfect
0,16,29,2,47,0.34,18,0.383,3,2,0.6,1,2,27,20,8,20,19,0.17,0.426,0.404,17.475,15,riffle_perfect
0,25,17,4,46,0.543,29,0.63,3,2,0.6,2,2,28,18,11,19,16,0.239,0.413,0.348,17.534,16,riffle_perfect
0,18,21,6,45,0.4,24,0.533,5,2,0.714,2,1,26,19,10,15,20,0.222,0.333,0.444,17.569,17,riffle_perfect
0,28,18,2,48,0.583,30,0.625,5,1,0.833,2,0,31,17,15,20,13,0.312,0.417,0.271,17.557,18,riffle_perfect
0,23,16,5,44,0.523,28,0.636,1,2,0.333,1,1,28,16,14,11,19,0.318,0.25,0.432,17.59,19,riffle_perfect
0,16,24,5,45,0.356,21,0.467,2,2,0.5,0,3,28,17,8,12,25,0.178,0.267,0.556,17.607,20,riffle_perfect
0,18,25,3,46,0.391,21,0.457,2,5,0.286,2,2,32,14,10,11,25,0.217,0.239,0.543,17.599,21,riffle_perfect
0,19,24,2,45,0.422,21,0.467,3,3,0.5,4,3,29,16,10,17,18,0.222,0.378,0.4,17.608,22,riffle_perfect
0,25,21,0,46,0.543,25,0.543,5,2,0.714,4,1,26,20,14,11,21,0.304,0.239,0.457,17.607,23,riffle_perfect
0,22,19,3,44,0.5,25,0.568,6,1,0.857,3,0,27,17,13,12,19,0.295,0.273,0.432,17.586,24,riffle_perfect
0,20,20,3,43,0.465,23,0.535,5,0,1.0,2,1,32,11,8,15,20,0.186,0.349,0.465,17.596,25,riffle_perfect
0,16,25,5,46,0.348,21,0.457,1,2,0.333,2,4,29,17,10,17,19,0.217,0.37,0.413,17.606,26,riffle_perfect
0,24,24,1,49,0.49,25,0.51,8,3,0.727,3,4,33,16,15,10,24,0.306,0.204,0.49,17.605,27,riffle_perfect
0,17,25,4,46,0.37,21,0.457,2,3,0.4,1,3,26,20,8,20,18,0.174,0.435,0.391,17.63,28,riffle_perfect
0,14,24,8,46,0.304,22,0.478,1,3,0.25,1,1,26,20,10,18,18,0.217,0.391,0.391,17.655,29,riffle_perfect
0,22,18,7,47,0.468,29,0.617,7,2,0.778,2,2,25,22,13,16,18,0.277,0.34,0.383,17.668,30,riffle_perfect
0,20,24,4,48,0.417,24,0.5,4,1,0.8,3,2,31,17,12,14,22,0.25,0.292,0.458,17.648,31,riffle_perfect
0,21,22,4,47,0.447,25,0.532,6,4,0.6,1,3,34,13,5,15,27,0.106,0.319,0.574,17.683,32,riffle_perfect
0,17,24,3,44,0.386,20,0.455,3,2,0.6,1,2,30,14,7,17,20,0.159,0.386,0.455,17.675,33,riffle_perfect
0,22,19,5,46,0.478,27,0.587,5,1,0.833,1,4,31,15,11,14,21,0.239,0.304,0.457,17.675,34,riffle_perfect
0,21,19,6,46,0.457,27,0.587,2,2,0.5,3,4,28,18,12,11,23,0.261,0.239,0.5,17.658,35,riffle_perfect
0,18,20,6,44,0.409,24,0.545,3,3,0.5,1,0,21,23,11,17,16,0.25,0.386,0.364,17.668,36,riffle_perfect
0,23,21,0,44,0.523,23,0.523,2,2,0.5,1,4,27,17,15,10,19,0.341,0.227,0.432,17.673,37,riffle_perfect
0,21,22,2,45,0.467,23,0.511,1,1,0.5,2,4,23,22,13,13,19,0.289,0.289,0.422,17.661,38,riffle_perfect
0,16,24,3,43,0.372,19,0.442,1,1,0.5,2,3,26,17,11,12,20,0.256,0.279,0.465,17.643,39,riffle_perfect
0,20,21,4,45,0.444,24,0.533,2,4,0.333,2,5,31,14,13,11,21,0.289,0.244,0.467,17.645,40,riffle_perfect
0,14,25,6,45,0.311,20,0.444,1,1,0.5,0,2,31,14,8,18,19,0.178,0.4,0.422,17.652,41,riffle_perfect
0,19,23,2,44,0.432,21,0.477,4,3,0.571,2,1,31,13,12,7,25,0.273,0.159,0.568,17.655,42,riffle_perfect
0,20,20,4,44,0.455,24,0.545,4,2,0.667,1,2,24,20,13,15,16,0.295,0.341,0.364,17.657,43,riffle_perfect
0,15,27,4,46,0.326,19,0.413,0,0,0,3,1,31,15,3,19,24,0.065,0.413,0.522,17.638,44,riffle_perfect
0,19,19,6,44,0.432,25,0.568,2,1,0.667,0,1,27,17,11,16,17,0.25,0.364,0.386,17.633,45,riffle_perfect
0,23,19,3,45,0.511,26,0.578,3,4,0.429,4,1,22,23,12,17,16,0.267,0.378,0.356,17.641,46,riffle_perfect
0,20,24,1,45,0.444,21,0.467,2,4,0.333,4,4,26,19,7,14,24,0.156,0.311,0.533,17.646,47,riffle_perfect
0,15,25,3,43,0.349,18,0.419,2,2,0.5,1,0,24,19,7,18,18,0.163,0.419,0.419,17.661,48,riffle_perfect
0,13,29,5,47,0.277,18,0.383,1,0,1.0,0,3,31,16,7,14,26,0.149,0.298,0.553,17.668,49,riffle_perfect
0,14,28,4,46,0.304,18,0.391,1,1,0.5,1,1,25,21,6,20,20,0.13,0.435,0.435,17.663,50,riffle_perfect
0,21,27,3,51,0.412,24,0.471,2,4,0.333,3,3,25,26,13,19,19,0.255,0.373,0.373,17.67,51,riffle_perfect
0,17,26,4,47,0.362,21,0.447,6,2,0.75,3,2,25,22,9,15,23,0.191,0.319,0.489,17.658,52,riffle_perfect
0,23,17,4,44,0.523,27,0.614,3,0,1.0,1,0,28,16,16,8,20,0.364,0.182,0.455,17.652,53,riffle_perfect
0,26,16,1,43,0.605,27,0.628,6,2,0.75,3,1,29,14,14,10,19,0.326,0.233,0.442,17.642,54,riffle_perfect
0,20,24,5,49,0.408,25,0.51,1,5,0.167,0,0,22,27,13,20,16,0.265,0.408,0.327,17.653,55,riffle_perfect
0,15,25,4,44,0.341,19,0.432,3,4,0.429,2,1,26,18,10,13,21,0.227,0.295,0.477,17.658,56,riffle_perfect
0,18,24,5,47,0.383,23,0.489,1,2,0.333,3,6,29,18,8,17,22,0.17,0.362,0.468,17.653,57,riffle_perfect
0,19,22,5,46,0.413,24,0.522,1,1,0.5,6,3,29,17,8,10,28,0.174,0.217,0.609,17.638,58,riffle_perfect
0,26,18,3,47,0.553,29,0.617,3,0,1.0,1,2,28,19,16,14,17,0.34,0.298,0.362,17.644,59,riffle_perfect
0,20,19,6,45,0.444,26,0.578,3,2,0.6,3,1,25,20,11,16,18,0.244,0.356,0.4,17.646,60,riffle_perfect
0,16,23,5,44,0.364,21,0.477,4,1,0.8,0,2,25,19,7,21,16,0.159,0.477,0.364,17.65,61,riffle_perfect
0,22,18,3,43,0.512,25,0.581,6,0,1.0,1,1,25,18,14,15,14,0.326,0.349,0.326,17.644,62,riffle_perfect
0,15,28,3,46,0.326,18,0.391,1,2,0.333,1,2,32,14,6,16,24,0.13,0.348,0.522,17.643,63,riffle_perfect
0,19,28,2,49,0.388,21,0.429,1,5,0.167,0,3,29,20,12,15,22,0.245,0.306,0.449,17.644,64,riffle_perfect
0,17,20,8,45,0.378,25,0.556,1,0,1.0,1,1,24,21,12,19,14,0.267,0.422,0.311,17.65,65,riffle_perfect
0,26,15,3,44,0.591,29,0.659,7,3,0.7,2,1,30,14,12,10,22,0.273,0.227,0.5,17.659,66,riffle_perfect
0,20,19,6,45,0.444,26,0.578,3,0,1.0,2,3,24,21,14,14,17,0.311,0.311,0.378,17.661,67,riffle_perfect
0,18,25,3,46,0.391,21,0.457,2,3,0.4,1,1,26,20,9,14,23,0.196,0.304,0.5,17.662,68,riffle_perfect
0,18,22,3,43,0.419,21,0.488,4,3,0.571,2,4,30,13,11,14,18,0.256,0.326,0.419,17.674,69,riffle_perfect
0,23,22,3,48,0.479,26,0.542,4,1,0.8,2,4,25,23,13,14,21,0.271,0.292,0.438,17.671,70,riffle_perfect
0,20,19,6,45,0.444,26,0.578,5,2,0.714,2,2,27,18,12,9,24,0.267,0.2,0.533,17.669,71,riffle_perfect
0,22,22,3,47,0.468,25,0.532,2,2,0.5,1,3,30,17,10,16,21,0.213,0.34,0.447,17.663,72,riffle_perfect
0,19,25,2,46,0.413,21,0.457,1,6,0.143,2,1,30,16,8,16,22,0.174,0.348,0.478,17.66,73,riffle_perfect
0,18,24,2,44,0.409,20,0.455,2,2,0.5,0,1,27,17,9,13,22,0.205,0.295,0.5,17.664,74,riffle_perfect
0,25,18,4,47,0.532,29,0.617,8,0,1.0,2,3,25,22,13,16,18,0.277,0.34,0.383,17.67,75,riffle_perfect
0,20,19,6,45,0.444,26,0.578,3,2,0.6,4,1,32,13,8,19,18,0.178,0.422,0.4,17.677,76,riffle_perfect
0,20,19,7,46,0.435,27,0.587,4,0,1.0,5,1,32,14,4,18,24,0.087,0.391,0.522,17.664,77,riffle_perfect
0,25,17,1,43,0.581,26,0.605,4,2,0.667,3,1,25,18,14,13,16,0.326,0.302,0.372,17.664,78,riffle_perfect
0,21,21,4,46,0.457,25,0.543,2,1,0.667,4,1,25,21,9,14,23,0.196,0.304,0.5,17.666,79,riffle_perfect
0,22,18,4,44,0.5,26,0.591,2,1,0.667,4,2,23,21,10,17,17,0.227,0.386,0.386,17.666,80,riffle_perfect
0,24,17,4,45,0.533,28,0.622,6,2,0.75,1,2,28,17,14,14,17,0.311,0.311,0.378,17.664,81,riffle_perfect
0,19,29,0,48,0.396,19,0.396,4,7,0.364,2,3,28,20,9,22,17,0.188,0.458,0.354,17.674,82,riffle_perfect
0,20,28,1,49,0.408,21,0.429,3,3,0.5,3,5,35,14,4,16,29,0.082,0.327,0.592,17.677,83,riffle_perfect
0,25,16,4,45,0.556,29,0.644,4,3,0.571,1,4,33,12,18,5,22,0.4,0.111,0.489,17.673,84,riffle_perfect
0,18,26,2,46,0.391,20,0.435,2,1,0.667,4,3,30,16,8,17,21,0.174,0.37,0.457,17.662,85,riffle_perfect
0,14,28,3,45,0.311,17,0.378,2,2,0.5,0,2,28,17,5,18,22,0.111,0.4,0.489,17.669,86,riffle_perfect
0,20,18,7,45,0.444,27,0.6,3,2,0.6,1,2,30,15,15,10,20,0.333,0.222,0.444,17.668,87,riffle_perfect
0,24,17,3,44,0.545,27,0.614,5,3,0.625,3,2,26,18,13,14,17,0.295,0.318,0.386,17.67,88,riffle_perfect
0,18,21,6,45,0.4,24,0.533,2,0,1.0,2,0,26,19,11,14,20,0.244,0.311,0.444,17.672,89,riffle_perfect
0,27,15,4,46,0.587,31,0.674,2,3,0.4,5,1,30,16,12,16,18,0.261,0.348,0.391,17.671,90,riffle_perfect
0,21,21,4,46,0.457,25,0.543,3,1,0.75,3,1,29,17,13,10,23,0.283,0.217,0.5,17.665,91,riffle_perfect
0,23,14,5,42,0.548,28,0.667,5,1,0.833,4,0,21,21,10,17,15,0.238,0.405,0.357,17.663,92,riffle_perfect
0,24,21,4,49,0.49,28,0.571,2,3,0.4,1,2,31,18,18,13,18,0.367,0.265,0.367,17.668,93,riffle_perfect
0,19,24,4,47,0.404,23,0.489,1,2,0.333,1,3,29,18,10,15,22,0.213,0.319,0.468,17.662,94,riffle_perfect
0,16,26,4,46,0.348,20,0.435,1,3,0.25,1,1,31,15,9,17,20,0.196,0.37,0.435,17.656,95,riffle_perfect
0,19,22,4,45,0.422,23,0.511,2,1,0.667,4,3,32,13,6,21,18,0.133,0.467,0.4,17.655,96,riffle_perfect
0,16,24,7,47,0.34,23,0.489,1,2,0.333,2,1,34,13,5,15,27,0.106,0.319,0.574,17.684,1,riffle_perfect
0,26,15,4,45,0.578,30,0.667,2,1,0.667,2,3,24,21,13,14,18,0.289,0.311,0.4,18.03,2,riffle_perfect
0,21,20,6,47,0.447,27,0.574,4,1,0.8,2,1,27,20,12,12,23,0.255,0.255,0.489,17.812,3,riffle_perfect
0,15,22,7,44,0.341,22,0.5,2,2,0.5,1,3,23,21,9,20,15,0.205,0.455,0.341,17.96,4,riffle_perfect
0,16,24,5,45,0.356,21,0.467,3,2,0.6,1,1,28,17,3,20,22,0.067,0.444,0.489,18.006,5,riffle_perfect
0,17,22,5,44,0.386,22,0.5,2,2,0.5,2,0,30,14,6,15,23,0.136,0.341,0.523,17.862,6,riffle_perfect
0,18,22,3,43,0.419,21,0.488,6,0,1.0,3,1,24,19,6,19,18,0.14,0.442,0.419,17.947,7,riffle_perfect
0,22,19,3,44,0.5,25,0.568,4,1,0.8,2,0,26,18,11,16,17,0.25,0.364,0.386,17.917,8,riffle_perfect
0,24,20,3,47,0.511,27,0.574,1,3,0.25,3,1,34,13,13,10,24,0.277,0.213,0.511,17.901,9,riffle_perfect
0,18,24,3,45,0.4,21,0.467,3,3,0.5,1,2,29,16,12,11,22,0.267,0.244,0.489,17.869,10,riffle_perfect
0,18,23,3,44,0.409,21,0.477,4,3,0.571,1,5,26,18,14,12,18,0.318,0.273,0.409,17.862,11,riffle_perfect
0,19,19,7,45,0.422,26,0.578,2,0,1.0,2,3,33,12,7,13,25,0.156,0.289,0.556,17.799,12,riffle_perfect
0,17,27,3,47,0.362,20,0.426,0,3,0.0,3,2,26,21,11,13,23,0.234,0.277,0.489,17.832,13,riffle_perfect
0,20,21,3,44,0.455,23,0.523,3,2,0.6,2,1,22,22,10,17,17,0.227,0.386,0.386,17.8,14,riffle_perfect
0,18,23,4,45,0.4,22,0.489,3,1,0.75,0,1,25,20,12,15,18,0.267,0.333,0.4,17.79,15,riffle_perfect
0,19,22,1,42,0.452,20,0.476,4,2,0.667,0,1,26,16,11,14,17,0.262,0.333,0.405,17.792,16,riffle_perfect
0,19,22,5,46,0.413,24,0.522,2,3,0.4,1,2,33,13,9,18,19,0.196,0.391,0.413,17.777,17,riffle_perfect
0,19,17,8,44,0.432,27,0.614,5,1,0.833,2,1,28,16,12,11,21,0.273,0.25,0.477,17.799,18,riffle_perfect
0,20,21,4,45,0.444,24,0.533,4,1,0.8,2,2,26,19,10,16,19,0.222,0.356,0.422,17.752,19,riffle_perfect
0,21,17,6,44,0.477,27,0.614,2,1,0.667,3,0,30,14,9,12,23,0.205,0.273,0.523,17.736,20,riffle_perfect
0,23,22,0,45,0.511,23,0.511,5,1,0.833,0,3,26,19,17,9,19,0.378,0.2,0.422,17.752,21,riffle_perfect
0,13,26,6,45,0.289,19,0.422,1,0,1.0,1,0,31,14,8,13,24,0.178,0.289,0.533,17.743,22,riffle_perfect
0,21,23,0,44,0.477,21,0.477,1,0,1.0,3,1,29,15,14,7,23,0.318,0.159,0.523,17.692,23,riffle_perfect
0,20,20,5,45,0.444,25,0.556,3,2,0.6,3,0,28,17,10,16,19,0.222,0.356,0.422,17.662,24,riffle_perfect
0,16,27,1,44,0.364,17,0.386,1,3,0.25,3,1,32,12,9,10,25,0.205,0.227,0.568,17.642,25,riffle_perfect
0,23,20,3,46,0.5,26,0.565,3,2,0.6,2,4,34,12,13,7,26,0.283,0.152,0.565,17.631,26,riffle_perfect
0,16,24,5,45,0.356,21,0.467,2,3,0.4,3,2,25,20,7,19,19,0.156,0.422,0.422,17.627,27,riffle_perfect
0,15,31,2,48,0.312,17,0.354,2,2,0.5,5,3,31,17,4,19,25,0.083,0.396,0.521,17.614,28,riffle_perfect
0,22,24,4,50,0.44,26,0.52,3,3,0.5,2,0,24,26,13,17,20,0.26,0.34,0.4,17.632,29,riffle_perfect
0,19,24,4,47,0.404,23,0.489,4,1,0.8,2,4,25,22,12,16,19,0.255,0.34,0.404,17.652,30,riffle_perfect
0,17,26,2,45,0.378,19,0.422,1,2,0.333,1,5,31,14,8,17,20,0.178,0.378,0.444,17.675,31,riffle_perfect
0,26,15,4,45,0.578,30,0.667,2,2,0.5,3,2,28,17,16,11,18,0.356,0.244,0.4,17.667,32,riffle_perfect
0,18,25,2,45,0.4,20,0.444,2,2,0.5,3,5,28,17,10,13,22,0.222,0.289,0.489,17.654,33,riffle_perfect
0,21,21,2,44,0.477,23,0.523,3,4,0.429,3,1,26,18,10,13,21,0.227,0.295,0.477,17.655,34,riffle_perfect
0,25,21,1,47,0.532,26,0.553,3,0,1.0,2,6,24,23,16,11,20,0.34,0.234,0.426,17.639,35,riffle_perfect
0,14,28,5,47,0.298,19,0.404,2,3,0.4,2,3,33,14,6,18,23,0.128,0.383,0.489,17.651,36,riffle_perfect
0,23,22,2,47,0.489,25,0.532,3,2,0.6,2,1,29,18,11,11,25,0.234,0.234,0.532,17.644,37,riffle_perfect
0,20,28,0,48,0.417,20,0.417,1,1,0.5,1,2,30,18,10,14,24,0.208,0.292,0.5,17.618,38,riffle_perfect
0,17,21,7,45,0.378,24,0.533,2,3,0.4,2,1,29,16,8,14,23,0.178,0.311,0.511,17.622,39,riffle_perfect
0,15,24,5,44,0.341,20,0.455,1,1,0.5,0,1,29,15,6,16,22,0.136,0.364,0.5,17.637,40,riffle_perfect
0,17,25,4,46,0.37,21,0.457,0,3,0.0,1,3,35,11,7,11,28,0.152,0.239,0.609,17.632,41,riffle_perfect
0,24,19,4,47,0.511,28,0.596,3,2,0.6,2,2,32,15,11,12,24,0.234,0.255,0.511,17.622,42,riffle_perfect
0,24,16,3,43,0.558,27,0.628,3,1,0.75,2,0,19,24,19,11,13,0.442,0.256,0.302,17.61,43,riffle_perfect
0,20,30,2,52,0.385,22,0.423,1,2,0.333,6,5,29,23,8,20,24,0.154,0.385,0.462,17.596,44,riffle_perfect
0,23,18,6,47,0.489,29,0.617,5,1,0.833,4,4,26,21,13,12,22,0.277,0.255,0.468,17.579,45,riffle_perfect
0,17,22,4,43,0.395,21,0.488,3,1,0.75,1,3,27,16,11,14,18,0.256,0.326,0.419,17.596,46,riffle_perfect
0,16,25,4,45,0.356,20,0.444,1,3,0.25,2,3,28,17,8,13,24,0.178,0.289,0.533,17.592,47,riffle_perfect
0,19,22,3,44,0.432,22,0.5,2,3,0.4,3,2,27,17,14,10,20,0.318,0.227,0.455,17.592,48,riffle_perfect
0,21,22,4,47,0.447,25,0.532,2,0,1.0,1,3,30,17,13,14,20,0.277,0.298,0.426,17.576,49,riffle_perfect
0,19,26,3,48,0.396,22,0.458,2,1,0.667,2,4,28,20,11,20,17,0.229,0.417,0.354,17.566,50,riffle_perfect
0,19,25,1,45,0.422,20,0.444,7,4,0.636,2,3,27,18,11,10,24,0.244,0.222,0.533,17.567,51,riffle_perfect
0,19,20,6,45,0.422,25,0.556,1,2,0.333,3,2,27,18,9,16,20,0.2,0.356,0.444,17.56,52,riffle_perfect
0,16,27,2,45,0.356,18,0.4,2,2,0.5,1,3,31,14,7,13,25,0.156,0.289,0.556,17.564,53,riffle_perfect
0,21,22,2,45,0.467,23,0.511,2,3,0.4,1,2,28,17,16,10,19,0.356,0.222,0.422,17.57,54,riffle_perfect
0,19,22,3,44,0.432,22,0.5,3,2,0.6,3,2,24,20,11,14,19,0.25,0.318,0.432,17.564,55,riffle_perfect
0,15,25,5,45,0.333,20,0.444,3,3,0.5,2,1,29,16,9,15,21,0.2,0.333,0.467,17.573,56,riffle_perfect
0,21,21,3,45,0.467,24,0.533,5,1,0.833,0,3,21,24,13,13,19,0.289,0.289,0.422,17.571,57,riffle_perfect
0,27,19,1,47,0.574,28,0.596,5,0,1.0,3,0,32,15,11,11,25,0.234,0.234,0.532,17.563,58,riffle_perfect
0,20,25,1,46,0.435,21,0.457,6,3,0.667,2,1,20,26,15,16,15,0.326,0.348,0.326,17.564,59,riffle_perfect
0,23,22,3,48,0.479,26,0.542,8,4,0.667,3,2,25,23,13,14,21,0.271,0.292,0.438,17.569,60,riffle_perfect
0,19,23,4,46,0.413,23,0.5,0,0,0,0,1,32,14,10,13,23,0.217,0.283,0.5,17.563,61,riffle_perfect
0,21,21,2,44,0.477,23,0.523,2,3,0.4,2,0,27,17,11,14,19,0.25,0.318,0.432,17.571,62,riffle_perfect
0,20,25,4,49,0.408,24,0.49,5,4,0.556,4,4,32,17,11,10,28,0.224,0.204,0.571,17.572,63,riffle_perfect
0,16,21,6,43,0.372,22,0.512,3,0,1.0,1,0,30,13,6,13,24,0.14,0.302,0.558,17.568,64,riffle_perfect
0,16,27,3,46,0.348,19,0.413,3,5,0.375,3,1,26,20,7,17,22,0.152,0.37,0.478,17.565,65,riffle_perfect
0,16,22,6,44,0.364,22,0.5,1,1,0.5,2,1,26,18,10,12,22,0.227,0.273,0.5,17.576,66,riffle_perfect
0,16,26,2,44,0.364,18,0.409,1,5,0.167,1,3,29,15,10,14,20,0.227,0.318,0.455,17.582,67,riffle_perfect
0,19,21,3,43,0.442,22,0.512,1,3,0.25,1,0,27,16,9,16,18,0.209,0.372,0.419,17.593,68,riffle_perfect
0,18,24,5,47,0.383,23,0.489,1,1,0.5,4,4,23,24,11,16,20,0.234,0.34,0.426,17.593,69,riffle_perfect
0,18,24,1,43,0.419,19,0.442,5,5,0.5,2,2,26,17,12,11,20,0.279,0.256,0.465,17.598,70,riffle_perfect
0,21,21,3,45,0.467,24,0.533,2,4,0.333,2,3,26,19,12,16,17,0.267,0.356,0.378,17.604,71,riffle_perfect
0,21,22,2,45,0.467,23,0.511,1,0,1.0,4,4,27,18,11,13,21,0.244,0.289,0.467,17.602,72,riffle_perfect
0,21,22,2,45,0.467,23,0.511,3,3,0.5,2,3,25,20,14,13,18,0.311,0.289,0.4,17.604,73,riffle_perfect
0,17,24,6,47,0.362,23,0.489,2,4,0.333,2,2,26,21,10,15,22,0.213,0.319,0.468,17.605,74,riffle_perfect
0,21,17,6,44,0.477,27,0.614,0,1,0.0,1,1,26,18,14,14,16,0.318,0.318,0.364,17.604,75,riffle_perfect
0,15,25,6,46,0.326,21,0.457,3,2,0.6,1,4,30,16,11,11,24,0.239,0.239,0.522,17.601,76,riffle_perfect
0,18,23,5,46,0.391,23,0.5,1,2,0.333,1,2,33,13,13,6,27,0.283,0.13,0.587,17.6,77,riffle_perfect
0,26,15,3,44,0.591,29,0.659,4,1,0.8,3,2,21,23,18,9,17,0.409,0.205,0.386,17.598,78,riffle_perfect
0,15,29,3,47,0.319,18,0.383,1,0,1.0,4,2,26,21,4,21,22,0.085,0.447,0.468,17.595,79,riffle_perfect
0,25,13,6,44,0.568,31,0.705,3,3,0.5,3,1,29,15,10,14,20,0.227,0.318,0.455,17.596,80,riffle_perfect
0,26,18,2,46,0.565,28,0.609,4,3,0.571,4,1,29,17,18,11,17,0.391,0.239,0.37,17.592,81,riffle_perfect
0,19,21,3,43,0.442,22,0.512,4,2,0.667,1,2,29,14,8,14,21,0.186,0.326,0.488,17.596,82,riffle_perfect
0,21,21,3,45,0.467,24,0.533,4,0,1.0,3,0,27,18,8,17,20,0.178,0.378,0.444,17.599,83,riffle_perfect
0,19,20,6,45,0.422,25,0.556,2,2,0.5,3,2,28,17,10,15,20,0.222,0.333,0.444,17.603,84,riffle_perfect
0,21,25,2,48,0.438,23,0.479,1,5,0.167,2,3,31,17,9,19,20,0.188,0.396,0.417,17.6,85,riffle_perfect
0,25,15,4,44,0.568,29,0.659,5,0,1.0,2,0,23,21,13,13,18,0.295,0.295,0.409,17.597,86,riffle_perfect
0,20,21,5,46,0.435,25,0.543,4,0,1.0,4,4,32,14,7,15,24,0.152,0.326,0.522,17.59,87,riffle_perfect
0,19,21,4,44,0.432,23,0.523,3,1,0.75,1,1,29,15,8,19,17,0.182,0.432,0.386,17.592,88,riffle_perfect
0,16,22,7,45,0.356,23,0.511,2,2,0.5,2,2,32,13,11,13,21,0.244,0.289,0.467,17.595,89,riffle_perfect
0,21,24,1,46,0.457,22,0.478,2,2,0.5,3,1,31,15,10,16,20,0.217,0.348,0.435,17.605,90,riffle_perfect
0,25,17,1,43,0.581,26,0.605,3,3,0.5,1,4,28,15,12,13,18,0.279,0.302,0.419,17.613,91,riffle_perfect
0,18,24,2,44,0.409,20,0.455,3,3,0.5,1,1,29,15,12,11,21,0.273,0.25,0.477,17.616,92,riffle_perfect
0,19,20,4,43,0.442,23,0.535,2,2,0.5,2,3,29,14,10,19,14,0.233,0.442,0.326,17.621,93,riffle_perfect
0,23,17,2,42,0.548,25,0.595,2,3,0.4,0,1,26,16,16,11,15,0.381,0.262,0.357,17.624,94,riffle_perfect
0,19,23,4,46,0.413,23,0.5,2,2,0.5,2,1,28,18,8,18,20,0.174,0.391,0.435,17.629,95,riffle_perfect
0,16,24,6,46,0.348,22,0.478,3,2,0.6,2,3,26,20,10,18,18,0.217,0.391,0.391,17.634,96,riffle_perfect
0,21,23,4,48,0.438,25,0.521,3,4,0.429,2,3,29,19,9,20,19,0.188,0.417,0.396,17.967,1,riffle_clumpy
0,20,21,5,46,0.435,25,0.543,6,1,0.857,1,3,26,20,8,15,23,0.174,0.326,0.5,17.967,2,riffle_clumpy
0,20,22,3,45,0.444,23,0.511,0,2,0.0,6,2,28,17,11,9,25,0.244,0.2,0.556,18.089,3,riffle_clumpy
0,17,23,9,49,0.347,26,0.531,1,7,0.125,2,2,31,18,8,18,23,0.163,0.367,0.469,18.122,4,riffle_clumpy
0,19,22,4,45,0.422,23,0.511,2,3,0.4,2,1,28,17,10,17,18,0.222,0.378,0.4,18.126,5,riffle_clumpy
0,16,28,4,48,0.333,20,0.417,6,2,0.75,1,2,31,17,8,13,27,0.167,0.271,0.562,18.137,6,riffle_clumpy
0,24,18,3,45,0.533,27,0.6,4,2,0.667,3,0,25,20,17,11,17,0.378,0.244,0.378,18.078,7,riffle_clumpy
0,21,19,5,45,0.467,26,0.578,3,2,0.6,2,2,25,20,11,13,21,0.244,0.289,0.467,18.073,8,riffle_clumpy
0,12,29,4,45,0.267,16,0.356,1,4,0.2,1,3,28,17,9,16,20,0.2,0.356,0.444,18.08,9,riffle_clumpy
0,24,18,1,43,0.558,25,0.581,6,0,1.0,0,0,27,16,14,9,20,0.326,0.209,0.465,18.083,10,riffle_clumpy
0,17,23,5,45,0.378,22,0.489,3,1,0.75,4,3,27,18,9,16,20,0.2,0.356,0.444,18.019,11,riffle_clumpy
0,21,18,4,43,0.488,25,0.581,3,1,0.75,2,3,29,14,13,10,20,0.302,0.233,0.465,17.959,12,riffle_clumpy
0,26,16,2,44,0.591,28,0.636,5,1,0.833,3,1,26,18,10,15,19,0.227,0.341,0.432,17.914,13,riffle_clumpy
0,21,20,5,46,0.457,26,0.565,4,2,0.667,0,3,25,21,8,18,20,0.174,0.391,0.435,17.915,14,riffle_clumpy
0,23,19,2,44,0.523,25,0.568,3,1,0.75,2,2,27,17,12,15,17,0.273,0.341,0.386,17.914,15,riffle_clumpy
0,21,21,5,47,0.447,26,0.553,6,2,0.75,4,1,27,20,8,18,21,0.17,0.383,0.447,17.863,16,riffle_clumpy
0,16,21,6,43,0.372,22,0.512,1,1,0.5,2,3,35,8,8,13,22,0.186,0.302,0.512,17.874,17,riffle_clumpy
0,28,14,4,46,0.609,32,0.696,2,1,0.667,5,1,32,14,9,12,25,0.196,0.261,0.543,17.831,18,riffle_clumpy
0,13,32,5,50,0.26,18,0.36,1,2,0.333,0,4,33,17,6,13,31,0.12,0.26,0.62,17.856,19,riffle_clumpy
0,19,19,7,45,0.422,26,0.578,3,2,0.6,3,5,32,13,9,15,21,0.2,0.333,0.467,17.881,20,riffle_clumpy
0,19,21,5,45,0.422,24,0.533,2,3,0.4,2,3,33,12,8,17,20,0.178,0.378,0.444,17.863,21,riffle_clumpy
0,11,25,8,44,0.25,19,0.432,0,0,0,1,0,29,15,8,17,19,0.182,0.386,0.432,17.862,22,riffle_clumpy
0,18,25,2,45,0.4,20,0.444,3,1,0.75,3,3,28,17,8,15,22,0.178,0.333,0.489,17.824,23,riffle_clumpy
0,21,20,3,44,0.477,24,0.545,3,2,0.6,3,2,27,17,13,12,19,0.295,0.273,0.432,17.805,24,riffle_clumpy
0,25,21,1,47,0.532,26,0.553,5,2,0.714,0,2,28,19,12,15,20,0.255,0.319,0.426,17.798,25,riffle_clumpy
0,17,23,5,45,0.378,22,0.489,2,1,0.667,1,1,24,21,10,17,18,0.222,0.378,0.4,17.774,26,riffle_clumpy
0,21,20,3,44,0.477,24,0.545,0,1,0.0,2,1,26,18,13,13,18,0.295,0.295,0.409,17.744,27,riffle_clumpy
0,22,18,5,45,0.489,27,0.6,6,2,0.75,2,0,28,17,12,14,19,0.267,0.311,0.422,17.741,28,riffle_clumpy
0,29,13,2,44,0.659,31,0.705,7,1,0.875,1,1,24,20,13,14,17,0.295,0.318,0.386,17.745,29,riffle_clumpy
0,16,23,4,43,0.372,20,0.465,2,2,0.5,3,0,24,19,6,16,21,0.14,0.372,0.488,17.74,30,riffle_clumpy
0,23,21,2,46,0.5,25,0.543,4,2,0.667,0,2,29,17,13,12,21,0.283,0.261,0.457,17.744,31,riffle_clumpy
0,28,12,7,47,0.596,35,0.745,0,2,0.0,1,0,28,19,15,14,18,0.319,0.298,0.383,17.762,32,riffle_clumpy
0,19,24,4,47,0.404,23,0.489,3,3,0.5,0,3,32,15,12,14,21,0.255,0.298,0.447,17.774,33,riffle_clumpy
0,20,25,0,45,0.444,20,0.444,3,2,0.6,2,4,30,15,10,10,25,0.222,0.222,0.556,17.774,34,riffle_clumpy
0,19,22,3,44,0.432,22,0.5,6,1,0.857,1,4,28,16,9,15,20,0.205,0.341,0.455,17.777,35,riffle_clumpy
0,20,21,6,47,0.426,26,0.553,2,2,0.5,6,2,25,22,10,16,21,0.213,0.34,0.447,17.745,36,riffle_clumpy
0,26,16,2,44,0.591,28,0.636,1,2,0.333,4,2,27,17,11,15,18,0.25,0.341,0.409,17.735,37,riffle_clumpy
0,20,18,6,44,0.455,26,0.591,2,1,0.667,3,2,28,16,14,10,20,0.318,0.227,0.455,17.737,38,riffle_clumpy
0,23,18,4,45,0.511,27,0.6,5,3,0.625,2,2,23,22,12,14,19,0.267,0.311,0.422,17.743,39,riffle_clumpy
0,25,18,3,46,0.543,28,0.609,9,1,0.9,2,1,27,19,14,14,18,0.304,0.304,0.391,17.754,40,riffle_clumpy
0,18,20,6,44,0.409,24,0.545,1,2,0.333,0,4,26,18,7,17,20,0.159,0.386,0.455,17.755,41,riffle_clumpy
0,19,27,1,47,0.404,20,0.426,0,3,0.0,0,6,25,22,12,17,18,0.255,0.362,0.383,17.762,42,riffle_clumpy
0,22,17,6,45,0.489,28,0.622,2,2,0.5,4,2,25,20,8,17,20,0.178,0.378,0.444,17.766,43,riffle_clumpy
0,20,16,6,42,0.476,26,0.619,2,2,0.5,1,1,28,14,13,12,17,0.31,0.286,0.405,17.773,44,riffle_clumpy
0,19,23,4,46,0.413,23,0.5,5,4,0.556,2,2,25,21,11,16,19,0.239,0.348,0.413,17.772,45,riffle_clumpy
0,22,21,2,45,0.489,24,0.533,4,1,0.8,1,3,30,15,11,13,21,0.244,0.289,0.467,17.76,46,riffle_clumpy
0,14,22,8,44,0.318,22,0.5,5,1,0.833,2,2,28,16,7,15,22,0.159,0.341,0.5,17.767,47,riffle_clumpy
0,20,20,6,46,0.435,26,0.565,4,1,0.8,3,3,28,18,11,12,23,0.239,0.261,0.5,17.762,48,riffle_clumpy
0,17,22,5,44,0.386,22,0.5,4,4,0.5,2,0,29,15,8,10,26,0.182,0.227,0.591,17.777,49,riffle_clumpy
0,16,29,1,46,0.348,17,0.37,1,3,0.25,0,4,27,19,11,17,18,0.239,0.37,0.391,17.783,50,riffle_clumpy
0,23,21,4,48,0.479,27,0.562,5,1,0.833,3,0,26,22,11,18,19,0.229,0.375,0.396,17.788,51,riffle_clumpy
0,17,25,2,44,0.386,19,0.432,0,1,0.0,3,3,30,14,7,15,22,0.159,0.341,0.5,17.788,52,riffle_clumpy
0,19,23,2,44,0.432,21,0.477,5,2,0.714,2,3,27,17,10,9,25,0.227,0.205,0.568,17.784,53,riffle_clumpy
0,17,26,4,47,0.362,21,0.447,2,3,0.4,0,2,27,20,10,15,22,0.213,0.319,0.468,17.786,54,riffle_clumpy
0,16,24,5,45,0.356,21,0.467,4,1,0.8,1,4,24,21,9,21,15,0.2,0.467,0.333,17.788,55,riffle_clumpy
0,20,19,4,43,0.465,24,0.558,2,3,0.4,4,2,30,13,11,11,21,0.256,0.256,0.488,17.78,56,riffle_clumpy
0,19,21,4,44,0.432,23,0.523,1,2,0.333,1,3,30,14,12,10,22,0.273,0.227,0.5,17.785,57,riffle_clumpy
0,23,15,8,46,0.5,31,0.674,3,1,0.75,2,1,33,13,11,16,19,0.239,0.348,0.413,17.784,58,riffle_clumpy
0,25,15,4,44,0.568,29,0.659,4,2,0.667,1,1,32,12,15,8,21,0.341,0.182,0.477,17.775,59,riffle_clumpy
0,23,19,5,47,0.489,28,0.596,5,3,0.625,3,2,27,20,15,13,19,0.319,0.277,0.404,17.769,60,riffle_clumpy
0,18,22,4,44,0.409,22,0.5,4,5,0.444,2,0,24,20,9,14,21,0.205,0.318,0.477,17.773,61,riffle_clumpy
0,23,20,4,47,0.489,27,0.574,4,5,0.444,2,3,25,22,15,15,17,0.319,0.319,0.362,17.781,62,riffle_clumpy
0,19,20,6,45,0.422,25,0.556,0,4,0.0,2,0,26,19,11,20,14,0.244,0.444,0.311,17.787,63,riffle_clumpy
0,20,20,5,45,0.444,25,0.556,4,4,0.5,3,2,30,15,8,15,22,0.178,0.333,0.489,17.79,64,riffle_clumpy
0,15,22,9,46,0.326,24,0.522,1,3,0.25,1,1,27,19,5,24,17,0.109,0.522,0.37,17.804,65,riffle_clumpy
0,19,19,6,44,0.432,25,0.568,3,3,0.5,2,2,26,18,13,13,18,0.295,0.295,0.409,17.804,66,riffle_clumpy
0,25,16,4,45,0.556,29,0.644,1,0,1.0,3,2,23,22,15,14,16,0.333,0.311,0.356,17.795,67,riffle_clumpy
0,18,19,7,44,0.409,25,0.568,2,1,0.667,1,2,27,17,12,15,17,0.273,0.341,0.386,17.805,68,riffle_clumpy
0,20,20,6,46,0.435,26,0.565,3,3,0.5,1,6,27,19,14,12,20,0.304,0.261,0.435,17.809,69,riffle_clumpy
0,18,24,2,44,0.409,20,0.455,0,5,0.0,2,1,24,20,8,16,20,0.182,0.364,0.455,17.815,70,riffle_clumpy
0,20,21,4,45,0.444,24,0.533,1,0,1.0,3,0,23,22,10,20,15,0.222,0.444,0.333,17.822,71,riffle_clumpy
0,19,21,7,47,0.404,26,0.553,2,5,0.286,2,2,28,19,10,19,18,0.213,0.404,0.383,17.826,72,riffle_clumpy
0,17,28,3,48,0.354,20,0.417,2,4,0.333,3,4,36,12,9,11,28,0.188,0.229,0.583,17.822,73,riffle_clumpy
0,17,22,5,44,0.386,22,0.5,3,1,0.75,1,5,28,16,11,11,22,0.25,0.25,0.5,17.82,74,riffle_clumpy
0,22,18,5,45,0.489,27,0.6,7,1,0.875,2,1,25,20,13,16,16,0.289,0.356,0.356,17.82,75,riffle_clumpy
0,12,28,5,45,0.267,17,0.378,1,2,0.333,2,1,29,16,6,17,22,0.133,0.378,0.489,17.826,76,riffle_clumpy
0,22,20,2,44,0.5,24,0.545,4,2,0.667,2,0,30,14,12,12,20,0.273,0.273,0.455,17.824,77,riffle_clumpy
0,25,25,1,51,0.49,26,0.51,2,3,0.4,4,3,29,22,11,17,23,0.216,0.333,0.451,17.817,78,riffle_clumpy
0,21,21,3,45,0.467,24,0.533,3,1,0.75,4,3,32,13,7,13,25,0.156,0.289,0.556,17.82,79,riffle_clumpy
0,21,25,2,48,0.438,23,0.479,6,3,0.667,1,1,25,23,12,15,21,0.25,0.312,0.438,17.817,80,riffle_clumpy
0,15,25,5,45,0.333,20,0.444,1,1,0.5,1,3,24,21,11,13,21,0.244,0.289,0.467,17.81,81,riffle_clumpy
0,17,21,6,44,0.386,23,0.523,3,0,1.0,0,2,31,13,8,13,23,0.182,0.295,0.523,17.812,82,riffle_clumpy
0,22,20,6,48,0.458,28,0.583,3,4,0.429,4,1,29,19,11,17,20,0.229,0.354,0.417,17.807,83,riffle_clumpy
0,20,22,3,45,0.444,23,0.511,1,2,0.333,0,2,25,20,7,17,21,0.156,0.378,0.467,17.807,84,riffle_clumpy
0,16,29,2,47,0.34,18,0.383,1,1,0.5,2,2,21,26,9,18,20,0.191,0.383,0.426,17.807,85,riffle_clumpy
0,21,21,4,46,0.457,25,0.543,4,3,0.571,3,3,32,14,7,16,23,0.152,0.348,0.5,17.798,86,riffle_clumpy
0,16,23,5,44,0.364,21,0.477,2,1,0.667,3,2,28,16,8,13,23,0.182,0.295,0.523,17.792,87,riffle_clumpy
0,25,15,3,43,0.581,28,0.651,6,0,1.0,3,0,24,19,12,16,15,0.279,0.372,0.349,17.792,88,riffle_clumpy
0,17,24,5,46,0.37,22,0.478,2,3,0.4,1,3,24,22,9,17,20,0.196,0.37,0.435,17.795,89,riffle_clumpy
0,19,21,5,45,0.422,24,0.533,4,0,1.0,1,4,32,13,12,9,24,0.267,0.2,0.533,17.797,90,riffle_clumpy
0,21,21,4,46,0.457,25,0.543,5,0,1.0,3,1,33,13,11,11,24,0.239,0.239,0.522,17.793,91,riffle_clumpy
0,23,20,1,44,0.523,24,0.545,5,0,1.0,0,1,27,17,13,12,19,0.295,0.273,0.432,17.794,92,riffle_clumpy
0,19,23,2,44,0.432,21,0.477,0,1,0.0,2,3,30,14,14,12,18,0.318,0.273,0.409,17.796,93,riffle_clumpy
0,20,21,5,46,0.435,25,0.543,5,3,0.625,3,2,31,15,10,14,22,0.217,0.304,0.478,17.793,94,riffle_clumpy
0,25,17,4,46,0.543,29,0.63,2,0,1.0,3,0,31,15,13,11,22,0.283,0.239,0.478,17.793,95,riffle_clumpy
0,20,21,6,47,0.426,26,0.553,1,1,0.5,3,1,35,12,12,12,23,0.255,0.255,0.489,17.793,96,riffle_clumpy
0,14,25,6,45,0.311,20,0.444,3,4,0.429,2,3,29,16,8,15,22,0.178,0.333,0.489,17.643,1,riffle_clumpy
0,23,20,3,46,0.5,26,0.565,7,2,0.778,2,2,27,19,16,9,21,0.348,0.196,0.457,17.907,2,riffle_clumpy
0,25,18,4,47,0.532,29,0.617,3,0,1.0,4,1,30,17,12,11,24,0.255,0.234,0.511,17.759,3,riffle_clumpy
0,27,14,2,43,0.628,29,0.674,3,2,0.6,1,0,27,16,16,12,15,0.372,0.279,0.349,17.852,4,riffle_clumpy
0,20,19,5,44,0.455,25,0.568,2,2,0.5,3,0,26,18,11,11,22,0.25,0.25,0.5,17.949,5,riffle_clumpy
0,11,27,8,46,0.239,19,0.413,0,1,0.0,4,2,26,20,6,16,24,0.13,0.348,0.522,17.877,6,riffle_clumpy
0,22,21,3,46,0.478,25,0.543,3,1,0.75,3,3,26,20,16,12,18,0.348,0.261,0.391,17.851,7,riffle_clumpy
0,21,24,2,47,0.447,23,0.489,3,2,0.6,3,2,29,18,11,16,20,0.234,0.34,0.426,17.796,8,riffle_clumpy
0,19,23,3,45,0.422,22,0.489,1,4,0.2,4,4,27,18,10,12,23,0.222,0.267,0.511,17.721,9,riffle_clumpy
0,22,19,4,45,0.489,26,0.578,3,1,0.75,3,3,24,21,11,16,18,0.244,0.356,0.4,17.725,10,riffle_clumpy
0,19,24,2,45,0.422,21,0.467,2,4,0.333,4,3,32,13,8,7,30,0.178,0.156,0.667,17.748,11,riffle_clumpy
0,26,11,5,42,0.619,31,0.738,5,3,0.625,0,1,24,18,14,14,14,0.333,0.333,0.333,17.788,12,riffle_clumpy
0,19,21,3,43,0.442,22,0.512,1,3,0.25,1,3,28,15,12,16,15,0.279,0.372,0.349,17.819,13,riffle_clumpy
0,22,17,6,45,0.489,28,0.622,4,1,0.8,2,2,30,15,11,10,24,0.244,0.222,0.533,17.836,14,riffle_clumpy
0,23,21,0,44,0.523,23,0.523,0,3,0.0,5,1,25,19,13,12,19,0.295,0.273,0.432,17.842,15,riffle_clumpy
0,16,25,4,45,0.356,20,0.444,3,1,0.75,1,2,24,21,8,21,16,0.178,0.467,0.356,17.837,16,riffle_clumpy
0,20,22,3,45,0.444,23,0.511,2,2,0.5,2,1,26,19,15,6,24,0.333,0.133,0.533,17.825,17,riffle_clumpy
0,17,21,6,44,0.386,23,0.523,4,2,0.667,2,1,33,11,8,12,24,0.182,0.273,0.545,17.836,18,riffle_clumpy
0,17,23,7,47,0.362,24,0.511,1,1,0.5,2,3,30,17,13,12,22,0.277,0.255,0.468,17.829,19,riffle_clumpy
0,16,23,5,44,0.364,21,0.477,2,4,0.333,1,2,22,22,13,17,14,0.295,0.386,0.318,17.816,20,riffle_clumpy
0,21,18,7,46,0.457,28,0.609,2,0,1.0,2,5,24,22,15,14,17,0.326,0.304,0.37,17.807,21,riffle_clumpy
0,22,19,2,43,0.512,24,0.558,7,1,0.875,2,5,22,21,13,12,18,0.302,0.279,0.419,17.833,22,riffle_clumpy
0,20,17,7,44,0.455,27,0.614,2,2,0.5,2,3,31,13,10,16,18,0.227,0.364,0.409,17.858,23,riffle_clumpy
0,17,28,4,49,0.347,21,0.429,2,4,0.333,3,4,27,22,11,17,21,0.224,0.347,0.429,17.862,24,riffle_clumpy
0,22,20,3,45,0.489,25,0.556,3,2,0.6,0,2,27,18,12,16,17,0.267,0.356,0.378,17.868,25,riffle_clumpy
0,16,27,3,46,0.348,19,0.413,2,3,0.4,1,3,30,16,6,16,24,0.13,0.348,0.522,17.831,26,riffle_clumpy
0,15,25,5,45,0.333,20,0.444,2,0,1.0,2,1,28,17,5,15,25,0.111,0.333,0.556,17.799,27,riffle_clumpy
0,16,24,4,44,0.364,20,0.455,5,2,0.714,0,5,34,10,8,13,23,0.182,0.295,0.523,17.816,28,riffle_clumpy
0,20,22,2,44,0.455,22,0.5,3,0,1.0,0,4,30,14,11,15,18,0.25,0.341,0.409,17.823,29,riffle_clumpy
0,25,18,4,47,0.532,29,0.617,1,2,0.333,5,2,28,19,10,15,22,0.213,0.319,0.468,17.819,30,riffle_clumpy
0,19,19,4,42,0.452,23,0.548,3,3,0.5,1,1,22,20,10,13,19,0.238,0.31,0.452,17.803,31,riffle_clumpy
0,22,19,2,43,0.512,24,0.558,3,0,1.0,1,3,28,15,14,12,17,0.326,0.279,0.395,17.794,32,riffle_clumpy
0,25,19,1,45,0.556,26,0.578,7,0,1.0,4,3,29,16,10,9,26,0.222,0.2,0.578,17.766,33,riffle_clumpy
0,27,15,4,46,0.587,31,0.674,4,3,0.571,5,2,27,19,19,7,20,0.413,0.152,0.435,17.744,34,riffle_clumpy
0,20,24,0,44,0.455,20,0.455,3,1,0.75,2,4,26,18,12,14,18,0.273,0.318,0.409,17.755,35,riffle_clumpy
0,20,21,5,46,0.435,25,0.543,4,1,0.8,1,1,28,18,10,18,18,0.217,0.391,0.391,17.765,36,riffle_clumpy
0,17,24,3,44,0.386,20,0.455,4,4,0.5,1,2,26,18,8,15,21,0.182,0.341,0.477,17.781,37,riffle_clumpy
0,26,19,1,46,0.565,27,0.587,1,2,0.333,4,2,29,17,12,15,19,0.261,0.326,0.413,17.768,38,riffle_clumpy
0,25,21,3,49,0.51,28,0.571,8,3,0.727,1,2,26,23,17,12,20,0.347,0.245,0.408,17.745,39,riffle_clumpy
0,12,29,8,49,0.245,20,0.408,1,4,0.2,0,3,24,25,8,21,20,0.163,0.429,0.408,17.763,40,riffle_clumpy
0,16,20,8,44,0.364,24,0.545,3,1,0.75,4,1,30,14,4,18,22,0.091,0.409,0.5,17.749,41,riffle_clumpy
0,20,24,2,46,0.435,22,0.478,1,4,0.2,3,4,27,19,14,9,23,0.304,0.196,0.5,17.76,42,riffle_clumpy
0,26,17,5,48,0.542,31,0.646,5,2,0.714,0,2,28,20,18,12,18,0.375,0.25,0.375,17.766,43,riffle_clumpy
0,21,21,2,44,0.477,23,0.523,4,2,0.667,4,2,29,15,14,9,21,0.318,0.205,0.477,17.755,44,riffle_clumpy
0,23,21,3,47,0.489,26,0.553,5,3,0.625,3,7,27,20,16,10,21,0.34,0.213,0.447,17.74,45,riffle_clumpy
0,23,17,3,43,0.535,26,0.605,4,3,0.571,3,0,22,21,14,16,13,0.326,0.372,0.302,17.748,46,riffle_clumpy
0,16,23,5,44,0.364,21,0.477,0,3,0.0,1,0,30,14,7,17,20,0.159,0.386,0.455,17.753,47,riffle_clumpy
0,18,28,0,46,0.391,18,0.391,3,2,0.6,1,2,31,15,7,15,24,0.152,0.326,0.522,17.746,48,riffle_clumpy
0,23,21,2,46,0.5,25,0.543,3,2,0.6,3,2,26,20,14,12,20,0.304,0.261,0.435,17.733,49,riffle_clumpy
0,19,22,4,45,0.422,23,0.511,2,2,0.5,4,4,33,12,10,11,24,0.222,0.244,0.533,17.727,50,riffle_clumpy
0,20,21,6,47,0.426,26,0.553,5,1,0.833,3,3,30,17,11,13,23,0.234,0.277,0.489,17.722,51,riffle_clumpy
0,15,24,8,47,0.319,23,0.489,4,1,0.8,6,1,27,20,7,17,23,0.149,0.362,0.489,17.725,52,riffle_clumpy
0,23,19,4,46,0.5,27,0.587,3,2,0.6,5,1,27,19,11,11,24,0.239,0.239,0.522,17.712,53,riffle_clumpy
0,22,19,4,45,0.489,26,0.578,2,1,0.667,3,4,31,14,7,16,22,0.156,0.356,0.489,17.715,54,riffle_clumpy
0,18,24,6,48,0.375,24,0.5,5,4,0.556,3,2,27,21,13,13,22,0.271,0.271,0.458,17.696,55,riffle_clumpy
0,14,27,6,47,0.298,20,0.426,3,3,0.5,2,2,28,19,9,11,27,0.191,0.234,0.574,17.676,56,riffle_clumpy
0,16,22,5,43,0.372,21,0.488,2,3,0.4,1,1,31,12,8,13,22,0.186,0.302,0.512,17.682,57,riffle_clumpy
0,14,26,4,44,0.318,18,0.409,4,2,0.667,2,3,33,11,8,15,21,0.182,0.341,0.477,17.687,58,riffle_clumpy
0,24,17,4,45,0.533,28,0.622,4,1,0.8,1,0,23,22,18,12,15,0.4,0.267,0.333,17.688,59,riffle_clumpy
0,20,22,3,45,0.444,23,0.511,4,3,0.571,3,2,30,15,9,9,27,0.2,0.2,0.6,17.685,60,riffle_clumpy
0,24,18,4,46,0.522,28,0.609,2,2,0.5,3,3,30,16,11,14,21,0.239,0.304,0.457,17.685,61,riffle_clumpy
0,21,21,4,46,0.457,25,0.543,4,1,0.8,1,1,23,23,13,16,17,0.283,0.348,0.37,17.693,62,riffle_clumpy
0,24,21,0,45,0.533,24,0.533,5,1,0.833,1,3,21,24,19,10,16,0.422,0.222,0.356,17.688,63,riffle_clumpy
0,22,21,3,46,0.478,25,0.543,2,1,0.667,1,3,22,24,14,13,19,0.304,0.283,0.413,17.676,64,riffle_clumpy
0,24,17,2,43,0.558,26,0.605,5,4,0.556,3,2,30,13,11,13,19,0.256,0.302,0.442,17.678,65,riffle_clumpy
0,26,15,3,44,0.591,29,0.659,2,0,1.0,1,1,24,20,18,12,14,0.409,0.273,0.318,17.689,66,riffle_clumpy
0,22,20,2,44,0.5,24,0.545,2,1,0.667,2,0,31,13,11,16,17,0.25,0.364,0.386,17.693,67,riffle_clumpy
0,21,19,4,44,0.477,25,0.568,2,0,1.0,1,0,30,14,12,10,22,0.273,0.227,0.5,17.691,68,riffle_clumpy
0,20,24,3,47,0.426,23,0.489,5,4,0.556,3,2,29,18,9,14,24,0.191,0.298,0.511,17.69,69,riffle_clumpy
0,16,29,2,47,0.34,18,0.383,2,2,0.5,2,0,27,20,6,16,25,0.128,0.34,0.532,17.688,70,riffle_clumpy
0,18,19,6,43,0.419,24,0.558,3,1,0.75,1,0,28,15,10,11,22,0.233,0.256,0.512,17.686,71,riffle_clumpy
0,24,21,4,49,0.49,28,0.571,7,3,0.7,3,3,28,21,13,12,24,0.265,0.245,0.49,17.686,72,riffle_clumpy
0,21,21,4,46,0.457,25,0.543,2,5,0.286,2,0,29,17,7,19,20,0.152,0.413,0.435,17.687,73,riffle_clumpy
0,16,24,5,45,0.356,21,0.467,2,3,0.4,2,2,29,16,10,12,23,0.222,0.267,0.511,17.693,74,riffle_clumpy
0,18,26,4,48,0.375,22,0.458,0,0,0,4,2,28,20,9,13,26,0.188,0.271,0.542,17.674,75,riffle_clumpy
0,19,19,7,45,0.422,26,0.578,5,3,0.625,2,2,28,17,10,15,20,0.222,0.333,0.444,17.671,76,riffle_clumpy
0,18,22,6,46,0.391,24,0.522,0,4,0.0,3,1,25,21,10,18,18,0.217,0.391,0.391,17.671,77,riffle_clumpy
0,15,26,3,44,0.341,18,0.409,2,2,0.5,3,5,33,11,8,12,24,0.182,0.273,0.545,17.668,78,riffle_clumpy
0,15,27,5,47,0.319,20,0.426,2,1,0.667,1,5,36,11,6,15,26,0.128,0.319,0.553,17.67,79,riffle_clumpy
0,18,21,3,42,0.429,21,0.5,3,1,0.75,0,2,30,12,10,12,20,0.238,0.286,0.476,17.671,80,riffle_clumpy
0,16,29,0,45,0.356,16,0.356,2,1,0.667,2,6,30,15,10,15,20,0.222,0.333,0.444,17.662,81,riffle_clumpy
0,22,23,4,49,0.449,26,0.531,0,1,0.0,1,3,24,25,11,17,21,0.224,0.347,0.429,17.658,82,riffle_clumpy
0,20,24,3,47,0.426,23,0.489,0,5,0.0,1,2,27,20,13,18,16,0.277,0.383,0.34,17.665,83,riffle_clumpy
0,16,26,2,44,0.364,18,0.409,1,1,0.5,2,2,26,18,9,16,19,0.205,0.364,0.432,17.673,84,riffle_clumpy
0,19,25,4,48,0.396,23,0.479,5,1,0.833,2,1,31,17,7,14,27,0.146,0.292,0.562,17.673,85,riffle_clumpy
0,19,17,8,44,0.432,27,0.614,3,2,0.6,3,4,29,15,11,14,19,0.25,0.318,0.432,17.674,86,riffle_clumpy
0,20,22,5,47,0.426,25,0.532,1,1,0.5,4,4,29,18,12,13,22,0.255,0.277,0.468,17.672,87,riffle_clumpy
0,17,24,4,45,0.378,21,0.467,3,2,0.6,2,5,30,15,7,14,24,0.156,0.311,0.533,17.672,88,riffle_clumpy
0,17,24,4,45,0.378,21,0.467,3,2,0.6,2,1,22,23,9,20,16,0.2,0.444,0.356,17.676,89,riffle_clumpy
0,17,25,4,46,0.37,21,0.457,0,2,0.0,1,4,29,17,11,18,17,0.239,0.391,0.37,17.675,90,riffle_clumpy
0,21,18,5,44,0.477,26,0.591,4,1,0.8,4,3,27,17,12,14,18,0.273,0.318,0.409,17.671,91,riffle_clumpy
0,20,20,3,43,0.465,23,0.535,6,0,1.0,0,1,29,14,14,10,19,0.326,0.233,0.442,17.67,92,riffle_clumpy
0,23,22,4,49,0.469,27,0.551,4,6,0.4,5,0,30,19,13,17,19,0.265,0.347,0.388,17.661,93,riffle_clumpy
0,20,19,7,46,0.435,27,0.587,4,1,0.8,3,2,29,17,10,15,21,0.217,0.326,0.457,17.665,94,riffle_clumpy
0,22,23,3,48,0.458,25,0.521,5,1,0.833,2,5,33,15,10,16,22,0.208,0.333,0.458,17.667,95,riffle_clumpy
0,24,17,3,44,0.545,27,0.614,2,3,0.4,3,1,28,16,16,15,13,0.364,0.341,0.295,17.664,96,riffle_clumpy
0,14,26,6,46,0.304,20,0.435,1,2,0.333,2,2,31,15,5,14,27,0.109,0.304,0.587,18.029,1,riffle_clumpy
0,16,25,2,43,0.372,18,0.419,0,2,0.0,0,2,26,17,9,16,18,0.209,0.372,0.419,17.938,2,riffle_clumpy
0,19,16,8,43,0.442,27,0.628,2,2,0.5,1,2,25,18,13,12,18,0.302,0.279,0.419,17.978,3,riffle_clumpy
0,19,18,8,45,0.422,27,0.6,5,3,0.625,4,0,26,19,13,15,17,0.289,0.333,0.378,18.034,4,riffle_clumpy
0,22,23,3,48,0.458,25,0.521,3,5,0.375,2,1,29,19,9,17,22,0.188,0.354,0.458,17.926,5,riffle_clumpy
0,16,29,2,47,0.34,18,0.383,1,7,0.125,3,4,31,16,5,17,25,0.106,0.362,0.532,17.794,6,riffle_clumpy
0,26,15,2,43,0.605,28,0.651,4,1,0.8,1,2,31,12,12,15,16,0.279,0.349,0.372,17.842,7,riffle_clumpy
0,24,16,4,44,0.545,28,0.636,2,2,0.5,1,0,19,25,14,12,18,0.318,0.273,0.409,17.841,8,riffle_clumpy
0,18,26,2,46,0.391,20,0.435,3,0,1.0,1,2,28,18,10,16,20,0.217,0.348,0.435,17.77,9,riffle_clumpy
0,15,28,5,48,0.312,20,0.417,2,3,0.4,2,2,31,17,8,19,21,0.167,0.396,0.438,17.788,10,riffle_clumpy
0,22,22,3,47,0.468,25,0.532,6,2,0.75,2,2,29,18,12,13,22,0.255,0.277,0.468,17.805,11,riffle_clumpy
0,20,21,4,45,0.444,24,0.533,7,0,1.0,1,3,23,22,11,18,16,0.244,0.4,0.356,17.834,12,riffle_clumpy
0,21,18,7,46,0.457,28,0.609,6,4,0.6,6,1,28,18,13,10,23,0.283,0.217,0.5,17.816,13,riffle_clumpy
0,11,27,8,46,0.239,19,0.413,2,5,0.286,1,3,28,18,8,18,20,0.174,0.391,0.435,17.822,14,riffle_clumpy
0,22,20,4,46,0.478,26,0.565,4,2,0.667,5,2,29,17,9,15,22,0.196,0.326,0.478,17.82,15,riffle_clumpy
0,19,18,9,46,0.413,28,0.609,3,5,0.375,3,1,26,20,11,18,17,0.239,0.391,0.37,17.809,16,riffle_clumpy
0,26,17,0,43,0.605,26,0.605,2,2,0.5,0,4,24,19,16,13,14,0.372,0.302,0.326,17.784,17,riffle_clumpy
0,17,30,3,50,0.34,20,0.4,0,0,0,2,3,30,20,7,22,21,0.14,0.44,0.42,17.758,18,riffle_clumpy
0,17,26,2,45,0.378,19,0.422,0,4,0.0,2,1,31,14,10,13,22,0.222,0.289,0.489,17.741,19,riffle_clumpy
0,22,19,5,46,0.478,27,0.587,2,3,0.4,4,1,29,17,12,16,18,0.261,0.348,0.391,17.73,20,riffle_clumpy
0,21,26,2,49,0.429,23,0.469,0,4,0.0,2,1,25,24,11,17,21,0.224,0.347,0.429,17.726,21,riffle_clumpy
0,20,27,0,47,0.426,20,0.426,2,2,0.5,1,2,24,23,10,20,17,0.213,0.426,0.362,17.733,22,riffle_clumpy
0,15,26,2,43,0.349,17,0.395,1,5,0.167,1,1,30,13,6,17,20,0.14,0.395,0.465,17.74,23,riffle_clumpy
0,23,21,2,46,0.5,25,0.543,2,3,0.4,2,0,26,20,9,16,21,0.196,0.348,0.457,17.741,24,riffle_clumpy
0,19,25,3,47,0.404,22,0.468,1,1,0.5,5,4,28,19,8,12,27,0.17,0.255,0.574,17.699,25,riffle_clumpy
0,20,23,3,46,0.435,23,0.5,1,2,0.333,2,2,28,18,11,15,20,0.239,0.326,0.435,17.706,26,riffle_clumpy
0,16,26,4,46,0.348,20,0.435,2,1,0.667,2,1,26,20,12,12,22,0.261,0.261,0.478,17.706,27,riffle_clumpy
0,15,20,9,44,0.341,24,0.545,2,0,1.0,0,0,28,16,7,17,20,0.159,0.386,0.455,17.715,28,riffle_clumpy
0,19,21,8,48,0.396,27,0.562,1,1,0.5,0,3,31,17,10,15,23,0.208,0.312,0.479,17.736,29,riffle_clumpy
0,20,22,5,47,0.426,25,0.532,2,1,0.667,5,4,25,22,10,16,21,0.213,0.34,0.447,17.727,30,riffle_clumpy
0,23,18,6,47,0.489,29,0.617,3,3,0.5,4,2,28,19,13,10,24,0.277,0.213,0.511,17.714,31,riffle_clumpy
0,14,28,5,47,0.298,19,0.404,2,6,0.25,2,2,26,21,5,17,25,0.106,0.362,0.532,17.694,32,riffle_clumpy
0,26,21,1,48,0.542,27,0.562,4,1,0.8,4,3,30,18,9,13,26,0.188,0.271,0.542,17.689,33,riffle_clumpy
0,23,17,5,45,0.511,28,0.622,4,1,0.8,3,2,26,19,14,14,17,0.311,0.311,0.378,17.68,34,riffle_clumpy
0,17,23,4,44,0.386,21,0.477,4,0,1.0,0,4,30,14,9,14,21,0.205,0.318,0.477,17.686,35,riffle_clumpy
0,18,19,5,42,0.429,23,0.548,3,2,0.6,1,2,28,14,12,12,18,0.286,0.286,0.429,17.691,36,riffle_clumpy
0,19,21,4,44,0.432,23,0.523,4,2,0.667,1,1,28,16,14,8,22,0.318,0.182,0.5,17.695,37,riffle_clumpy
0,23,19,2,44,0.523,25,0.568,5,2,0.714,2,0,23,21,12,17,15,0.273,0.386,0.341,17.699,38,riffle_clumpy
0,18,23,4,45,0.4,22,0.489,3,3,0.5,2,2,33,12,11,13,21,0.244,0.289,0.467,17.707,39,riffle_clumpy
0,22,22,2,46,0.478,24,0.522,6,4,0.6,1,3,26,20,16,10,20,0.348,0.217,0.435,17.718,40,riffle_clumpy
0,17,26,4,47,0.362,21,0.447,1,0,1.0,2,2,24,23,12,12,23,0.255,0.255,0.489,17.7,41,riffle_clumpy
0,21,20,3,44,0.477,24,0.545,2,3,0.4,2,3,25,19,15,9,20,0.341,0.205,0.455,17.7,42,riffle_clumpy
0,17,20,10,47,0.362,27,0.574,0,2,0.0,2,3,25,22,11,12,24,0.234,0.255,0.511,17.711,43,riffle_clumpy
0,21,22,3,46,0.457,24,0.522,5,3,0.625,3,0,25,21,11,15,20,0.239,0.326,0.435,17.721,44,riffle_clumpy
0,24,16,3,43,0.558,27,0.628,6,1,0.857,1,2,23,20,15,14,14,0.349,0.326,0.326,17.714,45,riffle_clumpy
0,21,21,3,45,0.467,24,0.533,0,2,0.0,2,0,29,16,13,12,20,0.289,0.267,0.444,17.699,46,riffle_clumpy
0,19,27,2,48,0.396,21,0.438,2,5,0.286,6,1,23,25,11,14,23,0.229,0.292,0.479,17.686,47,riffle_clumpy
0,21,20,3,44,0.477,24,0.545,0,1,0.0,2,2,27,17,13,11,20,0.295,0.25,0.455,17.671,48,riffle_clumpy
0,22,21,2,45,0.489,24,0.533,5,1,0.833,2,2,28,17,10,13,22,0.222,0.289,0.489,17.659,49,riffle_clumpy
0,16,24,4,44,0.364,20,0.455,3,1,0.75,0,4,33,11,12,8,24,0.273,0.182,0.545,17.661,50,riffle_clumpy
0,20,21,4,45,0.444,24,0.533,1,0,1.0,2,2,27,18,13,14,18,0.289,0.311,0.4,17.684,51,riffle_clumpy
0,16,24,4,44,0.364,20,0.455,3,1,0.75,0,0,30,14,12,13,19,0.273,0.295,0.432,17.689,52,riffle_clumpy
0,24,17,3,44,0.545,27,0.614,5,1,0.833,1,3,30,14,18,7,19,0.409,0.159,0.432,17.687,53,riffle_clumpy
0,14,24,7,45,0.311,21,0.467,2,3,0.4,1,1,28,17,7,18,20,0.156,0.4,0.444,17.704,54,riffle_clumpy
0,19,20,7,46,0.413,26,0.565,2,3,0.4,5,1,30,16,9,13,24,0.196,0.283,0.522,17.686,55,riffle_clumpy
0,21,19,4,44,0.477,25,0.568,4,2,0.667,2,1,26,18,10,14,20,0.227,0.318,0.455,17.682,56,riffle_clumpy
0,18,18,9,45,0.4,27,0.6,2,3,0.4,4,2,24,21,10,15,20,0.222,0.333,0.444,17.686,57,riffle_clumpy
0,20,18,5,43,0.465,25,0.581,4,1,0.8,2,1,28,15,10,16,17,0.233,0.372,0.395,17.676,58,riffle_clumpy
0,17,25,2,44,0.386,19,0.432,2,2,0.5,1,0,28,16,11,16,17,0.25,0.364,0.386,17.671,59,riffle_clumpy
0,20,22,3,45,0.444,23,0.511,2,2,0.5,1,1,24,21,12,17,16,0.267,0.378,0.356,17.67,60,riffle_clumpy
0,20,23,2,45,0.444,22,0.489,5,2,0.714,3,2,27,18,12,11,22,0.267,0.244,0.489,17.67,61,riffle_clumpy
0,20,19,5,44,0.455,25,0.568,1,3,0.25,2,0,27,17,13,11,20,0.295,0.25,0.455,17.658,62,riffle_clumpy
0,20,19,3,42,0.476,23,0.548,5,3,0.625,0,0,26,16,10,16,16,0.238,0.381,0.381,17.655,63,riffle_clumpy
0,22,19,5,46,0.478,27,0.587,4,0,1.0,2,4,30,16,13,8,25,0.283,0.174,0.543,17.648,64,riffle_clumpy
0,23,18,5,46,0.5,28,0.609,2,0,1.0,3,4,31,15,16,5,25,0.348,0.109,0.543,17.651,65,riffle_clumpy
0,22,21,3,46,0.478,25,0.543,6,2,0.75,3,3,21,25,15,12,19,0.326,0.261,0.413,17.648,66,riffle_clumpy
0,24,16,4,44,0.545,28,0.636,2,2,0.5,3,3,23,21,13,14,17,0.295,0.318,0.386,17.653,67,riffle_clumpy
0,11,30,3,44,0.25,14,0.318,1,1,0.5,3,1,31,13,2,13,29,0.045,0.295,0.659,17.651,68,riffle_clumpy
0,25,20,1,46,0.543,26,0.565,6,2,0.75,3,0,23,23,11,13,22,0.239,0.283,0.478,17.647,69,riffle_clumpy
0,18,25,3,46,0.391,21,0.457,0,0,0,3,3,33,13,7,17,22,0.152,0.37,0.478,17.642,70,riffle_clumpy
0,21,21,4,46,0.457,25,0.543,3,2,0.6,4,2,24,22,10,15,21,0.217,0.326,0.457,17.643,71,riffle_clumpy
0,20,23,4,47,0.426,24,0.511,3,0,1.0,2,3,24,23,12,18,17,0.255,0.383,0.362,17.648,72,riffle_clumpy
0,22,23,2,47,0.468,24,0.511,1,4,0.2,3,3,29,18,12,14,21,0.255,0.298,0.447,17.646,73,riffle_clumpy
0,21,22,3,46,0.457,24,0.522,2,4,0.333,1,4,26,20,14,10,22,0.304,0.217,0.478,17.65,74,riffle_clumpy
0,16,25,4,45,0.356,20,0.444,2,2,0.5,0,4,31,14,12,12,21,0.267,0.267,0.467,17.648,75,riffle_clumpy
0,17,25,6,48,0.354,23,0.479,4,1,0.8,1,2,33,15,8,12,28,0.167,0.25,0.583,17.653,76,riffle_clumpy
0,19,26,2,47,0.404,21,0.447,9,2,0.818,0,4,23,24,14,17,16,0.298,0.362,0.34,17.66,77,riffle_clumpy
0,19,26,2,47,0.404,21,0.447,3,4,0.429,2,5,30,17,11,10,26,0.234,0.213,0.553,17.657,78,riffle_clumpy
0,17,25,3,45,0.378,20,0.444,1,3,0.25,3,3,33,12,10,12,23,0.222,0.267,0.511,17.667,79,riffle_clumpy
0,19,24,3,46,0.413,22,0.478,3,5,0.375,2,2,35,11,7,14,25,0.152,0.304,0.543,17.673,80,riffle_clumpy
0,19,20,8,47,0.404,27,0.574,5,0,1.0,2,2,29,18,11,11,25,0.234,0.234,0.532,17.674,81,riffle_clumpy
0,19,20,7,46,0.413,26,0.565,5,2,0.714,2,3,29,17,9,15,22,0.196,0.326,0.478,17.675,82,riffle_clumpy
0,18,24,4,46,0.391,22,0.478,4,2,0.667,2,3,28,18,9,16,21,0.196,0.348,0.457,17.668,83,riffle_clumpy
0,15,27,7,49,0.306,22,0.449,5,2,0.714,2,1,22,27,9,20,20,0.184,0.408,0.408,17.667,84,riffle_clumpy
0,19,23,2,44,0.432,21,0.477,5,2,0.714,1,2,32,12,13,11,20,0.295,0.25,0.455,17.665,85,riffle_clumpy
0,17,27,3,47,0.362,20,0.426,2,5,0.286,2,3,32,15,8,17,22,0.17,0.362,0.468,17.664,86,riffle_clumpy
0,20,27,4,51,0.392,24,0.471,4,5,0.444,2,2,33,18,9,20,22,0.176,0.392,0.431,17.672,87,riffle_clumpy
0,18,22,4,44,0.409,22,0.5,3,3,0.5,1,4,29,15,8,17,19,0.182,0.386,0.432,17.675,88,riffle_clumpy
0,13,28,4,45,0.289,17,0.378,2,3,0.4,0,1,27,18,5,14,26,0.111,0.311,0.578,17.669,89,riffle_clumpy
0,30,15,3,48,0.625,33,0.688,6,2,0.75,3,1,18,30,19,13,16,0.396,0.271,0.333,17.663,90,riffle_clumpy
0,16,25,3,44,0.364,19,0.432,2,1,0.667,0,4,25,19,13,14,17,0.295,0.318,0.386,17.66,91,riffle_clumpy
0,23,16,6,45,0.511,29,0.644,3,2,0.6,1,2,28,17,12,14,19,0.267,0.311,0.422,17.664,92,riffle_clumpy
0,20,21,4,45,0.444,24,0.533,4,2,0.667,1,0,31,14,14,11,20,0.311,0.244,0.444,17.664,93,riffle_clumpy
0,19,20,4,43,0.442,23,0.535,1,5,0.167,2,2,28,15,10,13,20,0.233,0.302,0.465,17.668,94,riffle_clumpy
0,20,21,5,46,0.435,25,0.543,1,5,0.167,5,3,32,14,8,17,21,0.174,0.37,0.457,17.669,95,riffle_clumpy
0,25,18,3,46,0.543,28,0.609,4,1,0.8,5,1,26,20,18,8,20,0.391,0.174,0.435,17.667,96,riffle_clumpy
0,19,21,5,45,0.422,24,0.533,4,6,0.4,0,2,27,18,6,19,20,0.133,0.422,0.444,18.121,1,riffle_clumpy
0,23,17,4,44,0.523,27,0.614,1,1,0.5,2,0,30,14,12,17,15,0.273,0.386,0.341,17.774,2,riffle_clumpy
0,18,21,7,46,0.391,25,0.543,4,1,0.8,4,4,28,18,8,15,23,0.174,0.326,0.5,17.692,3,riffle_clumpy
0,22,22,3,47,0.468,25,0.532,4,2,0.667,2,3,30,17,10,16,21,0.213,0.34,0.447,17.847,4,riffle_clumpy
0,18,26,4,48,0.375,22,0.458,2,6,0.25,5,4,29,19,10,11,27,0.208,0.229,0.562,17.701,5,riffle_clumpy
0,19,19,6,44,0.432,25,0.568,6,2,0.75,0,2,32,12,10,14,20,0.227,0.318,0.455,17.712,6,riffle_clumpy
0,17,26,1,44,0.386,18,0.409,4,3,0.571,1,4,30,14,10,11,23,0.227,0.25,0.523,17.718,7,riffle_clumpy
0,22,23,2,47,0.468,24,0.511,3,0,1.0,5,4,33,14,11,13,23,0.234,0.277,0.489,17.722,8,riffle_clumpy
0,19,24,2,45,0.422,21,0.467,5,2,0.714,2,4,18,27,15,10,20,0.333,0.222,0.444,17.589,9,riffle_clumpy
0,19,19,6,44,0.432,25,0.568,4,1,0.8,0,1,32,12,14,12,18,0.318,0.273,0.409,17.599,10,riffle_clumpy
0,18,25,3,46,0.391,21,0.457,4,3,0.571,1,4,28,18,8,13,25,0.174,0.283,0.543,17.528,11,riffle_clumpy
0,14,26,3,43,0.326,17,0.395,3,3,0.5,1,3,27,16,10,10,23,0.233,0.233,0.535,17.486,12,riffle_clumpy
0,21,22,4,47,0.447,25,0.532,3,3,0.5,5,2,22,25,10,16,21,0.213,0.34,0.447,17.492,13,riffle_clumpy
0,15,29,3,47,0.319,18,0.383,2,0,1.0,1,2,35,12,8,10,29,0.17,0.213,0.617,17.51,14,riffle_clumpy
0,19,20,5,44,0.432,24,0.545,3,2,0.6,2,3,27,17,10,14,20,0.227,0.318,0.455,17.563,15,riffle_clumpy
0,17,21,4,42,0.405,21,0.5,1,1,0.5,1,1,28,14,8,18,16,0.19,0.429,0.381,17.609,16,riffle_clumpy
0,20,24,3,47,0.426,23,0.489,5,2,0.714,0,1,27,20,11,14,22,0.234,0.298,0.468,17.617,17,riffle_clumpy
0,21,22,2,45,0.467,23,0.511,2,2,0.5,1,0,30,15,12,11,22,0.267,0.244,0.489,17.606,18,riffle_clumpy
0,18,27,2,47,0.383,20,0.426,0,4,0.0,1,0,27,20,6,17,24,0.128,0.362,0.511,17.582,19,riffle_clumpy
0,15,28,2,45,0.333,17,0.378,7,3,0.7,1,4,29,16,10,12,23,0.222,0.267,0.511,17.572,20,riffle_clumpy
0,18,20,5,43,0.419,23,0.535,2,3,0.4,1,1,23,20,12,12,19,0.279,0.279,0.442,17.571,21,riffle_clumpy
0,20,21,5,46,0.435,25,0.543,2,1,0.667,3,2,31,15,8,14,24,0.174,0.304,0.522,17.585,22,riffle_clumpy
0,15,27,3,45,0.333,18,0.4,2,6,0.25,2,2,28,17,8,17,20,0.178,0.378,0.444,17.615,23,riffle_clumpy
0,20,18,6,44,0.455,26,0.591,3,2,0.6,2,2,28,16,13,11,20,0.295,0.25,0.455,17.622,24,riffle_clumpy
0,26,22,2,50,0.52,28,0.56,6,2,0.75,3,3,28,22,13,14,23,0.26,0.28,0.46,17.614,25,riffle_clumpy
0,18,22,3,43,0.419,21,0.488,3,2,0.6,2,3,25,18,15,10,18,0.349,0.233,0.419,17.613,26,riffle_clumpy
0,16,25,5,46,0.348,21,0.457,2,5,0.286,3,4,32,14,6,14,26,0.13,0.304,0.565,17.592,27,riffle_clumpy
0,18,24,4,46,0.391,22,0.478,3,1,0.75,1,1,25,21,11,13,22,0.239,0.283,0.478,17.593,28,riffle_clumpy
0,25,16,3,44,0.568,28,0.636,8,0,1.0,1,0,24,20,17,13,14,0.386,0.295,0.318,17.592,29,riffle_clumpy
0,22,22,2,46,0.478,24,0.522,3,3,0.5,3,2,28,18,9,13,24,0.196,0.283,0.522,17.588,30,riffle_clumpy
0,16,21,7,44,0.364,23,0.523,1,2,0.333,0,2,30,14,12,13,19,0.273,0.295,0.432,17.598,31,riffle_clumpy
0,20,24,3,47,0.426,23,0.489,3,0,1.0,2,5,30,17,13,8,26,0.277,0.17,0.553,17.573,32,riffle_clumpy
0,25,17,3,45,0.556,28,0.622,3,3,0.5,6,1,27,18,11,15,19,0.244,0.333,0.422,17.565,33,riffle_clumpy
0,20,23,0,43,0.465,20,0.465,3,0,1.0,1,1,28,15,12,10,21,0.279,0.233,0.488,17.544,34,riffle_clumpy
0,18,25,4,47,0.383,22,0.468,3,1,0.75,2,1,27,20,6,19,22,0.128,0.404,0.468,17.542,35,riffle_clumpy
0,21,20,7,48,0.438,28,0.583,5,1,0.833,0,0,28,20,16,18,14,0.333,0.375,0.292,17.553,36,riffle_clumpy
0,19,25,3,47,0.404,22,0.468,3,3,0.5,3,1,24,23,12,17,18,0.255,0.362,0.383,17.533,37,riffle_clumpy
0,20,24,4,48,0.417,24,0.5,5,5,0.5,1,1,24,24,10,19,19,0.208,0.396,0.396,17.548,38,riffle_clumpy
0,28,15,2,45,0.622,30,0.667,3,2,0.6,4,3,22,23,14,14,17,0.311,0.311,0.378,17.53,39,riffle_clumpy
0,16,24,6,46,0.348,22,0.478,1,2,0.333,1,5,33,13,7,18,21,0.152,0.391,0.457,17.524,40,riffle_clumpy
0,17,24,3,44,0.386,20,0.455,7,1,0.875,2,1,25,19,12,13,19,0.273,0.295,0.432,17.515,41,riffle_clumpy
0,14,29,5,48,0.292,19,0.396,0,3,0.0,1,4,33,15,12,14,22,0.25,0.292,0.458,17.504,42,riffle_clumpy
0,19,21,6,46,0.413,25,0.543,2,1,0.667,2,1,29,17,7,18,21,0.152,0.391,0.457,17.518,43,riffle_clumpy
0,15,29,3,47,0.319,18,0.383,2,2,0.5,1,3,33,14,7,14,26,0.149,0.298,0.553,17.542,44,riffle_clumpy
0,20,23,4,47,0.426,24,0.511,0,2,0.0,3,3,30,17,9,16,22,0.191,0.34,0.468,17.539,45,riffle_clumpy
0,14,24,9,47,0.298,23,0.489,3,3,0.5,3,2,28,19,7,18,22,0.149,0.383,0.468,17.545,46,riffle_clumpy
0,18,26,1,45,0.4,19,0.422,2,3,0.4,2,2,24,21,9,15,21,0.2,0.333,0.467,17.533,47,riffle_clumpy
0,19,24,4,47,0.404,23,0.489,4,1,0.8,3,1,29,18,5,17,25,0.106,0.362,0.532,17.537,48,riffle_clumpy
0,19,17,8,44,0.432,27,0.614,1,2,0.333,1,1,29,15,6,16,22,0.136,0.364,0.5,17.547,49,riffle_clumpy
0,21,19,3,43,0.488,24,0.558,3,3,0.5,1,1,26,17,9,16,18,0.209,0.372,0.419,17.544,50,riffle_clumpy
0,13,23,9,45,0.289,22,0.489,0,7,0.0,3,2,31,14,4,17,24,0.089,0.378,0.533,17.549,51,riffle_clumpy
0,16,23,5,44,0.364,21,0.477,4,1,0.8,0,3,26,18,10,14,20,0.227,0.318,0.455,17.554,52,riffle_clumpy
0,16,27,3,46,0.348,19,0.413,5,5,0.5,2,1,32,14,6,16,24,0.13,0.348,0.522,17.56,53,riffle_clumpy
0,16,23,7,46,0.348,23,0.5,5,4,0.556,1,3,33,13,8,11,27,0.174,0.239,0.587,17.56,54,riffle_clumpy
0,22,19,5,46,0.478,27,0.587,2,2,0.5,1,1,30,16,13,14,19,0.283,0.304,0.413,17.56,55,riffle_clumpy
0,23,20,4,47,0.489,27,0.574,4,4,0.5,1,3,27,20,10,15,22,0.213,0.319,0.468,17.562,56,riffle_clumpy
0,23,21,3,47,0.489,26,0.553,5,0,1.0,2,2,29,18,17,6,24,0.362,0.128,0.511,17.554,57,riffle_clumpy
0,29,16,3,48,0.604,32,0.667,2,1,0.667,4,1,23,25,15,16,17,0.312,0.333,0.354,17.559,58,riffle_clumpy
0,23,15,4,42,0.548,27,0.643,2,3,0.4,4,0,22,20,13,15,14,0.31,0.357,0.333,17.565,59,riffle_clumpy
0,18,21,7,46,0.391,25,0.543,3,2,0.6,2,2,24,22,9,19,18,0.196,0.413,0.391,17.569,60,riffle_clumpy
0,20,19,4,43,0.465,24,0.558,4,3,0.571,2,3,26,17,13,13,17,0.302,0.302,0.395,17.58,61,riffle_clumpy
0,18,25,2,45,0.4,20,0.444,0,3,0.0,0,0,24,21,11,17,17,0.244,0.378,0.378,17.59,62,riffle_clumpy
0,21,24,3,48,0.438,24,0.5,3,5,0.375,2,1,29,19,9,16,23,0.188,0.333,0.479,17.588,63,riffle_clumpy
0,19,21,4,44,0.432,23,0.523,6,2,0.75,2,2,28,16,11,12,21,0.25,0.273,0.477,17.582,64,riffle_clumpy
0,23,18,3,44,0.523,26,0.591,5,2,0.714,1,1,32,12,11,10,23,0.25,0.227,0.523,17.583,65,riffle_clumpy
0,22,20,2,44,0.5,24,0.545,5,5,0.5,2,1,27,17,13,13,18,0.295,0.295,0.409,17.596,66,riffle_clumpy
0,21,22,5,48,0.438,26,0.542,4,3,0.571,2,4,32,16,9,19,20,0.188,0.396,0.417,17.598,67,riffle_clumpy
0,25,17,3,45,0.556,28,0.622,5,4,0.556,5,1,27,18,11,12,22,0.244,0.267,0.489,17.592,68,riffle_clumpy
0,20,21,4,45,0.444,24,0.533,4,1,0.8,1,3,26,19,13,15,17,0.289,0.333,0.378,17.592,69,riffle_clumpy
0,21,21,3,45,0.467,24,0.533,5,4,0.556,0,2,25,20,16,11,18,0.356,0.244,0.4,17.595,70,riffle_clumpy
0,20,21,5,46,0.435,25,0.543,5,0,1.0,2,2,24,22,14,13,19,0.304,0.283,0.413,17.602,71,riffle_clumpy
0,22,18,4,44,0.5,26,0.591,4,1,0.8,1,2,30,14,11,12,21,0.25,0.273,0.477,17.598,72,riffle_clumpy
0,22,23,1,46,0.478,23,0.5,2,2,0.5,2,4,27,19,15,9,22,0.326,0.196,0.478,17.599,73,riffle_clumpy
0,23,23,4,50,0.46,27,0.54,4,2,0.667,1,1,28,22,14,18,18,0.28,0.36,0.36,17.604,74,riffle_clumpy
0,18,18,9,45,0.4,27,0.6,2,2,0.5,3,2,25,20,6,18,21,0.133,0.4,0.467,17.608,75,riffle_clumpy
0,21,20,5,46,0.457,26,0.565,5,3,0.625,0,1,28,18,15,16,15,0.326,0.348,0.326,17.612,76,riffle_clumpy
0,18,25,4,47,0.383,22,0.468,2,3,0.4,1,0,23,24,12,17,18,0.255,0.362,0.383,17.611,77,riffle_clumpy
0,17,24,3,44,0.386,20,0.455,3,1,0.75,0,1,31,13,7,18,19,0.159,0.409,0.432,17.617,78,riffle_clumpy
0,15,23,6,44,0.341,21,0.477,2,1,0.667,2,2,30,14,6,20,18,0.136,0.455,0.409,17.626,79,riffle_clumpy
0,29,17,1,47,0.617,30,0.638,2,3,0.4,4,3,32,15,16,10,21,0.34,0.213,0.447,17.632,80,riffle_clumpy
0,23,21,2,46,0.5,25,0.543,5,3,0.625,2,1,25,21,12,15,19,0.261,0.326,0.413,17.633,81,riffle_clumpy
0,17,26,2,45,0.378,19,0.422,5,3,0.625,1,1,29,16,9,15,21,0.2,0.333,0.467,17.637,82,riffle_clumpy
0,20,22,6,48,0.417,26,0.542,5,1,0.833,1,2,28,20,11,14,23,0.229,0.292,0.479,17.637,83,riffle_clumpy
0,23,19,4,46,0.5,27,0.587,1,1,0.5,2,0,24,22,10,15,21,0.217,0.326,0.457,17.639,84,riffle_clumpy
0,23,21,0,44,0.523,23,0.523,5,1,0.833,4,0,28,16,13,16,15,0.295,0.364,0.341,17.633,85,riffle_clumpy
0,17,24,6,47,0.362,23,0.489,2,3,0.4,5,3,27,20,6,22,19,0.128,0.468,0.404,17.631,86,riffle_clumpy
0,18,23,5,46,0.391,23,0.5,4,2,0.667,0,1,28,18,12,17,17,0.261,0.37,0.37,17.637,87,riffle_clumpy
0,18,20,7,45,0.4,25,0.556,3,2,0.6,3,3,31,14,11,12,22,0.244,0.267,0.489,17.635,88,riffle_clumpy
0,21,22,3,46,0.457,24,0.522,1,0,1.0,1,1,29,17,9,11,26,0.196,0.239,0.565,17.629,89,riffle_clumpy
0,21,18,3,42,0.5,24,0.571,6,4,0.6,2,0,27,15,11,13,18,0.262,0.31,0.429,17.633,90,riffle_clumpy
0,25,18,2,45,0.556,27,0.6,4,1,0.8,3,3,33,12,16,8,21,0.356,0.178,0.467,17.634,91,riffle_clumpy
0,20,19,7,46,0.435,27,0.587,2,2,0.5,5,2,31,15,12,10,24,0.261,0.217,0.522,17.635,92,riffle_clumpy
0,21,20,4,45,0.467,25,0.556,6,1,0.857,3,1,33,12,10,11,24,0.222,0.244,0.533,17.639,93,riffle_clumpy
0,22,21,5,48,0.458,27,0.562,4,2,0.667,5,0,32,16,8,12,28,0.167,0.25,0.583,17.63,94,riffle_clumpy
0,18,25,4,47,0.383,22,0.468,5,3,0.625,0,3,25,22,9,17,21,0.191,0.362,0.447,17.629,95,riffle_clumpy
0,24,22,4,50,0.48,28,0.56,2,3,0.4,1,5,31,19,16,9,25,0.32,0.18,0.5,17.634,96,riffle_clumpy
0,21,18,3,42,0.5,24,0.571,6,1,0.857,2,0,23,19,12,16,14,0.286,0.381,0.333,17.852,1,riffle_clumpy
0,24,20,3,47,0.511,27,0.574,5,0,1.0,3,0,28,19,11,14,22,0.234,0.298,0.468,17.672,2,riffle_clumpy
0,24,15,7,46,0.522,31,0.674,6,0,1.0,2,2,27,19,14,12,20,0.304,0.261,0.435,17.843,3,riffle_clumpy
0,20,20,6,46,0.435,26,0.565,4,0,1.0,2,2,29,17,12,11,23,0.261,0.239,0.5,17.95,4,riffle_clumpy
0,18,26,2,46,0.391,20,0.435,2,7,0.222,2,2,27,19,10,12,24,0.217,0.261,0.522,18.007,5,riffle_clumpy
0,21,21,4,46,0.457,25,0.543,4,1,0.8,3,1,29,17,12,10,24,0.261,0.217,0.522,17.886,6,riffle_clumpy
0,21,23,1,45,0.467,22,0.489,4,5,0.444,2,1,27,18,12,12,21,0.267,0.267,0.467,17.811,7,riffle_clumpy
0,20,19,6,45,0.444,26,0.578,3,0,1.0,2,3,26,19,13,13,19,0.289,0.289,0.422,17.772,8,riffle_clumpy
0,16,26,2,44,0.364,18,0.409,2,1,0.667,1,3,27,17,8,16,20,0.182,0.364,0.455,17.788,9,riffle_clumpy
0,17,24,3,44,0.386,20,0.455,3,2,0.6,1,2,29,15,10,13,21,0.227,0.295,0.477,17.787,10,riffle_clumpy
0,21,21,3,45,0.467,24,0.533,2,1,0.667,0,0,26,19,15,13,17,0.333,0.289,0.378,17.798,11,riffle_clumpy
0,17,27,5,49,0.347,22,0.449,3,3,0.5,3,1,23,26,7,20,22,0.143,0.408,0.449,17.805,12,riffle_clumpy
0,19,21,4,44,0.432,23,0.523,2,0,1.0,4,1,27,17,10,17,17,0.227,0.386,0.386,17.781,13,riffle_clumpy
0,20,18,6,44,0.455,26,0.591,4,2,0.667,2,2,30,14,12,8,24,0.273,0.182,0.545,17.818,14,riffle_clumpy
0,18,29,3,50,0.36,21,0.42,3,5,0.375,2,4,23,27,11,18,21,0.22,0.36,0.42,17.83,15,riffle_clumpy
0,20,19,4,43,0.465,24,0.558,4,3,0.571,1,2,26,17,14,14,15,0.326,0.326,0.349,17.867,16,riffle_clumpy
0,12,29,5,46,0.261,17,0.37,1,2,0.333,0,5,28,18,7,14,25,0.152,0.304,0.543,17.859,17,riffle_clumpy
0,23,21,2,46,0.5,25,0.543,4,1,0.8,1,4,25,21,14,16,16,0.304,0.348,0.348,17.879,18,riffle_clumpy
0,23,25,2,50,0.46,25,0.5,3,0,1.0,3,3,33,17,11,10,29,0.22,0.2,0.58,17.83,19,riffle_clumpy
0,18,21,4,43,0.419,22,0.512,5,2,0.714,1,2,28,15,14,11,18,0.326,0.256,0.419,17.814,20,riffle_clumpy
0,19,22,5,46,0.413,24,0.522,3,2,0.6,2,1,30,16,13,13,20,0.283,0.283,0.435,17.821,21,riffle_clumpy
0,18,26,2,46,0.391,20,0.435,3,3,0.5,2,5,29,17,13,11,22,0.283,0.239,0.478,17.831,22,riffle_clumpy
0,15,27,4,46,0.326,19,0.413,1,3,0.25,4,4,32,14,5,11,30,0.109,0.239,0.652,17.802,23,riffle_clumpy
0,19,23,3,45,0.422,22,0.489,4,3,0.571,3,3,30,15,10,11,24,0.222,0.244,0.533,17.804,24,riffle_clumpy
0,20,19,4,43,0.465,24,0.558,6,2,0.75,1,0,21,22,15,14,14,0.349,0.326,0.326,17.828,25,riffle_clumpy
0,23,17,4,44,0.523,27,0.614,3,3,0.5,0,0,30,14,11,14,19,0.25,0.318,0.432,17.821,26,riffle_clumpy
0,21,24,3,48,0.438,24,0.5,3,3,0.5,4,3,33,15,10,11,27,0.208,0.229,0.562,17.793,27,riffle_clumpy
0,17,23,3,43,0.395,20,0.465,3,1,0.75,0,0,29,14,8,15,20,0.186,0.349,0.465,17.807,28,riffle_clumpy
0,26,17,4,47,0.553,30,0.638,6,0,1.0,1,2,28,19,13,12,22,0.277,0.255,0.468,17.791,29,riffle_clumpy
0,14,23,9,46,0.304,23,0.5,1,0,1.0,1,1,28,18,4,18,24,0.087,0.391,0.522,17.795,30,riffle_clumpy
0,16,25,4,45,0.356,20,0.444,3,2,0.6,0,1,28,17,10,15,20,0.222,0.333,0.444,17.811,31,riffle_clumpy
0,18,26,3,47,0.383,21,0.447,3,1,0.75,2,1,31,16,8,16,23,0.17,0.34,0.489,17.813,32,riffle_clumpy
0,20,22,3,45,0.444,23,0.511,3,1,0.75,2,1,26,19,13,20,12,0.289,0.444,0.267,17.81,33,riffle_clumpy
0,23,17,3,43,0.535,26,0.605,5,2,0.714,2,1,24,19,14,13,16,0.326,0.302,0.372,17.799,34,riffle_clumpy
0,17,24,4,45,0.378,21,0.467,4,1,0.8,1,4,34,11,9,13,23,0.2,0.289,0.511,17.799,35,riffle_clumpy
0,17,25,2,44,0.386,19,0.432,2,1,0.667,2,3,29,15,7,15,22,0.159,0.341,0.5,17.789,36,riffle_clumpy
0,22,19,2,43,0.512,24,0.558,3,0,1.0,2,1,26,17,10,17,16,0.233,0.395,0.372,17.797,37,riffle_clumpy
0,23,18,6,47,0.489,29,0.617,2,2,0.5,1,2,24,23,14,15,18,0.298,0.319,0.383,17.798,38,riffle_clumpy
0,11,30,4,45,0.244,15,0.333,2,4,0.333,1,3,34,11,6,14,25,0.133,0.311,0.556,17.795,39,riffle_clumpy
0,23,20,3,46,0.5,26,0.565,5,0,1.0,2,1,26,20,14,13,19,0.304,0.283,0.413,17.782,40,riffle_clumpy
0,17,25,2,44,0.386,19,0.432,1,2,0.333,3,0,20,24,9,16,19,0.205,0.364,0.432,17.761,41,riffle_clumpy
0,25,17,2,44,0.568,27,0.614,4,1,0.8,1,3,26,18,15,16,13,0.341,0.364,0.295,17.767,42,riffle_clumpy
0,23,18,3,44,0.523,26,0.591,4,3,0.571,1,1,22,22,14,13,17,0.318,0.295,0.386,17.776,43,riffle_clumpy
0,19,21,5,45,0.422,24,0.533,6,0,1.0,3,0,30,15,9,15,21,0.2,0.333,0.467,17.75,44,riffle_clumpy
0,21,23,3,47,0.447,24,0.511,4,1,0.8,5,1,24,23,14,13,20,0.298,0.277,0.426,17.724,45,riffle_clumpy
0,22,17,3,42,0.524,25,0.595,0,2,0.0,6,1,29,13,12,12,18,0.286,0.286,0.429,17.724,46,riffle_clumpy
0,23,19,2,44,0.523,25,0.568,6,2,0.75,4,2,29,15,11,15,18,0.25,0.341,0.409,17.721,47,riffle_clumpy
0,20,29,1,50,0.4,21,0.42,3,3,0.5,2,4,34,16,13,13,24,0.26,0.26,0.48,17.695,48,riffle_clumpy
0,23,20,4,47,0.489,27,0.574,2,4,0.333,4,2,32,15,10,15,22,0.213,0.319,0.468,17.693,49,riffle_clumpy
0,17,23,4,44,0.386,21,0.477,1,1,0.5,3,0,27,17,8,16,20,0.182,0.364,0.455,17.693,50,riffle_clumpy
0,20,23,6,49,0.408,26,0.531,8,3,0.727,1,2,29,20,11,15,23,0.224,0.306,0.469,17.701,51,riffle_clumpy
0,21,18,5,44,0.477,26,0.591,0,0,0,1,2,27,17,12,13,19,0.273,0.295,0.432,17.711,52,riffle_clumpy
0,23,23,1,47,0.489,24,0.511,2,2,0.5,2,0,27,20,12,12,23,0.255,0.255,0.489,17.708,53,riffle_clumpy
0,20,20,5,45,0.444,25,0.556,1,1,0.5,2,0,30,15,12,11,22,0.267,0.244,0.489,17.71,54,riffle_clumpy
0,18,22,5,45,0.4,23,0.511,1,0,1.0,1,6,34,11,11,14,20,0.244,0.311,0.444,17.698,55,riffle_clumpy
0,24,20,1,45,0.533,25,0.556,2,3,0.4,2,4,27,18,13,11,21,0.289,0.244,0.467,17.688,56,riffle_clumpy
0,16,25,5,46,0.348,21,0.457,1,5,0.167,0,0,24,22,7,21,18,0.152,0.457,0.391,17.696,57,riffle_clumpy
0,24,21,0,45,0.533,24,0.533,4,2,0.667,3,0,30,15,11,15,19,0.244,0.333,0.422,17.697,58,riffle_clumpy
0,17,24,5,46,0.37,22,0.478,2,3,0.4,1,5,23,23,15,12,19,0.326,0.261,0.413,17.705,59,riffle_clumpy
0,24,20,4,48,0.5,28,0.583,2,2,0.5,1,3,26,22,12,17,19,0.25,0.354,0.396,17.702,60,riffle_clumpy
0,23,20,2,45,0.511,25,0.556,6,1,0.857,2,3,27,18,14,11,20,0.311,0.244,0.444,17.692,61,riffle_clumpy
0,23,18,3,44,0.523,26,0.591,1,4,0.2,3,2,32,12,12,8,24,0.273,0.182,0.545,17.692,62,riffle_clumpy
0,22,19,3,44,0.5,25,0.568,3,3,0.5,2,0,29,15,15,8,21,0.341,0.182,0.477,17.694,63,riffle_clumpy
0,18,26,1,45,0.4,19,0.422,5,1,0.833,2,1,24,21,10,17,18,0.222,0.378,0.4,17.694,64,riffle_clumpy
0,22,23,5,50,0.44,27,0.54,4,5,0.444,3,3,30,20,12,13,25,0.24,0.26,0.5,17.696,65,riffle_clumpy
0,23,17,3,43,0.535,26,0.605,5,2,0.714,1,3,31,12,16,8,19,0.372,0.186,0.442,17.686,66,riffle_clumpy
0,23,12,9,44,0.523,32,0.727,2,0,1.0,1,0,32,12,10,13,21,0.227,0.295,0.477,17.681,67,riffle_clumpy
0,29,16,3,48,0.604,32,0.667,10,2,0.833,1,1,28,20,17,13,18,0.354,0.271,0.375,17.686,68,riffle_clumpy
0,24,21,4,49,0.49,28,0.571,3,1,0.75,4,3,28,21,18,10,21,0.367,0.204,0.429,17.67,69,riffle_clumpy
0,17,22,5,44,0.386,22,0.5,3,1,0.75,2,3,27,17,13,9,22,0.295,0.205,0.5,17.665,70,riffle_clumpy
0,17,25,4,46,0.37,21,0.457,2,3,0.4,3,1,25,21,7,19,20,0.152,0.413,0.435,17.67,71,riffle_clumpy
0,18,21,4,43,0.419,22,0.512,4,1,0.8,1,2,22,21,11,16,16,0.256,0.372,0.372,17.675,72,riffle_clumpy
0,21,15,8,44,0.477,29,0.659,4,1,0.8,1,2,31,13,10,12,22,0.227,0.273,0.5,17.671,73,riffle_clumpy
0,20,21,7,48,0.417,27,0.562,5,2,0.714,4,5,30,18,13,17,18,0.271,0.354,0.375,17.675,74,riffle_clumpy
0,21,19,4,44,0.477,25,0.568,2,0,1.0,4,1,30,14,12,12,20,0.273,0.273,0.455,17.674,75,riffle_clumpy
0,19,22,5,46,0.413,24,0.522,1,2,0.333,1,5,29,17,14,16,16,0.304,0.348,0.348,17.679,76,riffle_clumpy
0,26,17,1,44,0.591,27,0.614,4,0,1.0,4,1,25,19,16,8,20,0.364,0.182,0.455,17.676,77,riffle_clumpy
0,28,16,6,50,0.56,34,0.68,6,0,1.0,6,0,35,15,13,9,28,0.26,0.18,0.56,17.67,78,riffle_clumpy
0,20,22,3,45,0.444,23,0.511,3,4,0.429,4,5,31,14,8,13,24,0.178,0.289,0.533,17.67,79,riffle_clumpy
0,14,22,8,44,0.318,22,0.5,2,1,0.667,1,1,28,16,9,18,17,0.205,0.409,0.386,17.674,80,riffle_clumpy
0,22,20,5,47,0.468,27,0.574,5,3,0.625,3,1,24,23,7,21,19,0.149,0.447,0.404,17.677,81,riffle_clumpy
0,19,19,6,44,0.432,25,0.568,2,0,1.0,1,3,28,16,10,13,21,0.227,0.295,0.477,17.678,82,riffle_clumpy
0,22,19,3,44,0.5,25,0.568,1,1,0.5,0,1,30,14,8,17,19,0.182,0.386,0.432,17.687,83,riffle_clumpy
0,22,22,4,48,0.458,26,0.542,4,4,0.5,4,3,27,21,10,16,22,0.208,0.333,0.458,17.693,84,riffle_clumpy
0,20,21,2,43,0.465,22,0.512,1,5,0.167,0,2,23,20,10,17,16,0.233,0.395,0.372,17.692,85,riffle_clumpy
0,23,20,2,45,0.511,25,0.556,3,1,0.75,2,0,24,21,13,14,18,0.289,0.311,0.4,17.687,86,riffle_clumpy
0,17,21,6,44,0.386,23,0.523,6,1,0.857,0,0,27,17,11,16,17,0.25,0.364,0.386,17.69,87,riffle_clumpy
0,19,20,5,44,0.432,24,0.545,1,1,0.5,4,2,25,19,9,15,20,0.205,0.341,0.455,17.694,88,riffle_clumpy
0,18,23,5,46,0.391,23,0.5,2,1,0.667,2,1,26,20,9,16,21,0.196,0.348,0.457,17.696,89,riffle_clumpy
0,21,25,5,51,0.412,26,0.51,3,1,0.75,4,4,30,21,8,19,24,0.157,0.373,0.471,17.689,90,riffle_clumpy
0,20,22,1,43,0.465,21,0.488,5,3,0.625,0,2,22,21,11,16,16,0.256,0.372,0.372,17.69,91,riffle_clumpy
0,20,21,4,45,0.444,24,0.533,5,2,0.714,3,3,25,20,16,13,16,0.356,0.289,0.356,17.694,92,riffle_clumpy
0,21,18,4,43,0.488,25,0.581,2,1,0.667,0,4,31,12,14,12,17,0.326,0.279,0.395,17.697,93,riffle_clumpy
0,19,23,4,46,0.413,23,0.5,1,3,0.25,2,2,21,25,9,17,20,0.196,0.37,0.435,17.696,94,riffle_clumpy
0,24,17,4,45,0.533,28,0.622,5,0,1.0,2,1,31,14,12,13,20,0.267,0.289,0.444,17.701,95,riffle_clumpy
0,19,22,4,45,0.422,23,0.511,2,2,0.5,2,3,27,18,11,17,17,0.244,0.378,0.378,17.697,96,riffle_clumpy
0,16,22,5,43,0.372,21,0.488,4,3,0.571,2,3,29,14,10,13,20,0.233,0.302,0.465,17.667,1,riffle_clumpy
0,19,20,7,46,0.413,26,0.565,3,4,0.429,1,1,22,24,9,19,18,0.196,0.413,0.391,17.965,2,riffle_clumpy
0,18,25,2,45,0.4,20,0.444,3,3,0.5,3,2,29,16,9,13,23,0.2,0.289,0.511,17.789,3,riffle_clumpy
0,18,22,4,44,0.409,22,0.5,6,0,1.0,1,3,29,15,9,14,21,0.205,0.318,0.477,17.95,4,riffle_clumpy
0,19,26,2,47,0.404,21,0.447,1,2,0.333,2,2,28,19,5,17,25,0.106,0.362,0.532,17.909,5,riffle_clumpy
0,22,21,3,46,0.478,25,0.543,4,4,0.5,1,1,25,21,11,14,21,0.239,0.304,0.457,17.896,6,riffle_clumpy
0,17,25,3,45,0.378,20,0.444,3,3,0.5,4,1,24,21,8,16,21,0.178,0.356,0.467,17.684,7,riffle_clumpy
0,17,23,6,46,0.37,23,0.5,3,0,1.0,1,4,28,18,9,21,16,0.196,0.457,0.348,17.664,8,riffle_clumpy
0,22,20,3,45,0.489,25,0.556,1,3,0.25,2,0,28,17,13,16,16,0.289,0.356,0.356,17.658,9,riffle_clumpy
0,22,25,3,50,0.44,25,0.5,0,0,0,4,1,33,17,6,19,25,0.12,0.38,0.5,17.652,10,riffle_clumpy
0,20,23,3,46,0.435,23,0.5,3,3,0.5,2,5,26,20,13,10,23,0.283,0.217,0.5,17.628,11,riffle_clumpy
0,21,19,6,46,0.457,27,0.587,4,1,0.8,2,4,20,26,11,15,20,0.239,0.326,0.435,17.692,12,riffle_clumpy
0,27,17,0,44,0.614,27,0.614,6,2,0.75,3,1,24,20,16,10,18,0.364,0.227,0.409,17.72,13,riffle_clumpy
0,22,25,0,47,0.468,22,0.468,4,4,0.5,2,2,30,17,8,16,23,0.17,0.34,0.489,17.701,14,riffle_clumpy
0,18,25,5,48,0.375,23,0.479,2,3,0.4,3,2,27,21,9,19,20,0.188,0.396,0.417,17.691,15,riffle_clumpy
0,18,21,8,47,0.383,26,0.553,0,6,0.0,0,2,30,17,12,18,17,0.255,0.383,0.362,17.702,16,riffle_clumpy
0,16,25,4,45,0.356,20,0.444,1,5,0.167,2,1,28,17,3,21,21,0.067,0.467,0.467,17.699,17,riffle_clumpy
0,21,17,7,45,0.467,28,0.622,4,0,1.0,2,3,26,19,10,20,15,0.222,0.444,0.333,17.73,18,riffle_clumpy
0,21,20,4,45,0.467,25,0.556,4,2,0.667,0,3,27,18,11,13,21,0.244,0.289,0.467,17.705,19,riffle_clumpy
0,27,16,1,44,0.614,28,0.636,9,5,0.643,3,1,25,19,14,12,18,0.318,0.273,0.409,17.675,20,riffle_clumpy
0,28,18,3,49,0.571,31,0.633,5,0,1.0,1,1,28,21,15,20,14,0.306,0.408,0.286,17.686,21,riffle_clumpy
0,17,25,5,47,0.362,22,0.468,2,2,0.5,2,2,31,16,8,14,25,0.17,0.298,0.532,17.671,22,riffle_clumpy
0,19,20,5,44,0.432,24,0.545,2,2,0.5,0,0,31,13,12,9,23,0.273,0.205,0.523,17.647,23,riffle_clumpy
0,24,17,4,45,0.533,28,0.622,3,0,1.0,2,2,27,18,12,15,18,0.267,0.333,0.4,17.643,24,riffle_clumpy
0,18,26,2,46,0.391,20,0.435,4,1,0.8,2,3,21,25,12,13,21,0.261,0.283,0.457,17.633,25,riffle_clumpy
0,21,20,4,45,0.467,25,0.556,6,3,0.667,0,1,24,21,13,19,13,0.289,0.422,0.289,17.664,26,riffle_clumpy
0,21,24,2,47,0.447,23,0.489,0,1,0.0,4,2,32,15,8,15,24,0.17,0.319,0.511,17.628,27,riffle_clumpy
0,17,22,6,45,0.378,23,0.511,2,1,0.667,2,0,25,20,10,20,15,0.222,0.444,0.333,17.633,28,riffle_clumpy
0,23,21,5,49,0.469,28,0.571,7,2,0.778,2,3,30,19,12,12,25,0.245,0.245,0.51,17.636,29,riffle_clumpy
0,19,22,5,46,0.413,24,0.522,1,0,1.0,4,1,30,16,9,19,18,0.196,0.413,0.391,17.623,30,riffle_clumpy
0,20,23,4,47,0.426,24,0.511,6,1,0.857,2,1,28,19,12,12,23,0.255,0.255,0.489,17.641,31,riffle_clumpy
0,17,27,3,47,0.362,20,0.426,1,2,0.333,2,2,33,14,10,18,19,0.213,0.383,0.404,17.637,32,riffle_clumpy
0,18,24,6,48,0.375,24,0.5,4,3,0.571,4,5,25,23,10,19,19,0.208,0.396,0.396,17.651,33,riffle_clumpy
0,18,21,5,44,0.409,23,0.523,3,3,0.5,2,4,26,18,14,10,20,0.318,0.227,0.455,17.637,34,riffle_clumpy
0,23,23,3,49,0.469,26,0.531,4,1,0.8,3,2,33,16,12,14,23,0.245,0.286,0.469,17.599,35,riffle_clumpy
0,16,28,2,46,0.348,18,0.391,2,3,0.4,3,1,31,15,6,16,24,0.13,0.348,0.522,17.612,36,riffle_clumpy
0,24,20,3,47,0.511,27,0.574,4,2,0.667,3,0,25,22,13,20,14,0.277,0.426,0.298,17.634,37,riffle_clumpy
0,18,21,9,48,0.375,27,0.562,3,2,0.6,4,2,29,19,10,16,22,0.208,0.333,0.458,17.646,38,riffle_clumpy
0,19,24,2,45,0.422,21,0.467,6,3,0.667,2,2,22,23,12,14,19,0.267,0.311,0.422,17.632,39,riffle_clumpy
0,19,22,3,44,0.432,22,0.5,4,2,0.667,4,3,28,16,9,11,24,0.205,0.25,0.545,17.627,40,riffle_clumpy
0,21,24,3,48,0.438,24,0.5,4,1,0.8,2,1,27,21,14,12,22,0.292,0.25,0.458,17.618,41,riffle_clumpy
0,25,18,2,45,0.556,27,0.6,2,2,0.5,1,3,26,19,13,13,19,0.289,0.289,0.422,17.633,42,riffle_clumpy
0,20,21,5,46,0.435,25,0.543,2,3,0.4,5,2,23,23,5,18,23,0.109,0.391,0.5,17.624,43,riffle_clumpy
0,17,28,5,50,0.34,22,0.44,4,4,0.5,2,3,27,23,8,19,23,0.16,0.38,0.46,17.609,44,riffle_clumpy
0,20,24,4,48,0.417,24,0.5,4,2,0.667,1,2,28,20,5,17,26,0.104,0.354,0.542,17.611,45,riffle_clumpy
0,16,24,5,45,0.356,21,0.467,2,1,0.667,2,1,26,19,9,16,20,0.2,0.356,0.444,17.621,46,riffle_clumpy
0,21,21,1,43,0.488,22,0.512,3,1,0.75,3,3,26,17,16,8,19,0.372,0.186,0.442,17.623,47,riffle_clumpy
0,18,25,2,45,0.4,20,0.444,2,2,0.5,4,2,28,17,12,9,24,0.267,0.2,0.533,17.612,48,riffle_clumpy
0,19,27,0,46,0.413,19,0.413,4,2,0.667,2,1,29,17,9,10,27,0.196,0.217,0.587,17.613,49,riffle_clumpy
0,18,25,2,45,0.4,20,0.444,2,1,0.667,2,1,30,15,10,15,20,0.222,0.333,0.444,17.611,50,riffle_clumpy
0,18,22,3,43,0.419,21,0.488,1,2,0.333,1,0,30,13,8,16,19,0.186,0.372,0.442,17.621,51,riffle_clumpy
0,23,16,4,43,0.535,27,0.628,4,0,1.0,2,1,27,16,12,10,21,0.279,0.233,0.488,17.624,52,riffle_clumpy
0,25,20,0,45,0.556,25,0.556,8,2,0.8,2,3,28,17,14,11,20,0.311,0.244,0.444,17.627,53,riffle_clumpy
0,22,20,2,44,0.5,24,0.545,2,1,0.667,0,0,23,21,7,17,20,0.159,0.386,0.455,17.629,54,riffle_clumpy
0,25,21,3,49,0.51,28,0.571,1,2,0.333,4,2,30,19,17,11,21,0.347,0.224,0.429,17.618,55,riffle_clumpy
0,18,25,6,49,0.367,24,0.49,1,4,0.2,3,4,26,23,6,23,20,0.122,0.469,0.408,17.625,56,riffle_clumpy
0,17,23,3,43,0.395,20,0.465,3,2,0.6,0,1,24,19,14,13,16,0.326,0.302,0.372,17.637,57,riffle_clumpy
0,25,15,4,44,0.568,29,0.659,4,3,0.571,3,0,30,14,12,9,23,0.273,0.205,0.523,17.638,58,riffle_clumpy
0,20,20,2,42,0.476,22,0.524,2,2,0.5,0,0,20,22,15,16,11,0.357,0.381,0.262,17.644,59,riffle_clumpy
0,18,23,5,46,0.391,23,0.5,4,1,0.8,3,2,23,23,11,15,20,0.239,0.326,0.435,17.645,60,riffle_clumpy
0,18,22,4,44,0.409,22,0.5,3,4,0.429,5,1,30,14,9,12,23,0.205,0.273,0.523,17.647,61,riffle_clumpy
0,17,27,3,47,0.362,20,0.426,3,0,1.0,4,4,28,19,10,15,22,0.213,0.319,0.468,17.632,62,riffle_clumpy
0,23,20,3,46,0.5,26,0.565,3,1,0.75,4,1,26,20,13,12,21,0.283,0.261,0.457,17.624,63,riffle_clumpy
0,17,27,7,51,0.333,24,0.471,4,3,0.571,1,1,33,18,5,22,24,0.098,0.431,0.471,17.635,64,riffle_clumpy
0,17,23,6,46,0.37,23,0.5,3,1,0.75,2,2,24,22,10,18,18,0.217,0.391,0.391,17.635,65,riffle_clumpy
0,21,24,3,48,0.438,24,0.5,3,3,0.5,2,2,28,20,12,14,22,0.25,0.292,0.458,17.639,66,riffle_clumpy
0,15,28,5,48,0.312,20,0.417,3,2,0.6,1,7,31,17,7,14,27,0.146,0.292,0.562,17.643,67,riffle_clumpy
0,18,26,2,46,0.391,20,0.435,2,1,0.667,5,4,29,17,7,14,25,0.152,0.304,0.543,17.637,68,riffle_clumpy
0,17,25,1,43,0.395,18,0.419,2,1,0.667,1,2,27,16,11,12,20,0.256,0.279,0.465,17.636,69,riffle_clumpy
0,15,25,3,43,0.349,18,0.419,1,2,0.333,1,3,32,11,8,8,27,0.186,0.186,0.628,17.635,70,riffle_clumpy
0,18,23,3,44,0.409,21,0.477,4,2,0.667,2,1,30,14,10,10,24,0.227,0.227,0.545,17.628,71,riffle_clumpy
0,23,20,2,45,0.511,25,0.556,1,2,0.333,1,1,26,19,13,14,18,0.289,0.311,0.4,17.627,72,riffle_clumpy
0,23,16,3,42,0.548,26,0.619,4,2,0.667,3,0,27,15,15,12,15,0.357,0.286,0.357,17.63,73,riffle_clumpy
0,17,28,3,48,0.354,20,0.417,1,2,0.333,2,4,29,19,10,14,24,0.208,0.292,0.5,17.616,74,riffle_clumpy
0,21,19,4,44,0.477,25,0.568,3,5,0.375,3,0,27,17,11,18,15,0.25,0.409,0.341,17.621,75,riffle_clumpy
0,17,26,2,45,0.378,19,0.422,0,3,0.0,0,4,27,18,9,13,23,0.2,0.289,0.511,17.631,76,riffle_clumpy
0,17,23,4,44,0.386,21,0.477,5,3,0.625,2,2,27,17,11,13,20,0.25,0.295,0.455,17.626,77,riffle_clumpy
0,19,24,4,47,0.404,23,0.489,1,0,1.0,3,2,20,27,10,17,20,0.213,0.362,0.426,17.62,78,riffle_clumpy
0,20,23,1,44,0.455,21,0.477,0,3,0.0,2,3,25,19,10,13,21,0.227,0.295,0.477,17.618,79,riffle_clumpy
0,25,18,3,46,0.543,28,0.609,7,2,0.778,2,1,25,21,15,12,19,0.326,0.261,0.413,17.618,80,riffle_clumpy
0,19,22,5,46,0.413,24,0.522,3,3,0.5,1,0,32,14,9,11,26,0.196,0.239,0.565,17.614,81,riffle_clumpy
0,17,21,6,44,0.386,23,0.523,4,4,0.5,1,2,29,15,10,15,19,0.227,0.341,0.432,17.608,82,riffle_clumpy
0,22,21,3,46,0.478,25,0.543,1,1,0.5,2,5,27,19,15,13,18,0.326,0.283,0.391,17.607,83,riffle_clumpy
0,22,19,3,44,0.5,25,0.568,4,1,0.8,2,2,27,17,12,10,22,0.273,0.227,0.5,17.612,84,riffle_clumpy
0,18,28,1,47,0.383,19,0.404,4,2,0.667,1,4,25,22,6,21,20,0.128,0.447,0.426,17.603,85,riffle_clumpy
0,20,19,6,45,0.444,26,0.578,3,2,0.6,3,3,28,17,11,14,20,0.244,0.311,0.444,17.609,86,riffle_clumpy
0,14,24,6,44,0.318,20,0.455,0,2,0.0,0,6,29,15,9,14,21,0.205,0.318,0.477,17.62,87,riffle_clumpy
0,14,26,2,42,0.333,16,0.381,3,3,0.5,0,1,30,12,7,15,20,0.167,0.357,0.476,17.623,88,riffle_clumpy
0,18,25,2,45,0.4,20,0.444,2,3,0.4,1,1,24,21,9,15,21,0.2,0.333,0.467,17.631,89,riffle_clumpy
0,16,28,4,48,0.333,20,0.417,3,3,0.5,1,2,31,17,6,21,21,0.125,0.438,0.438,17.64,90,riffle_clumpy
0,18,25,5,48,0.375,23,0.479,3,1,0.75,1,3,31,17,7,15,26,0.146,0.312,0.542,17.639,91,riffle_clumpy
0,22,22,3,47,0.468,25,0.532,5,2,0.714,3,3,31,16,9,14,24,0.191,0.298,0.511,17.639,92,riffle_clumpy
0,18,20,10,48,0.375,28,0.583,5,4,0.556,0,1,25,23,14,13,21,0.292,0.271,0.438,17.64,93,riffle_clumpy
0,16,24,4,44,0.364,20,0.455,1,3,0.25,3,2,29,15,7,13,24,0.159,0.295,0.545,17.639,94,riffle_clumpy
0,20,29,1,50,0.4,21,0.42,4,1,0.8,1,1,31,19,10,14,26,0.2,0.28,0.52,17.638,95,riffle_clumpy
0,18,24,5,47,0.383,23,0.489,6,5,0.545,1,3,31,16,11,15,21,0.234,0.319,0.447,17.64,96,riffle_clumpy
0,20,22,5,47,0.426,25,0.532,4,3,0.571,2,3,27,20,13,12,22,0.277,0.255,0.468,18.276,1,riffle_clumpy
0,17,18,10,45,0.378,27,0.6,2,2,0.5,4,1,25,20,6,15,24,0.133,0.333,0.533,17.8,2,riffle_clumpy
0,23,17,6,46,0.5,29,0.63,3,1,0.75,3,5,30,16,10,13,23,0.217,0.283,0.5,17.755,3,riffle_clumpy
0,24,19,4,47,0.511,28,0.596,2,1,0.667,6,4,27,20,10,15,22,0.213,0.319,0.468,17.492,4,riffle_clumpy
0,22,18,5,45,0.489,27,0.6,4,1,0.8,6,1,27,18,11,17,17,0.244,0.378,0.378,17.617,5,riffle_clumpy
0,19,19,6,44,0.432,25,0.568,2,3,0.4,3,2,28,16,8,16,20,0.182,0.364,0.455,17.651,6,riffle_clumpy
0,22,21,4,47,0.468,26,0.553,3,2,0.6,4,1,25,22,13,13,21,0.277,0.277,0.447,17.591,7,riffle_clumpy
0,24,16,4,44,0.545,28,0.636,8,1,0.889,3,3,27,17,12,13,19,0.273,0.295,0.432,17.577,8,riffle_clumpy
0,20,27,4,51,0.392,24,0.471,1,3,0.25,2,1,29,22,7,19,25,0.137,0.373,0.49,17.571,9,riffle_clumpy
0,15,26,4,45,0.333,19,0.422,2,1,0.667,2,1,29,16,10,10,25,0.222,0.222,0.556,17.554,10,riffle_clumpy
0,22,20,4,46,0.478,26,0.565,5,1,0.833,1,1,31,15,11,12,23,0.239,0.261,0.5,17.641,11,riffle_clumpy
0,23,15,9,47,0.489,32,0.681,7,2,0.778,2,1,29,18,13,11,23,0.277,0.234,0.489,17.631,12,riffle_clumpy
0,23,17,3,43,0.535,26,0.605,3,0,1.0,2,1,27,16,21,4,18,0.488,0.093,0.419,17.606,13,riffle_clumpy
0,23,18,3,44,0.523,26,0.591,3,3,0.5,2,1,31,13,13,13,18,0.295,0.295,0.409,17.66,14,riffle_clumpy
0,21,15,10,46,0.457,31,0.674,3,4,0.429,2,3,30,16,11,20,15,0.239,0.435,0.326,17.712,15,riffle_clumpy
0,13,25,9,47,0.277,22,0.468,1,4,0.2,1,4,31,16,8,12,27,0.17,0.255,0.574,17.734,16,riffle_clumpy
0,14,28,3,45,0.311,17,0.378,1,5,0.167,0,2,26,19,9,15,21,0.2,0.333,0.467,17.772,17,riffle_clumpy
0,23,19,5,47,0.489,28,0.596,2,0,1.0,2,1,28,19,14,8,25,0.298,0.17,0.532,17.751,18,riffle_clumpy
0,18,26,2,46,0.391,20,0.435,1,2,0.333,2,2,31,15,8,15,23,0.174,0.326,0.5,17.737,19,riffle_clumpy
0,23,23,1,47,0.489,24,0.511,3,5,0.375,3,2,27,20,13,15,19,0.277,0.319,0.404,17.739,20,riffle_clumpy
0,19,23,3,45,0.422,22,0.489,3,4,0.429,1,1,25,20,10,16,19,0.222,0.356,0.422,17.773,21,riffle_clumpy
0,23,21,4,48,0.479,27,0.562,4,1,0.8,2,1,29,19,12,13,23,0.25,0.271,0.479,17.769,22,riffle_clumpy
0,18,25,2,45,0.4,20,0.444,2,3,0.4,1,2,30,15,8,14,23,0.178,0.311,0.511,17.775,23,riffle_clumpy
0,19,22,4,45,0.422,23,0.511,2,3,0.4,0,2,31,14,13,14,18,0.289,0.311,0.4,17.792,24,riffle_clumpy
0,21,21,4,46,0.457,25,0.543,1,2,0.333,4,1,28,18,7,14,25,0.152,0.304,0.543,17.775,25,riffle_clumpy
0,22,17,5,44,0.5,27,0.614,2,2,0.5,3,2,29,15,12,10,22,0.273,0.227,0.5,17.757,26,riffle_clumpy
0,16,22,5,43,0.372,21,0.488,3,4,0.429,3,0,21,22,8,18,17,0.186,0.419,0.395,17.756,27,riffle_clumpy
0,22,21,4,47,0.468,26,0.553,3,2,0.6,4,2,31,16,13,16,18,0.277,0.34,0.383,17.761,28,riffle_clumpy
0,19,24,1,44,0.432,20,0.455,1,2,0.333,2,2,27,17,11,15,18,0.25,0.341,0.409,17.784,29,riffle_clumpy
0,22,19,4,45,0.489,26,0.578,4,2,0.667,1,1,24,21,15,16,14,0.333,0.356,0.311,17.781,30,riffle_clumpy
0,23,18,2,43,0.535,25,0.581,8,2,0.8,2,0,23,20,14,14,15,0.326,0.326,0.349,17.784,31,riffle_clumpy
0,16,26,3,45,0.356,19,0.422,3,4,0.429,1,2,30,15,8,13,24,0.178,0.289,0.533,17.791,32,riffle_clumpy
0,16,28,2,46,0.348,18,0.391,2,3,0.4,2,5,25,21,10,19,17,0.217,0.413,0.37,17.797,33,riffle_clumpy
0,21,16,8,45,0.467,29,0.644,3,3,0.5,1,0,29,16,9,19,17,0.2,0.422,0.378,17.807,34,riffle_clumpy
0,18,25,7,50,0.36,25,0.5,3,0,1.0,3,1,27,23,7,17,26,0.14,0.34,0.52,17.777,35,riffle_clumpy
0,18,23,5,46,0.391,23,0.5,3,3,0.5,2,4,25,21,10,15,21,0.217,0.326,0.457,17.77,36,riffle_clumpy
0,22,21,3,46,0.478,25,0.543,5,2,0.714,2,5,29,17,12,9,25,0.261,0.196,0.543,17.771,37,riffle_clumpy
0,14,29,4,47,0.298,18,0.383,4,1,0.8,2,2,28,19,6,18,23,0.128,0.383,0.489,17.772,38,riffle_clumpy
0,17,23,4,44,0.386,21,0.477,1,2,0.333,1,2,27,17,7,16,21,0.159,0.364,0.477,17.772,39,riffle_clumpy
0,23,19,6,48,0.479,29,0.604,6,0,1.0,3,0,25,23,11,16,21,0.229,0.333,0.438,17.774,40,riffle_clumpy
0,20,19,7,46,0.435,27,0.587,2,0,1.0,1,1,27,19,12,14,20,0.261,0.304,0.435,17.773,41,riffle_clumpy
0,17,22,4,43,0.395,21,0.488,2,3,0.4,0,4,26,17,12,15,16,0.279,0.349,0.372,17.775,42,riffle_clumpy
0,29,15,2,46,0.63,31,0.674,5,2,0.714,2,1,31,15,19,9,18,0.413,0.196,0.391,17.774,43,riffle_clumpy
0,21,21,3,45,0.467,24,0.533,3,1,0.75,2,2,27,18,12,13,20,0.267,0.289,0.444,17.771,44,riffle_clumpy
0,18,25,1,44,0.409,19,0.432,2,1,0.667,1,2,30,14,10,11,23,0.227,0.25,0.523,17.753,45,riffle_clumpy
0,19,23,3,45,0.422,22,0.489,7,3,0.7,3,1,22,23,13,18,14,0.289,0.4,0.311,17.758,46,riffle_clumpy
0,22,23,1,46,0.478,23,0.5,4,2,0.667,3,1,29,17,9,14,23,0.196,0.304,0.5,17.751,47,riffle_clumpy
0,20,20,6,46,0.435,26,0.565,3,1,0.75,2,2,29,17,11,14,21,0.239,0.304,0.457,17.754,48,riffle_clumpy
0,23,20,3,46,0.5,26,0.565,3,0,1.0,3,1,22,24,15,13,18,0.326,0.283,0.391,17.745,49,riffle_clumpy
0,15,30,4,49,0.306,19,0.388,2,1,0.667,2,5,22,27,12,21,16,0.245,0.429,0.327,17.754,50,riffle_clumpy
0,17,26,1,44,0.386,18,0.409,3,3,0.5,0,4,27,17,12,10,22,0.273,0.227,0.5,17.759,51,riffle_clumpy
0,22,22,3,47,0.468,25,0.532,2,2,0.5,2,2,28,19,13,11,23,0.277,0.234,0.489,17.756,52,riffle_clumpy
0,25,17,3,45,0.556,28,0.622,3,1,0.75,5,2,23,22,13,13,19,0.289,0.289,0.422,17.738,53,riffle_clumpy
0,23,15,6,44,0.523,29,0.659,1,0,1.0,1,1,27,17,14,14,16,0.318,0.318,0.364,17.732,54,riffle_clumpy
0,18,22,4,44,0.409,22,0.5,3,1,0.75,2,0,29,15,8,13,23,0.182,0.295,0.523,17.737,55,riffle_clumpy
0,22,19,2,43,0.512,24,0.558,5,1,0.833,1,5,27,16,12,10,21,0.279,0.233,0.488,17.737,56,riffle_clumpy
0,23,22,1,46,0.5,24,0.522,1,2,0.333,2,2,20,26,15,12,19,0.326,0.261,0.413,17.73,57,riffle_clumpy
0,17,21,6,44,0.386,23,0.523,3,1,0.75,2,2,24,20,12,15,17,0.273,0.341,0.386,17.741,58,riffle_clumpy
0,19,25,2,46,0.413,21,0.457,3,3,0.5,3,1,26,20,10,17,19,0.217,0.37,0.413,17.737,59,riffle_clumpy
0,11,26,7,44,0.25,18,0.409,1,2,0.333,1,1,28,16,5,17,22,0.114,0.386,0.5,17.734,60,riffle_clumpy
0,19,22,5,46,0.413,24,0.522,4,2,0.667,2,3,30,16,11,12,23,0.239,0.261,0.5,17.743,61,riffle_clumpy
0,20,20,4,44,0.455,24,0.545,3,1,0.75,0,3,25,19,14,15,15,0.318,0.341,0.341,17.754,62,riffle_clumpy
0,22,18,4,44,0.5,26,0.591,6,2,0.75,0,1,25,19,16,11,17,0.364,0.25,0.386,17.758,63,riffle_clumpy
0,23,19,4,46,0.5,27,0.587,2,3,0.4,5,2,31,15,9,15,22,0.196,0.326,0.478,17.738,64,riffle_clumpy
0,17,20,8,45,0.378,25,0.556,3,1,0.75,2,5,30,15,9,12,24,0.2,0.267,0.533,17.727,65,riffle_clumpy
0,19,25,3,47,0.404,22,0.468,1,3,0.25,3,2,24,23,7,20,20,0.149,0.426,0.426,17.729,66,riffle_clumpy
0,14,27,5,46,0.304,19,0.413,3,3,0.5,3,2,28,18,9,19,18,0.196,0.413,0.391,17.726,67,riffle_clumpy
0,14,28,5,47,0.298,19,0.404,5,4,0.556,2,3,32,15,9,14,24,0.191,0.298,0.511,17.729,68,riffle_clumpy
0,23,20,2,45,0.511,25,0.556,2,1,0.667,4,1,25,20,12,12,21,0.267,0.267,0.467,17.71,69,riffle_clumpy
0,23,23,2,48,0.479,25,0.521,2,3,0.4,1,5,28,20,19,11,18,0.396,0.229,0.375,17.71,70,riffle_clumpy
0,18,24,3,45,0.4,21,0.467,1,2,0.333,0,4,31,14,10,14,21,0.222,0.311,0.467,17.716,71,riffle_clumpy
0,17,23,7,47,0.362,24,0.511,0,1,0.0,4,2,33,14,7,16,24,0.149,0.34,0.511,17.703,72,riffle_clumpy
0,18,22,6,46,0.391,24,0.522,1,3,0.25,2,2,30,16,8,13,25,0.174,0.283,0.543,17.705,73,riffle_clumpy
0,17,22,5,44,0.386,22,0.5,2,0,1.0,2,1,24,20,8,14,22,0.182,0.318,0.5,17.702,74,riffle_clumpy
0,14,26,5,45,0.311,19,0.422,2,1,0.667,1,2,28,17,7,18,20,0.156,0.4,0.444,17.697,75,riffle_clumpy
0,20,23,2,45,0.444,22,0.489,2,1,0.667,2,1,29,16,9,15,21,0.2,0.333,0.467,17.696,76,riffle_clumpy
0,17,23,3,43,0.395,20,0.465,1,2,0.333,2,1,24,19,12,16,15,0.279,0.372,0.349,17.695,77,riffle_clumpy
0,21,19,4,44,0.477,25,0.568,5,3,0.625,1,1,25,19,14,15,15,0.318,0.341,0.341,17.694,78,riffle_clumpy
0,22,22,2,46,0.478,24,0.522,5,3,0.625,0,1,26,20,14,11,21,0.304,0.239,0.457,17.695,79,riffle_clumpy
0,16,25,4,45,0.356,20,0.444,3,2,0.6,0,3,29,16,7,16,22,0.156,0.356,0.489,17.697,80,riffle_clumpy
0,19,23,5,47,0.404,24,0.511,2,2,0.5,3,4,34,13,7,16,24,0.149,0.34,0.511,17.697,81,riffle_clumpy
0,19,22,6,47,0.404,25,0.532,5,4,0.556,3,0,32,15,9,18,20,0.191,0.383,0.426,17.703,82,riffle_clumpy
0,24,20,6,50,0.48,30,0.6,3,3,0.5,3,1,24,26,9,18,23,0.18,0.36,0.46,17.694,83,riffle_clumpy
0,22,18,7,47,0.468,29,0.617,3,0,1.0,3,2,30,17,14,13,20,0.298,0.277,0.426,17.695,84,riffle_clumpy
0,22,20,2,44,0.5,24,0.545,1,1,0.5,3,0,26,18,7,13,24,0.159,0.295,0.545,17.692,85,riffle_clumpy
0,18,25,5,48,0.375,23,0.479,3,5,0.375,1,1,30,18,13,18,17,0.271,0.375,0.354,17.696,86,riffle_clumpy
0,21,18,6,45,0.467,27,0.6,3,2,0.6,2,2,31,14,14,14,17,0.311,0.311,0.378,17.694,87,riffle_clumpy
0,17,26,3,46,0.37,20,0.435,0,2,0.0,3,2,29,17,6,15,25,0.13,0.326,0.543,17.689,88,riffle_clumpy
0,16,23,8,47,0.34,24,0.511,4,3,0.571,5,0,20,27,8,18,21,0.17,0.383,0.447,17.682,89,riffle_clumpy
0,16,29,4,49,0.327,20,0.408,1,1,0.5,0,4,31,18,9,23,17,0.184,0.469,0.347,17.692,90,riffle_clumpy
0,21,22,3,46,0.457,24,0.522,4,1,0.8,5,2,24,22,11,15,20,0.239,0.326,0.435,17.692,91,riffle_clumpy
0,21,22,1,44,0.477,22,0.5,1,1,0.5,2,1,22,22,13,15,16,0.295,0.341,0.364,17.689,92,riffle_clumpy
0,26,17,3,46,0.565,29,0.63,5,1,0.833,1,1,26,20,14,16,16,0.304,0.348,0.348,17.695,93,riffle_clumpy
0,19,22,4,45,0.422,23,0.511,3,3,0.5,0,1,23,22,13,18,14,0.289,0.4,0.311,17.705,94,riffle_clumpy
0,20,22,3,45,0.444,23,0.511,2,2,0.5,2,1,27,18,6,18,21,0.133,0.4,0.467,17.708,95,riffle_clumpy
0,22,21,4,47,0.468,26,0.553,4,1,0.8,3,2,24,23,10,19,18,0.213,0.404,0.383,17.711,96,riffle_clumpy
0,18,26,2,46,0.391,20,0.435,1,1,0.5,1,1,28,18,5,17,24,0.109,0.37,0.522,17.541,1,riffle_clumpy
0,22,21,2,45,0.489,24,0.533,2,3,0.4,1,1,28,17,15,10,20,0.333,0.222,0.444,17.841,2,riffle_clumpy
0,19,25,2,46,0.413,21,0.457,7,2,0.778,1,1,27,19,11,17,18,0.239,0.37,0.391,17.978,3,riffle_clumpy
0,16,29,3,48,0.333,19,0.396,2,1,0.667,0,5,29,19,5,21,22,0.104,0.438,0.458,17.862,4,riffle_clumpy
0,18,22,5,45,0.4,23,0.511,4,2,0.667,4,2,27,18,10,13,22,0.222,0.289,0.489,17.803,5,riffle_clumpy
0,25,21,3,49,0.51,28,0.571,1,2,0.333,1,2,26,23,15,16,18,0.306,0.327,0.367,17.867,6,riffle_clumpy
0,21,19,3,43,0.488,24,0.558,3,3,0.5,4,0,23,20,11,18,14,0.256,0.419,0.326,17.852,7,riffle_clumpy
0,18,19,7,44,0.409,25,0.568,3,1,0.75,1,1,30,14,8,17,19,0.182,0.386,0.432,17.951,8,riffle_clumpy
0,16,26,5,47,0.34,21,0.447,4,4,0.5,1,1,31,16,10,15,22,0.213,0.319,0.468,18.0,9,riffle_clumpy
0,23,20,4,47,0.489,27,0.574,2,3,0.4,4,8,30,17,12,12,23,0.255,0.255,0.489,17.915,10,riffle_clumpy
0,22,26,4,52,0.423,26,0.5,1,1,0.5,4,3,31,21,12,19,21,0.231,0.365,0.404,17.855,11,riffle_clumpy
0,13,28,5,46,0.283,18,0.391,2,3,0.4,0,1,28,18,6,20,20,0.13,0.435,0.435,17.821,12,riffle_clumpy
0,17,27,4,48,0.354,21,0.438,3,1,0.75,4,0,30,18,5,22,21,0.104,0.458,0.438,17.838,13,riffle_clumpy
0,20,23,3,46,0.435,23,0.5,4,2,0.667,5,5,26,20,10,13,23,0.217,0.283,0.5,17.792,14,riffle_clumpy
0,27,16,3,46,0.587,30,0.652,5,2,0.714,0,2,29,17,18,13,15,0.391,0.283,0.326,17.785,15,riffle_clumpy
0,20,24,3,47,0.426,23,0.489,0,0,0,1,0,29,18,9,15,23,0.191,0.319,0.489,17.777,16,riffle_clumpy
0,13,27,5,45,0.289,18,0.4,3,3,0.5,2,2,30,15,8,17,20,0.178,0.378,0.444,17.78,17,riffle_clumpy
0,17,19,8,44,0.386,25,0.568,3,3,0.5,2,2,26,18,12,17,15,0.273,0.386,0.341,17.79,18,riffle_clumpy
0,20,20,5,45,0.444,25,0.556,2,1,0.667,3,2,28,17,11,13,21,0.244,0.289,0.467,17.764,19,riffle_clumpy
0,21,22,3,46,0.457,24,0.522,2,3,0.4,4,3,28,18,12,10,24,0.261,0.217,0.522,17.721,20,riffle_clumpy
0,23,15,7,45,0.511,30,0.667,4,1,0.8,5,0,27,18,9,15,21,0.2,0.333,0.467,17.732,21,riffle_clumpy
0,22,18,2,42,0.524,24,0.571,7,3,0.7,1,0,26,16,11,11,20,0.262,0.262,0.476,17.736,22,riffle_clumpy
0,19,21,4,44,0.432,23,0.523,3,2,0.6,0,2,26,18,11,16,17,0.25,0.364,0.386,17.724,23,riffle_clumpy
0,19,22,4,45,0.422,23,0.511,1,2,0.333,2,3,26,19,12,13,20,0.267,0.289,0.444,17.744,24,riffle_clumpy
0,17,23,6,46,0.37,23,0.5,3,4,0.429,3,2,27,19,10,13,23,0.217,0.283,0.5,17.759,25,riffle_clumpy
0,19,23,2,44,0.432,21,0.477,2,0,1.0,1,1,25,19,9,18,17,0.205,0.409,0.386,17.778,26,riffle_clumpy
0,16,25,7,48,0.333,23,0.479,2,3,0.4,1,3,29,19,9,19,20,0.188,0.396,0.417,17.792,27,riffle_clumpy
0,28,16,2,46,0.609,30,0.652,7,3,0.7,2,0,26,20,19,10,17,0.413,0.217,0.37,17.788,28,riffle_clumpy
0,16,27,2,45,0.356,18,0.4,2,1,0.667,1,2,29,16,10,11,24,0.222,0.244,0.533,17.762,29,riffle_clumpy
0,23,23,0,46,0.5,23,0.5,6,3,0.667,2,4,19,27,9,21,16,0.196,0.457,0.348,17.77,30,riffle_clumpy
0,22,22,2,46,0.478,24,0.522,3,3,0.5,3,1,31,15,10,15,21,0.217,0.326,0.457,17.762,31,riffle_clumpy
0,20,20,4,44,0.455,24,0.545,4,0,1.0,2,3,26,18,10,13,21,0.227,0.295,0.477,17.746,32,riffle_clumpy
0,21,19,4,44,0.477,25,0.568,0,1,0.0,2,2,25,19,15,15,14,0.341,0.341,0.318,17.753,33,riffle_clumpy
0,18,23,5,46,0.391,23,0.5,2,2,0.5,3,4,25,21,9,16,21,0.196,0.348,0.457,17.734,34,riffle_clumpy
0,22,19,3,44,0.5,25,0.568,5,2,0.714,3,2,26,18,11,9,24,0.25,0.205,0.545,17.736,35,riffle_clumpy
0,16,26,4,46,0.348,20,0.435,2,2,0.5,2,4,23,23,9,17,20,0.196,0.37,0.435,17.758,36,riffle_clumpy
0,16,25,4,45,0.356,20,0.444,4,0,1.0,2,1,29,16,8,17,20,0.178,0.378,0.444,17.75,37,riffle_clumpy
0,23,23,2,48,0.479,25,0.521,1,2,0.333,3,3,27,21,14,12,22,0.292,0.25,0.458,17.745,38,riffle_clumpy
0,20,24,3,47,0.426,23,0.489,2,2,0.5,1,4,30,17,13,14,20,0.277,0.298,0.426,17.731,39,riffle_clumpy
0,21,21,4,46,0.457,25,0.543,6,0,1.0,2,1,30,16,10,13,23,0.217,0.283,0.5,17.71,40,riffle_clumpy
0,21,19,7,47,0.447,28,0.596,4,0,1.0,2,0,28,19,9,22,16,0.191,0.468,0.34,17.717,41,riffle_clumpy
0,19,25,4,48,0.396,23,0.479,3,3,0.5,3,3,37,11,9,13,26,0.188,0.271,0.542,17.726,42,riffle_clumpy
0,16,26,4,46,0.348,20,0.435,3,3,0.5,2,1,29,17,4,20,22,0.087,0.435,0.478,17.732,43,riffle_clumpy
0,22,21,2,45,0.489,24,0.533,3,1,0.75,1,2,27,18,16,11,18,0.356,0.244,0.4,17.73,44,riffle_clumpy
0,26,19,4,49,0.531,30,0.612,5,1,0.833,1,1,29,20,15,14,20,0.306,0.286,0.408,17.734,45,riffle_clumpy
0,16,25,5,46,0.348,21,0.457,3,0,1.0,3,4,30,16,8,13,25,0.174,0.283,0.543,17.703,46,riffle_clumpy
0,22,20,5,47,0.468,27,0.574,2,2,0.5,1,5,33,14,13,14,20,0.277,0.298,0.426,17.702,47,riffle_clumpy
0,25,18,5,48,0.521,30,0.625,3,2,0.6,4,2,26,22,17,12,19,0.354,0.25,0.396,17.691,48,riffle_clumpy
0,24,17,4,45,0.533,28,0.622,3,1,0.75,7,3,25,20,16,8,21,0.356,0.178,0.467,17.681,49,riffle_clumpy
0,13,28,3,44,0.295,16,0.364,1,1,0.5,2,1,25,19,7,17,20,0.159,0.386,0.455,17.68,50,riffle_clumpy
0,24,19,3,46,0.522,27,0.587,4,1,0.8,3,2,29,17,11,14,21,0.239,0.304,0.457,17.671,51,riffle_clumpy
0,19,25,1,45,0.422,20,0.444,2,3,0.4,2,1,24,21,14,14,17,0.311,0.311,0.378,17.679,52,riffle_clumpy
0,17,24,5,46,0.37,22,0.478,0,2,0.0,3,3,26,20,8,16,22,0.174,0.348,0.478,17.686,53,riffle_clumpy
0,20,22,5,47,0.426,25,0.532,1,2,0.333,3,3,32,15,10,12,25,0.213,0.255,0.532,17.687,54,riffle_clumpy
0,24,21,2,47,0.511,26,0.553,2,2,0.5,2,1,25,22,14,15,18,0.298,0.319,0.383,17.684,55,riffle_clumpy
0,17,22,4,43,0.395,21,0.488,2,1,0.667,1,4,30,13,16,8,19,0.372,0.186,0.442,17.682,56,riffle_clumpy
0,14,25,4,43,0.326,18,0.419,0,2,0.0,3,1,21,22,8,18,17,0.186,0.419,0.395,17.681,57,riffle_clumpy
0,22,17,5,44,0.5,27,0.614,4,2,0.667,1,0,24,20,13,12,19,0.295,0.273,0.432,17.681,58,riffle_clumpy
0,18,23,6,47,0.383,24,0.511,2,3,0.4,1,6,31,16,9,14,24,0.191,0.298,0.511,17.683,59,riffle_clumpy
0,19,24,2,45,0.422,21,0.467,3,2,0.6,4,5,25,20,9,15,21,0.2,0.333,0.467,17.678,60,riffle_clumpy
0,13,24,9,46,0.283,22,0.478,1,1,0.5,3,5,30,16,7,14,25,0.152,0.304,0.543,17.677,61,riffle_clumpy
0,15,26,4,45,0.333,19,0.422,3,2,0.6,2,3,27,18,9,13,23,0.2,0.289,0.511,17.684,62,riffle_clumpy
0,25,18,3,46,0.543,28,0.609,2,1,0.667,2,2,29,17,17,11,18,0.37,0.239,0.391,17.685,63,riffle_clumpy
0,22,17,4,43,0.512,26,0.605,4,0,1.0,1,2,26,17,14,13,16,0.326,0.302,0.372,17.687,64,riffle_clumpy
0,22,18,4,44,0.5,26,0.591,1,4,0.2,3,1,29,15,11,12,21,0.25,0.273,0.477,17.695,65,riffle_clumpy
0,26,16,1,43,0.605,27,0.628,3,2,0.6,2,0,27,16,15,12,16,0.349,0.279,0.372,17.695,66,riffle_clumpy
0,21,21,4,46,0.457,25,0.543,2,3,0.4,3,1,24,22,11,20,15,0.239,0.435,0.326,17.695,67,riffle_clumpy
0,17,29,1,47,0.362,18,0.383,2,1,0.667,1,7,30,17,10,11,26,0.213,0.234,0.553,17.688,68,riffle_clumpy
0,19,22,6,47,0.404,25,0.532,2,2,0.5,1,5,26,21,10,16,21,0.213,0.34,0.447,17.691,69,riffle_clumpy
0,24,18,4,46,0.522,28,0.609,9,1,0.9,1,4,22,24,13,16,17,0.283,0.348,0.37,17.694,70,riffle_clumpy
0,29,16,2,47,0.617,31,0.66,4,1,0.8,1,2,27,20,15,15,17,0.319,0.319,0.362,17.693,71,riffle_clumpy
0,19,24,5,48,0.396,24,0.5,4,2,0.667,2,4,30,18,10,14,24,0.208,0.292,0.5,17.68,72,riffle_clumpy
0,22,18,4,44,0.5,26,0.591,5,2,0.714,0,5,30,14,11,12,21,0.25,0.273,0.477,17.687,73,riffle_clumpy
0,15,22,8,45,0.333,23,0.511,1,3,0.25,1,1,31,14,9,17,19,0.2,0.378,0.422,17.686,74,riffle_clumpy
0,17,22,8,47,0.362,25,0.532,1,3,0.25,4,4,26,21,6,17,24,0.128,0.362,0.511,17.678,75,riffle_clumpy
0,13,30,5,48,0.271,18,0.375,0,3,0.0,1,1,27,21,4,21,23,0.083,0.438,0.479,17.682,76,riffle_clumpy
0,16,27,4,47,0.34,20,0.426,2,3,0.4,3,1,29,18,7,17,23,0.149,0.362,0.489,17.69,77,riffle_clumpy
0,25,23,2,50,0.5,27,0.54,4,1,0.8,2,0,25,25,16,13,21,0.32,0.26,0.42,17.688,78,riffle_clumpy
0,18,22,6,46,0.391,24,0.522,1,1,0.5,1,1,30,16,6,19,21,0.13,0.413,0.457,17.686,79,riffle_clumpy
0,21,22,4,47,0.447,25,0.532,3,3,0.5,2,2,32,15,11,16,20,0.234,0.34,0.426,17.682,80,riffle_clumpy
0,19,22,4,45,0.422,23,0.511,1,2,0.333,1,1,28,17,11,16,18,0.244,0.356,0.4,17.673,81,riffle_clumpy
0,25,15,3,43,0.581,28,0.651,4,0,1.0,0,1,25,18,15,12,16,0.349,0.279,0.372,17.68,82,riffle_clumpy
0,15,25,3,43,0.349,18,0.419,4,1,0.8,2,1,26,17,11,13,19,0.256,0.302,0.442,17.676,83,riffle_clumpy
0,21,19,5,45,0.467,26,0.578,2,3,0.4,3,1,28,17,10,14,21,0.222,0.311,0.467,17.678,84,riffle_clumpy
0,19,17,7,43,0.442,26,0.605,3,1,0.75,1,4,27,16,11,12,20,0.256,0.279,0.465,17.686,85,riffle_clumpy
0,16,27,1,44,0.364,17,0.386,1,4,0.2,3,2,32,12,8,11,25,0.182,0.25,0.568,17.684,86,riffle_clumpy
0,20,20,4,44,0.455,24,0.545,1,1,0.5,3,2,24,20,9,16,19,0.205,0.364,0.432,17.682,87,riffle_clumpy
0,17,26,4,47,0.362,21,0.447,1,1,0.5,2,1,29,18,7,18,22,0.149,0.383,0.468,17.674,88,riffle_clumpy
0,16,21,7,44,0.364,23,0.523,1,3,0.25,3,1,29,15,11,8,25,0.25,0.182,0.568,17.673,89,riffle_clumpy
0,13,24,7,44,0.295,20,0.455,2,0,1.0,2,1,29,15,7,17,20,0.159,0.386,0.455,17.68,90,riffle_clumpy
0,18,22,5,45,0.4,23,0.511,2,2,0.5,3,3,26,19,12,14,19,0.267,0.311,0.422,17.678,91,riffle_clumpy
0,24,20,1,45,0.533,25,0.556,1,2,0.333,4,2,25,20,12,13,20,0.267,0.289,0.444,17.678,92,riffle_clumpy
0,25,19,4,48,0.521,29,0.604,4,5,0.444,2,2,30,18,12,14,22,0.25,0.292,0.458,17.68,93,riffle_clumpy
0,27,16,3,46,0.587,30,0.652,3,1,0.75,1,0,26,20,14,11,21,0.304,0.239,0.457,17.677,94,riffle_clumpy
0,18,23,4,45,0.4,22,0.489,3,1,0.75,3,3,33,12,7,13,25,0.156,0.289,0.556,17.675,95,riffle_clumpy
0,21,17,6,44,0.477,27,0.614,4,0,1.0,2,3,29,15,11,15,18,0.25,0.341,0.409,17.684,96,riffle_clumpy
0,13,22,10,45,0.289,23,0.511,2,5,0.286,1,1,28,17,5,17,23,0.111,0.378,0.511,18.306,1,riffle_clumpy
0,22,20,4,46,0.478,26,0.565,4,4,0.5,1,2,30,16,12,11,23,0.261,0.239,0.5,17.723,2,riffle_clumpy
0,23,20,0,43,0.535,23,0.535,3,3,0.5,4,1,27,16,10,15,18,0.233,0.349,0.419,17.653,3,riffle_clumpy
0,26,18,2,46,0.565,28,0.609,5,2,0.714,3,0,30,16,14,13,19,0.304,0.283,0.413,17.532,4,riffle_clumpy
0,15,25,3,43,0.349,18,0.419,3,1,0.75,2,1,27,16,10,12,21,0.233,0.279,0.488,17.684,5,riffle_clumpy
0,16,24,5,45,0.356,21,0.467,5,1,0.833,2,1,28,17,6,18,21,0.133,0.4,0.467,17.559,6,riffle_clumpy
0,12,25,10,47,0.255,22,0.468,1,1,0.5,1,2,30,17,5,18,24,0.106,0.383,0.511,17.622,7,riffle_clumpy
0,18,24,7,49,0.367,25,0.51,5,0,1.0,0,3,31,18,8,19,22,0.163,0.388,0.449,17.698,8,riffle_clumpy
0,19,25,0,44,0.432,19,0.432,4,4,0.5,4,0,24,20,9,18,17,0.205,0.409,0.386,17.694,9,riffle_clumpy
0,17,23,3,43,0.395,20,0.465,3,1,0.75,1,2,27,16,13,11,19,0.302,0.256,0.442,17.71,10,riffle_clumpy
0,16,25,3,44,0.364,19,0.432,4,2,0.667,1,4,28,16,10,13,21,0.227,0.295,0.477,17.737,11,riffle_clumpy
0,14,25,9,48,0.292,23,0.479,2,3,0.4,4,4,27,21,5,27,16,0.104,0.562,0.333,17.771,12,riffle_clumpy
0,18,22,7,47,0.383,25,0.532,3,3,0.5,2,3,29,18,7,20,20,0.149,0.426,0.426,17.803,13,riffle_clumpy
0,16,24,5,45,0.356,21,0.467,2,2,0.5,2,0,28,17,8,17,20,0.178,0.378,0.444,17.77,14,riffle_clumpy
0,20,24,2,46,0.435,22,0.478,0,4,0.0,4,2,20,26,11,18,17,0.239,0.391,0.37,17.732,15,riffle_clumpy
0,22,21,3,46,0.478,25,0.543,2,4,0.333,2,2,28,18,14,16,16,0.304,0.348,0.348,17.749,16,riffle_clumpy
0,23,22,2,47,0.489,25,0.532,2,4,0.333,5,2,28,19,8,15,24,0.17,0.319,0.511,17.718,17,riffle_clumpy
0,25,19,1,45,0.556,26,0.578,2,4,0.333,4,3,26,19,12,16,17,0.267,0.356,0.378,17.718,18,riffle_clumpy
0,17,25,4,46,0.37,21,0.457,2,2,0.5,1,2,25,21,8,20,18,0.174,0.435,0.391,17.762,19,riffle_clumpy
0,20,21,4,45,0.444,24,0.533,0,0,0,1,2,29,16,14,13,18,0.311,0.289,0.4,17.783,20,riffle_clumpy
0,20,19,6,45,0.444,26,0.578,5,1,0.833,2,3,30,15,9,18,18,0.2,0.4,0.4,17.809,21,riffle_clumpy
0,24,19,3,46,0.522,27,0.587,3,0,1.0,1,3,27,19,21,9,16,0.457,0.196,0.348,17.808,22,riffle_clumpy
0,25,18,3,46,0.543,28,0.609,2,1,0.667,5,2,27,19,14,12,20,0.304,0.261,0.435,17.792,23,riffle_clumpy
0,18,23,3,44,0.409,21,0.477,1,0,1.0,1,2,31,13,9,12,23,0.205,0.273,0.523,17.778,24,riffle_clumpy
0,21,18,5,44,0.477,26,0.591,3,2,0.6,1,2,26,18,16,7,21,0.364,0.159,0.477,17.756,25,riffle_clumpy
0,15,24,4,43,0.349,19,0.442,2,1,0.667,2,1,23,20,10,17,16,0.233,0.395,0.372,17.742,26,riffle_clumpy
0,17,24,5,46,0.37,22,0.478,2,1,0.667,2,3,27,19,11,15,20,0.239,0.326,0.435,17.757,27,riffle_clumpy
0,13,27,5,45,0.289,18,0.4,3,4,0.429,0,4,28,17,7,18,20,0.156,0.4,0.444,17.763,28,riffle_clumpy
0,21,20,4,45,0.467,25,0.556,1,0,1.0,1,1,30,15,12,14,19,0.267,0.311,0.422,17.763,29,riffle_clumpy
0,23,20,4,47,0.489,27,0.574,3,0,1.0,5,4,26,21,10,15,22,0.213,0.319,0.468,17.748,30,riffle_clumpy
0,22,19,3,44,0.5,25,0.568,4,2,0.667,4,2,21,23,13,12,19,0.295,0.273,0.432,17.711,31,riffle_clumpy
0,24,14,6,44,0.545,30,0.682,4,0,1.0,3,1,25,19,12,17,15,0.273,0.386,0.341,17.706,32,riffle_clumpy
0,14,26,4,44,0.318,18,0.409,2,2,0.5,1,4,28,16,9,16,19,0.205,0.364,0.432,17.693,33,riffle_clumpy
0,15,26,5,46,0.326,20,0.435,1,0,1.0,2,3,25,21,10,11,25,0.217,0.239,0.543,17.667,34,riffle_clumpy
0,14,25,7,46,0.304,21,0.457,3,3,0.5,1,4,30,16,9,13,24,0.196,0.283,0.522,17.66,35,riffle_clumpy
0,23,23,1,47,0.489,24,0.511,3,4,0.429,2,3,29,18,9,20,18,0.191,0.426,0.383,17.658,36,riffle_clumpy
0,19,24,4,47,0.404,23,0.489,1,2,0.333,3,5,31,16,10,14,23,0.213,0.298,0.489,17.649,37,riffle_clumpy
0,13,28,4,45,0.289,17,0.378,1,3,0.25,0,2,34,11,10,11,24,0.222,0.244,0.533,17.672,38,riffle_clumpy
0,22,17,4,43,0.512,26,0.605,4,2,0.667,2,2,26,17,13,14,16,0.302,0.326,0.372,17.672,39,riffle_clumpy
0,22,15,9,46,0.478,31,0.674,3,0,1.0,1,0,30,16,11,16,19,0.239,0.348,0.413,17.69,40,riffle_clumpy
0,20,22,5,47,0.426,25,0.532,2,4,0.333,3,2,26,21,10,17,20,0.213,0.362,0.426,17.703,41,riffle_clumpy
0,16,25,3,44,0.364,19,0.432,3,2,0.6,2,5,26,18,11,14,19,0.25,0.318,0.432,17.702,42,riffle_clumpy
0,26,19,1,46,0.565,27,0.587,3,1,0.75,0,2,28,18,14,16,16,0.304,0.348,0.348,17.706,43,riffle_clumpy
0,26,16,7,49,0.531,33,0.673,7,1,0.875,2,0,29,20,16,15,18,0.327,0.306,0.367,17.701,44,riffle_clumpy
0,26,19,3,48,0.542,29,0.604,2,0,1.0,5,2,28,20,10,20,18,0.208,0.417,0.375,17.681,45,riffle_clumpy
0,22,19,3,44,0.5,25,0.568,3,1,0.75,2,0,23,21,14,10,20,0.318,0.227,0.455,17.676,46,riffle_clumpy
0,18,24,3,45,0.4,21,0.467,4,2,0.667,0,4,26,19,10,16,19,0.222,0.356,0.422,17.695,47,riffle_clumpy
0,19,22,5,46,0.413,24,0.522,3,3,0.5,2,2,26,20,11,19,16,0.239,0.413,0.348,17.689,48,riffle_clumpy
0,18,20,5,43,0.419,23,0.535,3,3,0.5,1,1,29,14,15,7,21,0.349,0.163,0.488,17.693,49,riffle_clumpy
0,18,20,5,43,0.419,23,0.535,2,1,0.667,1,3,28,15,11,9,23,0.256,0.209,0.535,17.688,50,riffle_clumpy
0,18,22,7,47,0.383,25,0.532,4,0,1.0,1,2,30,17,12,13,22,0.255,0.277,0.468,17.697,51,riffle_clumpy
0,17,23,4,44,0.386,21,0.477,0,3,0.0,1,3,28,16,9,16,19,0.205,0.364,0.432,17.71,52,riffle_clumpy
0,16,26,3,45,0.356,19,0.422,2,1,0.667,3,4,30,15,6,16,23,0.133,0.356,0.511,17.699,53,riffle_clumpy
0,22,21,5,48,0.458,27,0.562,4,4,0.5,3,3,25,23,14,12,22,0.292,0.25,0.458,17.69,54,riffle_clumpy
0,15,23,4,42,0.357,19,0.452,5,2,0.714,0,1,21,21,11,17,14,0.262,0.405,0.333,17.71,55,riffle_clumpy
0,17,24,3,44,0.386,20,0.455,1,1,0.5,1,5,29,15,9,12,23,0.205,0.273,0.523,17.707,56,riffle_clumpy
0,21,22,7,50,0.42,28,0.56,1,0,1.0,3,3,30,20,10,18,22,0.2,0.36,0.44,17.703,57,riffle_clumpy
0,18,24,2,44,0.409,20,0.455,2,2,0.5,1,1,29,15,13,12,19,0.295,0.273,0.432,17.699,58,riffle_clumpy
0,19,21,3,43,0.442,22,0.512,3,3,0.5,1,1,26,17,13,14,16,0.302,0.326,0.372,17.7,59,riffle_clumpy
0,20,25,2,47,0.426,22,0.468,5,2,0.714,2,3,30,17,10,12,25,0.213,0.255,0.532,17.691,60,riffle_clumpy
0,16,23,6,45,0.356,22,0.489,1,2,0.333,3,3,31,14,5,14,26,0.111,0.311,0.578,17.696,61,riffle_clumpy
0,19,27,4,50,0.38,23,0.46,6,3,0.667,2,0,30,20,10,17,23,0.2,0.34,0.46,17.699,62,riffle_clumpy
0,25,16,4,45,0.556,29,0.644,5,2,0.714,1,4,24,21,14,12,19,0.311,0.267,0.422,17.69,63,riffle_clumpy
0,23,19,5,47,0.489,28,0.596,3,1,0.75,1,3,29,18,13,15,19,0.277,0.319,0.404,17.699,64,riffle_clumpy
0,22,19,5,46,0.478,27,0.587,5,1,0.833,4,0,29,17,7,14,25,0.152,0.304,0.543,17.696,65,riffle_clumpy
0,19,18,8,45,0.422,27,0.6,1,0,1.0,0,3,27,18,11,12,22,0.244,0.267,0.489,17.709,66,riffle_clumpy
0,16,23,6,45,0.356,22,0.489,2,2,0.5,1,2,31,14,10,14,21,0.222,0.311,0.467,17.707,67,riffle_clumpy
0,25,18,4,47,0.532,29,0.617,0,4,0.0,3,1,28,19,12,15,20,0.255,0.319,0.426,17.705,68,riffle_clumpy
0,21,18,8,47,0.447,29,0.617,4,1,0.8,3,3,28,19,14,17,16,0.298,0.362,0.34,17.709,69,riffle_clumpy
0,16,25,3,44,0.364,19,0.432,3,3,0.5,1,3,33,11,9,11,24,0.205,0.25,0.545,17.702,70,riffle_clumpy
0,17,25,4,46,0.37,21,0.457,1,3,0.25,1,2,28,18,11,13,22,0.239,0.283,0.478,17.697,71,riffle_clumpy
0,20,19,4,43,0.465,24,0.558,2,1,0.667,2,2,28,15,11,10,22,0.256,0.233,0.512,17.694,72,riffle_clumpy
0,18,21,7,46,0.391,25,0.543,3,2,0.6,1,4,31,15,12,13,21,0.261,0.283,0.457,17.695,73,riffle_clumpy
0,18,26,2,46,0.391,20,0.435,4,3,0.571,2,3,30,16,7,15,24,0.152,0.326,0.522,17.696,74,riffle_clumpy
0,20,19,6,45,0.444,26,0.578,6,0,1.0,2,3,28,17,12,13,20,0.267,0.289,0.444,17.691,75,riffle_clumpy
0,23,19,4,46,0.5,27,0.587,2,1,0.667,3,2,29,17,10,15,21,0.217,0.326,0.457,17.691,76,riffle_clumpy
0,17,25,2,44,0.386,19,0.432,1,3,0.25,5,0,30,14,5,14,25,0.114,0.318,0.568,17.698,77,riffle_clumpy
0,25,17,5,47,0.532,30,0.638,7,0,1.0,0,0,21,26,15,14,18,0.319,0.298,0.383,17.698,78,riffle_clumpy
0,20,24,4,48,0.417,24,0.5,4,4,0.5,4,0,19,29,7,22,19,0.146,0.458,0.396,17.691,79,riffle_clumpy
0,20,25,2,47,0.426,22,0.468,2,4,0.333,3,4,29,18,9,16,22,0.191,0.34,0.468,17.689,80,riffle_clumpy
0,14,30,2,46,0.304,16,0.348,1,5,0.167,5,3,32,14,6,17,23,0.13,0.37,0.5,17.694,81,riffle_clumpy
0,15,21,7,43,0.349,22,0.512,2,3,0.4,1,1,25,18,11,17,15,0.256,0.395,0.349,17.697,82,riffle_clumpy
0,22,20,1,43,0.512,23,0.535,6,2,0.75,0,4,29,14,14,10,19,0.326,0.233,0.442,17.697,83,riffle_clumpy
0,21,19,5,45,0.467,26,0.578,3,5,0.375,2,0,20,25,11,19,15,0.244,0.422,0.333,17.697,84,riffle_clumpy
0,22,19,2,43,0.512,24,0.558,4,1,0.8,2,0,24,19,12,11,20,0.279,0.256,0.465,17.687,85,riffle_clumpy
0,19,21,5,45,0.422,24,0.533,4,0,1.0,3,1,28,17,10,9,26,0.222,0.2,0.578,17.69,86,riffle_clumpy
0,20,21,2,43,0.465,22,0.512,4,1,0.8,2,2,30,13,13,13,17,0.302,0.302,0.395,17.683,87,riffle_clumpy
0,18,23,6,47,0.383,24,0.511,0,2,0.0,4,1,28,19,10,17,20,0.213,0.362,0.426,17.677,88,riffle_clumpy
0,19,25,2,46,0.413,21,0.457,5,2,0.714,4,4,30,16,5,16,25,0.109,0.348,0.543,17.672,89,riffle_clumpy
0,22,13,8,43,0.512,30,0.698,5,3,0.625,0,0,25,18,12,11,20,0.279,0.256,0.465,17.67,90,riffle_clumpy
0,22,16,6,44,0.5,28,0.636,4,1,0.8,2,1,21,23,14,14,16,0.318,0.318,0.364,17.668,91,riffle_clumpy
0,14,29,2,45,0.311,16,0.356,0,2,0.0,2,3,27,18,6,16,23,0.133,0.356,0.511,17.663,92,riffle_clumpy
0,26,21,1,48,0.542,27,0.562,4,2,0.667,3,3,23,25,14,13,21,0.292,0.271,0.438,17.649,93,riffle_clumpy
0,23,23,3,49,0.469,26,0.531,2,2,0.5,1,4,34,15,13,10,26,0.265,0.204,0.531,17.647,94,riffle_clumpy
0,20,22,4,46,0.435,24,0.522,3,2,0.6,2,1,30,16,13,16,17,0.283,0.348,0.37,17.648,95,riffle_clumpy
0,20,19,4,43,0.465,24,0.558,3,4,0.429,1,1,25,18,12,15,16,0.279,0.349,0.372,17.652,96,riffle_clumpy
0,19,25,4,48,0.396,23,0.479,3,2,0.6,3,2,35,13,6,17,25,0.125,0.354,0.521,17.667,1,riffle_clumpy
0,17,22,8,47,0.362,25,0.532,2,2,0.5,3,1,30,17,8,14,25,0.17,0.298,0.532,17.576,2,riffle_clumpy
0,22,20,3,45,0.489,25,0.556,2,1,0.667,1,0,23,22,18,15,12,0.4,0.333,0.267,17.674,3,riffle_clumpy
0,16,23,8,47,0.34,24,0.511,3,3,0.5,2,1,31,16,11,16,20,0.234,0.34,0.426,17.635,4,riffle_clumpy
0,18,20,5,43,0.419,23,0.535,2,2,0.5,3,3,30,13,13,9,21,0.302,0.209,0.488,17.61,5,riffle_clumpy
0,21,18,4,43,0.488,25,0.581,2,2,0.5,1,2,31,12,11,11,21,0.256,0.256,0.488,17.6,6,riffle_clumpy
0,19,22,4,45,0.422,23,0.511,0,3,0.0,2,3,28,17,12,11,22,0.267,0.244,0.489,17.693,7,riffle_clumpy
0,14,28,3,45,0.311,17,0.378,2,4,0.333,0,2,26,19,9,15,21,0.2,0.333,0.467,17.748,8,riffle_clumpy
0,18,24,3,45,0.4,21,0.467,8,0,1.0,1,7,28,17,9,14,22,0.2,0.311,0.489,17.671,9,riffle_clumpy
0,18,22,3,43,0.419,21,0.488,3,2,0.6,3,1,30,13,10,9,24,0.233,0.209,0.558,17.552,10,riffle_clumpy
0,17,23,7,47,0.362,24,0.511,2,3,0.4,2,3,34,13,9,15,23,0.191,0.319,0.489,17.543,11,riffle_clumpy
0,14,28,4,46,0.304,18,0.391,1,0,1.0,4,3,29,17,5,14,27,0.109,0.304,0.587,17.556,12,riffle_clumpy
0,24,20,1,45,0.533,25,0.556,4,2,0.667,2,1,30,15,13,10,22,0.289,0.222,0.489,17.556,13,riffle_clumpy
0,29,17,2,48,0.604,31,0.646,7,5,0.583,6,1,22,26,13,15,20,0.271,0.312,0.417,17.607,14,riffle_clumpy
0,20,21,5,46,0.435,25,0.543,4,5,0.444,4,1,24,22,12,15,19,0.261,0.326,0.413,17.589,15,riffle_clumpy
0,16,23,4,43,0.372,20,0.465,4,5,0.444,0,3,31,12,9,14,20,0.209,0.326,0.465,17.638,16,riffle_clumpy
0,22,22,0,44,0.5,22,0.5,2,3,0.4,3,2,25,19,12,15,17,0.273,0.341,0.386,17.648,17,riffle_clumpy
0,24,19,2,45,0.533,26,0.578,4,0,1.0,4,4,26,19,15,10,20,0.333,0.222,0.444,17.636,18,riffle_clumpy
0,19,26,1,46,0.413,20,0.435,4,1,0.8,0,2,22,24,11,14,21,0.239,0.304,0.457,17.593,19,riffle_clumpy
0,19,23,5,47,0.404,24,0.511,0,0,0,3,2,33,14,9,13,25,0.191,0.277,0.532,17.573,20,riffle_clumpy
0,20,21,4,45,0.444,24,0.533,2,3,0.4,2,2,29,16,9,15,21,0.2,0.333,0.467,17.56,21,riffle_clumpy
0,15,26,4,45,0.333,19,0.422,3,2,0.6,2,3,30,15,6,16,23,0.133,0.356,0.511,17.578,22,riffle_clumpy
0,19,24,2,45,0.422,21,0.467,5,4,0.556,4,4,30,15,9,10,26,0.2,0.222,0.578,17.568,23,riffle_clumpy
0,14,26,7,47,0.298,21,0.447,1,5,0.167,1,2,29,18,7,19,21,0.149,0.404,0.447,17.555,24,riffle_clumpy
0,21,20,4,45,0.467,25,0.556,3,0,1.0,3,1,26,19,12,12,21,0.267,0.267,0.467,17.536,25,riffle_clumpy
0,14,26,3,43,0.326,17,0.395,0,3,0.0,0,2,29,14,7,20,16,0.163,0.465,0.372,17.548,26,riffle_clumpy
0,21,18,7,46,0.457,28,0.609,2,1,0.667,2,2,32,14,12,13,21,0.261,0.283,0.457,17.547,27,riffle_clumpy
0,25,18,2,45,0.556,27,0.6,5,1,0.833,1,3,30,15,15,10,20,0.333,0.222,0.444,17.536,28,riffle_clumpy
0,13,27,6,46,0.283,19,0.413,1,1,0.5,1,0,26,20,7,17,22,0.152,0.37,0.478,17.561,29,riffle_clumpy
0,21,19,6,46,0.457,27,0.587,3,0,1.0,5,4,30,16,10,15,21,0.217,0.326,0.457,17.57,30,riffle_clumpy
0,23,17,5,45,0.511,28,0.622,3,3,0.5,2,2,24,21,13,13,19,0.289,0.289,0.422,17.581,31,riffle_clumpy
0,21,25,2,48,0.438,23,0.479,6,2,0.75,2,2,31,17,9,8,31,0.188,0.167,0.646,17.571,32,riffle_clumpy
0,21,18,5,44,0.477,26,0.591,2,3,0.4,2,1,28,16,8,15,21,0.182,0.341,0.477,17.59,33,riffle_clumpy
0,21,24,3,48,0.438,24,0.5,2,7,0.222,2,1,24,24,13,15,20,0.271,0.312,0.417,17.585,34,riffle_clumpy
0,20,23,3,46,0.435,23,0.5,2,3,0.4,1,3,23,23,12,16,18,0.261,0.348,0.391,17.592,35,riffle_clumpy
0,23,20,1,44,0.523,24,0.545,4,0,1.0,2,2,24,20,16,9,19,0.364,0.205,0.432,17.583,36,riffle_clumpy
0,18,25,3,46,0.391,21,0.457,2,1,0.667,2,2,29,17,7,21,18,0.152,0.457,0.391,17.587,37,riffle_clumpy
0,18,23,5,46,0.391,23,0.5,2,6,0.25,2,0,27,19,7,17,22,0.152,0.37,0.478,17.6,38,riffle_clumpy
0,24,17,3,44,0.545,27,0.614,2,4,0.333,3,1,33,11,11,13,20,0.25,0.295,0.455,17.597,39,riffle_clumpy
0,20,22,3,45,0.444,23,0.511,2,1,0.667,3,2,28,17,9,11,25,0.2,0.244,0.556,17.602,40,riffle_clumpy
0,21,21,3,45,0.467,24,0.533,3,1,0.75,5,3,29,16,9,10,26,0.2,0.222,0.578,17.584,41,riffle_clumpy
0,23,21,1,45,0.511,24,0.533,5,0,1.0,3,2,24,21,12,11,22,0.267,0.244,0.489,17.567,42,riffle_clumpy
0,20,22,5,47,0.426,25,0.532,3,3,0.5,4,3,31,16,10,14,23,0.213,0.298,0.489,17.547,43,riffle_clumpy
0,21,21,3,45,0.467,24,0.533,4,2,0.667,5,0,24,21,11,14,20,0.244,0.311,0.444,17.538,44,riffle_clumpy
0,19,21,5,45,0.422,24,0.533,4,1,0.8,3,4,28,17,10,11,24,0.222,0.244,0.533,17.542,45,riffle_clumpy
0,17,28,3,48,0.354,20,0.417,4,3,0.571,1,2,29,19,13,17,18,0.271,0.354,0.375,17.553,46,riffle_clumpy
0,15,27,6,48,0.312,21,0.438,2,5,0.286,3,6,26,22,7,20,21,0.146,0.417,0.438,17.567,47,riffle_clumpy
0,19,19,7,45,0.422,26,0.578,2,1,0.667,1,3,28,17,13,9,23,0.289,0.2,0.511,17.573,48,riffle_clumpy
0,19,25,3,47,0.404,22,0.468,3,3,0.5,2,1,28,19,9,20,18,0.191,0.426,0.383,17.578,49,riffle_clumpy
0,17,24,4,45,0.378,21,0.467,2,0,1.0,1,3,30,15,11,11,23,0.244,0.244,0.511,17.585,50,riffle_clumpy
0,18,23,5,46,0.391,23,0.5,3,0,1.0,3,1,31,15,10,16,20,0.217,0.348,0.435,17.578,51,riffle_clumpy
0,18,21,4,43,0.419,22,0.512,2,1,0.667,1,2,31,12,12,12,19,0.279,0.279,0.442,17.591,52,riffle_clumpy
0,24,19,2,45,0.533,26,0.578,4,3,0.571,2,4,27,18,15,14,16,0.333,0.311,0.356,17.594,53,riffle_clumpy
0,16,26,3,45,0.356,19,0.422,2,2,0.5,2,4,25,20,10,14,21,0.222,0.311,0.467,17.597,54,riffle_clumpy
0,25,19,3,47,0.532,28,0.596,3,4,0.429,6,1,27,20,12,15,20,0.255,0.319,0.426,17.589,55,riffle_clumpy
0,18,23,4,45,0.4,22,0.489,3,1,0.75,4,2,30,15,6,15,24,0.133,0.333,0.533,17.609,56,riffle_clumpy
0,18,25,3,46,0.391,21,0.457,4,4,0.5,2,2,29,17,9,16,21,0.196,0.348,0.457,17.62,57,riffle_clumpy
0,19,25,2,46,0.413,21,0.457,2,0,1.0,3,1,30,16,6,15,25,0.13,0.326,0.543,17.619,58,riffle_clumpy
0,19,22,2,43,0.442,21,0.488,3,4,0.429,3,2,22,21,10,15,18,0.233,0.349,0.419,17.632,59,riffle_clumpy
0,18,22,4,44,0.409,22,0.5,2,3,0.4,1,1,32,12,7,18,19,0.159,0.409,0.432,17.64,60,riffle_clumpy
0,23,17,4,44,0.523,27,0.614,5,2,0.714,4,1,22,22,14,15,15,0.318,0.341,0.341,17.639,61,riffle_clumpy
0,17,22,5,44,0.386,22,0.5,3,2,0.6,3,2,26,18,8,16,20,0.182,0.364,0.455,17.643,62,riffle_clumpy
0,22,23,0,45,0.489,22,0.489,1,3,0.25,2,1,25,20,16,8,21,0.356,0.178,0.467,17.646,63,riffle_clumpy
0,18,28,2,48,0.375,20,0.417,3,3,0.5,4,1,24,24,10,20,18,0.208,0.417,0.375,17.654,64,riffle_clumpy
0,20,23,4,47,0.426,24,0.511,4,2,0.667,1,1,32,15,11,13,23,0.234,0.277,0.489,17.656,65,riffle_clumpy
0,18,29,2,49,0.367,20,0.408,2,2,0.5,3,5,28,21,4,20,25,0.082,0.408,0.51,17.649,66,riffle_clumpy
0,19,23,3,45,0.422,22,0.489,3,0,1.0,1,2,26,19,12,12,21,0.267,0.267,0.467,17.647,67,riffle_clumpy
0,20,18,5,43,0.465,25,0.581,2,2,0.5,3,2,24,19,10,17,16,0.233,0.395,0.372,17.644,68,riffle_clumpy
0,20,26,1,47,0.426,21,0.447,4,1,0.8,2,1,29,18,8,14,25,0.17,0.298,0.532,17.63,69,riffle_clumpy
0,18,24,5,47,0.383,23,0.489,6,3,0.667,1,5,31,16,9,11,27,0.191,0.234,0.574,17.627,70,riffle_clumpy
0,20,22,3,45,0.444,23,0.511,4,1,0.8,2,3,27,18,11,14,20,0.244,0.311,0.444,17.623,71,riffle_clumpy
0,17,23,4,44,0.386,21,0.477,0,2,0.0,1,0,23,21,12,20,12,0.273,0.455,0.273,17.631,72,riffle_clumpy
0,19,20,5,44,0.432,24,0.545,5,3,0.625,1,3,27,17,14,15,15,0.318,0.341,0.341,17.638,73,riffle_clumpy
0,25,17,4,46,0.543,29,0.63,6,5,0.545,1,3,28,18,17,15,14,0.37,0.326,0.304,17.643,74,riffle_clumpy
0,16,28,2,46,0.348,18,0.391,2,1,0.667,2,3,33,13,12,11,23,0.261,0.239,0.5,17.634,75,riffle_clumpy
0,19,20,5,44,0.432,24,0.545,3,4,0.429,3,0,27,17,9,21,14,0.205,0.477,0.318,17.632,76,riffle_clumpy
0,21,22,5,48,0.438,26,0.542,2,2,0.5,3,2,28,20,14,13,21,0.292,0.271,0.438,17.635,77,riffle_clumpy
0,23,20,4,47,0.489,27,0.574,5,2,0.714,4,2,28,19,11,10,26,0.234,0.213,0.553,17.635,78,riffle_clumpy
0,21,21,2,44,0.477,23,0.523,6,3,0.667,0,0,28,16,12,12,20,0.273,0.273,0.455,17.639,79,riffle_clumpy
0,25,19,0,44,0.568,25,0.568,3,2,0.6,6,2,30,14,11,11,22,0.25,0.25,0.5,17.632,80,riffle_clumpy
0,20,19,6,45,0.444,26,0.578,3,0,1.0,3,1,27,18,12,11,22,0.267,0.244,0.489,17.628,81,riffle_clumpy
0,23,16,7,46,0.5,30,0.652,3,0,1.0,2,4,30,16,14,12,20,0.304,0.261,0.435,17.626,82,riffle_clumpy
0,19,23,3,45,0.422,22,0.489,2,3,0.4,1,3,26,19,10,16,19,0.222,0.356,0.422,17.621,83,riffle_clumpy
0,18,27,2,47,0.383,20,0.426,2,1,0.667,2,2,29,18,6,20,21,0.128,0.426,0.447,17.626,84,riffle_clumpy
0,20,20,5,45,0.444,25,0.556,2,1,0.667,5,1,25,20,8,16,21,0.178,0.356,0.467,17.621,85,riffle_clumpy
0,19,27,5,51,0.373,24,0.471,0,0,0,2,1,27,24,11,14,26,0.216,0.275,0.51,17.61,86,riffle_clumpy
0,17,25,3,45,0.378,20,0.444,2,3,0.4,3,2,29,16,8,12,25,0.178,0.267,0.556,17.614,87,riffle_clumpy
0,20,22,4,46,0.435,24,0.522,1,4,0.2,3,3,32,14,8,19,19,0.174,0.413,0.413,17.615,88,riffle_clumpy
0,24,18,2,44,0.545,26,0.591,5,3,0.625,4,2,28,16,12,10,22,0.273,0.227,0.5,17.622,89,riffle_clumpy
0,21,25,1,47,0.447,22,0.468,3,6,0.333,1,1,27,20,11,16,20,0.234,0.34,0.426,17.621,90,riffle_clumpy
0,19,24,3,46,0.413,22,0.478,3,3,0.5,3,2,26,20,8,15,23,0.174,0.326,0.5,17.626,91,riffle_clumpy
0,20,20,4,44,0.455,24,0.545,1,0,1.0,4,3,25,19,10,11,23,0.227,0.25,0.523,17.62,92,riffle_clumpy
0,22,21,2,45,0.489,24,0.533,0,1,0.0,3,1,26,19,8,12,25,0.178,0.267,0.556,17.62,93,riffle_clumpy
0,22,20,4,46,0.478,26,0.565,4,2,0.667,0,5,27,19,11,16,19,0.239,0.348,0.413,17.627,94,riffle_clumpy
0,20,26,2,48,0.417,22,0.458,6,8,0.429,3,4,29,19,10,20,18,0.208,0.417,0.375,17.633,95,riffle_clumpy
0,16,23,5,44,0.364,21,0.477,2,1,0.667,1,1,31,13,7,16,21,0.159,0.364,0.477,17.634,96,riffle_clumpy
0,16,23,6,45,0.356,22,0.489,2,2,0.5,2,3,29,16,8,20,17,0.178,0.444,0.378,18.2,1,riffle_clumpy
0,20,22,4,46,0.435,24,0.522,2,2,0.5,2,3,28,18,12,16,18,0.261,0.348,0.391,18.105,2,riffle_clumpy
0,17,20,7,44,0.386,24,0.545,3,2,0.6,1,1,30,14,9,16,19,0.205,0.364,0.432,18.078,3,riffle_clumpy
0,17,22,7,46,0.37,24,0.522,3,1,0.75,2,2,29,17,11,20,15,0.239,0.435,0.326,18.084,4,riffle_clumpy
0,20,21,4,45,0.444,24,0.533,0,1,0.0,4,2,28,17,9,17,19,0.2,0.378,0.422,17.947,5,riffle_clumpy
0,11,25,7,43,0.256,18,0.419,0,0,0,1,1,32,11,6,18,19,0.14,0.419,0.442,18.049,6,riffle_clumpy
0,23,17,3,43,0.535,26,0.605,4,0,1.0,1,1,24,19,14,15,14,0.326,0.349,0.326,18.091,7,riffle_clumpy
0,21,22,2,45,0.467,23,0.511,2,2,0.5,1,3,29,16,11,13,21,0.244,0.289,0.467,18.05,8,riffle_clumpy
0,20,20,2,42,0.476,22,0.524,1,1,0.5,3,1,28,14,11,11,20,0.262,0.262,0.476,17.996,9,riffle_clumpy
0,18,25,2,45,0.4,20,0.444,2,2,0.5,3,2,30,15,9,19,17,0.2,0.422,0.378,18.034,10,riffle_clumpy
0,26,15,6,47,0.553,32,0.681,9,1,0.9,3,2,29,18,13,13,21,0.277,0.277,0.447,17.981,11,riffle_clumpy
0,19,19,7,45,0.422,26,0.578,4,3,0.571,2,2,27,18,9,18,18,0.2,0.4,0.4,17.963,12,riffle_clumpy
0,24,19,5,48,0.5,29,0.604,2,2,0.5,4,2,30,18,11,15,22,0.229,0.312,0.458,17.966,13,riffle_clumpy
0,22,19,6,47,0.468,28,0.596,3,3,0.5,5,0,28,19,10,17,20,0.213,0.362,0.426,17.99,14,riffle_clumpy
0,21,19,5,45,0.467,26,0.578,3,0,1.0,1,2,26,19,11,13,21,0.244,0.289,0.467,17.933,15,riffle_clumpy
0,21,23,2,46,0.457,23,0.5,0,4,0.0,2,3,31,15,10,14,22,0.217,0.304,0.478,17.935,16,riffle_clumpy
0,17,28,4,49,0.347,21,0.429,0,1,0.0,2,4,30,19,11,13,25,0.224,0.265,0.51,17.912,17,riffle_clumpy
0,21,23,2,46,0.457,23,0.5,5,2,0.714,3,5,32,14,13,10,23,0.283,0.217,0.5,17.908,18,riffle_clumpy
0,24,20,2,46,0.522,26,0.565,3,2,0.6,3,2,28,18,12,16,18,0.261,0.348,0.391,17.92,19,riffle_clumpy
0,16,25,3,44,0.364,19,0.432,4,2,0.667,0,2,32,12,7,13,24,0.159,0.295,0.545,17.906,20,riffle_clumpy
0,16,27,3,46,0.348,19,0.413,3,2,0.6,1,2,33,13,8,15,23,0.174,0.326,0.5,17.904,21,riffle_clumpy
0,20,22,3,45,0.444,23,0.511,3,5,0.375,1,1,27,18,9,19,17,0.2,0.422,0.378,17.893,22,riffle_clumpy
0,20,22,3,45,0.444,23,0.511,4,2,0.667,4,1,24,21,8,20,17,0.178,0.444,0.378,17.875,23,riffle_clumpy
0,23,17,5,45,0.511,28,0.622,3,3,0.5,2,3,25,20,14,16,15,0.311,0.356,0.333,17.889,24,riffle_clumpy
0,20,19,4,43,0.465,24,0.558,5,0,1.0,1,1,26,17,14,14,15,0.326,0.326,0.349,17.87,25,riffle_clumpy
0,28,17,5,50,0.56,33,0.66,5,3,0.625,6,1,29,21,14,8,28,0.28,0.16,0.56,17.82,26,riffle_clumpy
0,19,18,8,45,0.422,27,0.6,5,1,0.833,1,3,28,17,11,13,21,0.244,0.289,0.467,17.835,27,riffle_clumpy
0,15,28,4,47,0.319,19,0.404,3,1,0.75,2,2,32,15,5,16,26,0.106,0.34,0.553,17.808,28,riffle_clumpy
0,17,24,5,46,0.37,22,0.478,2,1,0.667,4,4,26,20,8,12,26,0.174,0.261,0.565,17.767,29,riffle_clumpy
0,15,26,3,44,0.341,18,0.409,3,0,1.0,0,2,25,19,10,14,20,0.227,0.318,0.455,17.746,30,riffle_clumpy
0,25,17,2,44,0.568,27,0.614,4,1,0.8,1,2,33,11,12,11,21,0.273,0.25,0.477,17.749,31,riffle_clumpy
0,17,24,3,44,0.386,20,0.455,3,5,0.375,1,2,26,18,5,20,19,0.114,0.455,0.432,17.759,32,riffle_clumpy
0,11,33,1,45,0.244,12,0.267,1,0,1.0,0,3,28,17,8,15,22,0.178,0.333,0.489,17.767,33,riffle_clumpy
0,23,20,3,46,0.5,26,0.565,1,2,0.333,3,1,32,14,11,13,22,0.239,0.283,0.478,17.759,34,riffle_clumpy
0,19,22,5,46,0.413,24,0.522,1,2,0.333,3,1,25,21,8,19,19,0.174,0.413,0.413,17.738,35,riffle_clumpy
0,23,17,6,46,0.5,29,0.63,3,2,0.6,2,3,28,18,13,15,18,0.283,0.326,0.391,17.73,36,riffle_clumpy
0,22,20,3,45,0.489,25,0.556,4,4,0.5,2,1,28,17,11,10,24,0.244,0.222,0.533,17.707,37,riffle_clumpy
0,16,21,6,43,0.372,22,0.512,2,1,0.667,2,1,31,12,8,8,27,0.186,0.186,0.628,17.687,38,riffle_clumpy
0,24,18,4,46,0.522,28,0.609,3,4,0.429,1,2,29,17,9,16,21,0.196,0.348,0.457,17.697,39,riffle_clumpy
0,18,23,3,44,0.409,21,0.477,2,1,0.667,0,1,28,16,8,18,18,0.182,0.409,0.409,17.708,40,riffle_clumpy
0,19,21,3,43,0.442,22,0.512,2,1,0.667,0,2,19,24,17,13,13,0.395,0.302,0.302,17.718,41,riffle_clumpy
0,21,18,5,44,0.477,26,0.591,5,3,0.625,3,1,30,14,7,17,20,0.159,0.386,0.455,17.707,42,riffle_clumpy
0,19,19,8,46,0.413,27,0.587,2,1,0.667,2,1,36,10,8,12,26,0.174,0.261,0.565,17.711,43,riffle_clumpy
0,18,28,1,47,0.383,19,0.404,2,6,0.25,3,1,28,19,10,17,20,0.213,0.362,0.426,17.714,44,riffle_clumpy
0,13,28,5,46,0.283,18,0.391,1,3,0.25,2,6,30,16,8,18,20,0.174,0.391,0.435,17.728,45,riffle_clumpy
0,16,23,7,46,0.348,23,0.5,1,2,0.333,1,2,27,19,10,13,23,0.217,0.283,0.5,17.723,46,riffle_clumpy
0,25,18,2,45,0.556,27,0.6,6,2,0.75,2,0,22,23,14,14,17,0.311,0.311,0.378,17.726,47,riffle_clumpy
0,22,19,5,46,0.478,27,0.587,1,0,1.0,1,3,25,21,17,11,18,0.37,0.239,0.391,17.721,48,riffle_clumpy
0,23,17,5,45,0.511,28,0.622,3,5,0.375,4,1,27,18,12,18,15,0.267,0.4,0.333,17.729,49,riffle_clumpy
0,22,18,6,46,0.478,28,0.609,4,0,1.0,2,3,34,12,12,13,21,0.261,0.283,0.457,17.731,50,riffle_clumpy
0,22,21,5,48,0.458,27,0.562,1,1,0.5,2,3,31,17,12,14,22,0.25,0.292,0.458,17.728,51,riffle_clumpy
0,20,18,7,45,0.444,27,0.6,4,2,0.667,0,2,27,18,14,12,19,0.311,0.267,0.422,17.733,52,riffle_clumpy
0,14,26,5,45,0.311,19,0.422,1,2,0.333,1,4,29,16,9,13,23,0.2,0.289,0.511,17.726,53,riffle_clumpy
0,21,19,5,45,0.467,26,0.578,2,2,0.5,3,1,30,15,9,17,19,0.2,0.378,0.422,17.72,54,riffle_clumpy
0,26,13,6,45,0.578,32,0.711,2,1,0.667,3,1,30,15,13,10,22,0.289,0.222,0.489,17.716,55,riffle_clumpy
0,22,20,3,45,0.489,25,0.556,6,4,0.6,1,2,21,24,13,16,16,0.289,0.356,0.356,17.725,56,riffle_clumpy
0,16,27,2,45,0.356,18,0.4,1,1,0.5,0,1,27,18,9,16,20,0.2,0.356,0.444,17.722,57,riffle_clumpy
0,22,22,4,48,0.458,26,0.542,1,0,1.0,2,1,30,18,12,11,25,0.25,0.229,0.521,17.716,58,riffle_clumpy
0,21,17,7,45,0.467,28,0.622,3,1,0.75,2,2,29,16,12,10,23,0.267,0.222,0.511,17.712,59,riffle_clumpy
0,18,24,3,45,0.4,21,0.467,4,1,0.8,0,1,24,21,13,14,18,0.289,0.311,0.4,17.707,60,riffle_clumpy
0,21,21,2,44,0.477,23,0.523,2,0,1.0,2,1,24,20,13,13,18,0.295,0.295,0.409,17.712,61,riffle_clumpy
0,17,22,6,45,0.378,23,0.511,1,1,0.5,1,1,29,16,8,15,22,0.178,0.333,0.489,17.714,62,riffle_clumpy
0,20,20,5,45,0.444,25,0.556,2,1,0.667,1,1,30,15,9,14,22,0.2,0.311,0.489,17.718,63,riffle_clumpy
0,12,26,7,45,0.267,19,0.422,3,4,0.429,1,3,31,14,6,15,24,0.133,0.333,0.533,17.717,64,riffle_clumpy
0,27,16,2,45,0.6,29,0.644,3,0,1.0,2,2,31,14,10,14,21,0.222,0.311,0.467,17.721,65,riffle_clumpy
0,19,24,3,46,0.413,22,0.478,2,1,0.667,2,2,25,21,12,20,14,0.261,0.435,0.304,17.722,66,riffle_clumpy
0,22,20,3,45,0.489,25,0.556,7,0,1.0,2,1,28,17,15,9,21,0.333,0.2,0.467,17.716,67,riffle_clumpy
0,17,21,7,45,0.378,24,0.533,3,1,0.75,3,2,30,15,6,19,20,0.133,0.422,0.444,17.72,68,riffle_clumpy
0,23,21,0,44,0.523,23,0.523,5,4,0.556,3,2,24,20,12,10,22,0.273,0.227,0.5,17.725,69,riffle_clumpy
0,19,20,4,43,0.442,23,0.535,4,1,0.8,0,2,31,12,12,11,20,0.279,0.256,0.465,17.727,70,riffle_clumpy
0,13,25,5,43,0.302,18,0.419,4,2,0.667,2,3,26,17,8,12,23,0.186,0.279,0.535,17.735,71,riffle_clumpy
0,17,25,3,45,0.378,20,0.444,4,0,1.0,2,2,26,19,8,15,22,0.178,0.333,0.489,17.733,72,riffle_clumpy
0,20,19,5,44,0.455,25,0.568,2,0,1.0,1,2,30,14,10,15,19,0.227,0.341,0.432,17.745,73,riffle_clumpy
0,17,26,2,45,0.378,19,0.422,4,2,0.667,2,2,25,20,10,17,18,0.222,0.378,0.4,17.758,74,riffle_clumpy
0,28,16,1,45,0.622,29,0.644,1,1,0.5,1,1,32,13,14,7,24,0.311,0.156,0.533,17.756,75,riffle_clumpy
0,20,20,3,43,0.465,23,0.535,2,3,0.4,2,0,26,17,7,18,18,0.163,0.419,0.419,17.763,76,riffle_clumpy
0,21,20,3,44,0.477,24,0.545,3,4,0.429,1,0,28,16,9,15,20,0.205,0.341,0.455,17.762,77,riffle_clumpy
0,21,19,3,43,0.488,24,0.558,5,3,0.625,3,2,29,14,11,13,19,0.256,0.302,0.442,17.764,78,riffle_clumpy
0,20,20,3,43,0.465,23,0.535,2,1,0.667,1,3,24,19,13,12,18,0.302,0.279,0.419,17.756,79,riffle_clumpy
0,21,18,4,43,0.488,25,0.581,2,1,0.667,1,1,29,14,11,15,17,0.256,0.349,0.395,17.756,80,riffle_clumpy
0,16,24,4,44,0.364,20,0.455,0,3,0.0,1,2,27,17,10,18,16,0.227,0.409,0.364,17.76,81,riffle_clumpy
0,19,21,3,43,0.442,22,0.512,3,0,1.0,0,2,27,16,14,14,15,0.326,0.326,0.349,17.76,82,riffle_clumpy
0,17,21,4,42,0.405,21,0.5,0,3,0.0,1,1,33,9,11,15,16,0.262,0.357,0.381,17.763,83,riffle_clumpy
0,17,26,2,45,0.378,19,0.422,2,3,0.4,0,1,32,13,9,14,22,0.2,0.311,0.489,17.758,84,riffle_clumpy
0,21,25,2,48,0.438,23,0.479,0,4,0.0,1,1,26,22,10,21,17,0.208,0.438,0.354,17.758,85,riffle_clumpy
0,21,21,4,46,0.457,25,0.543,1,1,0.5,3,2,29,17,9,14,23,0.196,0.304,0.5,17.742,86,riffle_clumpy
0,14,28,4,46,0.304,18,0.391,3,4,0.429,1,3,31,15,8,16,22,0.174,0.348,0.478,17.75,87,riffle_clumpy
0,19,20,7,46,0.413,26,0.565,1,1,0.5,5,0,26,20,8,17,21,0.174,0.37,0.457,17.751,88,riffle_clumpy
0,20,24,2,46,0.435,22,0.478,3,3,0.5,3,5,31,15,9,14,23,0.196,0.304,0.5,17.754,89,riffle_clumpy
0,20,26,4,50,0.4,24,0.48,0,6,0.0,5,2,26,24,10,16,24,0.2,0.32,0.48,17.756,90,riffle_clumpy
0,23,23,2,48,0.479,25,0.521,5,0,1.0,1,5,21,27,9,23,16,0.188,0.479,0.333,17.762,91,riffle_clumpy
0,20,22,1,43,0.465,21,0.488,3,2,0.6,2,0,29,14,12,11,20,0.279,0.256,0.465,17.766,92,riffle_clumpy
0,19,22,8,49,0.388,27,0.551,3,3,0.5,4,3,35,14,9,14,26,0.184,0.286,0.531,17.766,93,riffle_clumpy
0,23,20,3,46,0.5,26,0.565,3,5,0.375,3,2,28,18,14,12,20,0.304,0.261,0.435,17.768,94,riffle_clumpy
0,15,27,4,46,0.326,19,0.413,2,2,0.5,2,3,29,17,8,15,23,0.174,0.326,0.5,17.765,95,riffle_clumpy
0,22,23,3,48,0.458,25,0.521,1,3,0.25,3,4,32,16,14,10,24,0.292,0.208,0.5,17.759,96,riffle_clumpy
0,17,23,5,45,0.378,22,0.489,3,4,0.429,1,0,26,19,11,15,19,0.244,0.333,0.422,17.759,1,riffle_clumpy
0,23,20,2,45,0.511,25,0.556,2,3,0.4,2,2,27,18,9,19,17,0.2,0.422,0.378,17.695,2,riffle_clumpy
0,24,21,5,50,0.48,29,0.58,5,1,0.833,0,2,28,22,15,21,14,0.3,0.42,0.28,17.977,3,riffle_clumpy
0,20,17,8,45,0.444,28,0.622,2,4,0.333,4,1,23,22,11,18,16,0.244,0.4,0.356,17.991,4,riffle_clumpy
0,23,19,4,46,0.5,27,0.587,2,3,0.4,2,4,26,20,14,14,18,0.304,0.304,0.391,17.896,5,riffle_clumpy
0,13,31,1,45,0.289,14,0.311,2,1,0.667,1,3,34,11,9,10,26,0.2,0.222,0.578,17.706,6,riffle_clumpy
0,21,22,4,47,0.447,25,0.532,2,0,1.0,1,2,30,17,9,19,19,0.191,0.404,0.404,17.845,7,riffle_clumpy
0,21,21,1,43,0.488,22,0.512,4,3,0.571,4,2,27,16,10,10,23,0.233,0.233,0.535,17.709,8,riffle_clumpy
0,15,28,3,46,0.326,18,0.391,1,3,0.25,0,2,29,17,11,17,18,0.239,0.37,0.391,17.809,9,riffle_clumpy
0,24,20,2,46,0.522,26,0.565,4,2,0.667,1,2,30,16,13,12,21,0.283,0.261,0.457,17.794,10,riffle_clumpy
0,25,17,7,49,0.51,32,0.653,5,3,0.625,2,1,34,15,13,14,22,0.265,0.286,0.449,17.763,11,riffle_clumpy
0,18,22,6,46,0.391,24,0.522,6,1,0.857,1,1,25,21,12,16,18,0.261,0.348,0.391,17.804,12,riffle_clumpy
0,20,24,1,45,0.444,21,0.467,1,2,0.333,2,3,27,18,9,15,21,0.2,0.333,0.467,17.692,13,riffle_clumpy
0,22,21,5,48,0.458,27,0.562,4,0,1.0,4,4,30,18,12,13,23,0.25,0.271,0.479,17.713,14,riffle_clumpy
0,19,24,3,46,0.413,22,0.478,2,3,0.4,2,5,28,18,13,9,24,0.283,0.196,0.522,17.732,15,riffle_clumpy
0,22,25,2,49,0.449,24,0.49,2,4,0.333,6,7,27,22,12,12,25,0.245,0.245,0.51,17.692,16,riffle_clumpy
0,21,19,3,43,0.488,24,0.558,3,2,0.6,2,3,24,19,14,13,16,0.326,0.302,0.372,17.692,17,riffle_clumpy
0,17,25,6,48,0.354,23,0.479,2,5,0.286,3,2,25,23,10,19,19,0.208,0.396,0.396,17.666,18,riffle_clumpy
0,22,17,5,44,0.5,27,0.614,5,3,0.625,1,1,23,21,10,18,16,0.227,0.409,0.364,17.669,19,riffle_clumpy
0,20,23,1,44,0.455,21,0.477,4,4,0.5,2,4,22,22,12,17,15,0.273,0.386,0.341,17.645,20,riffle_clumpy
0,16,25,2,43,0.372,18,0.419,0,1,0.0,1,2,30,13,9,15,19,0.209,0.349,0.442,17.637,21,riffle_clumpy
0,22,19,3,44,0.5,25,0.568,4,3,0.571,2,2,27,17,10,17,17,0.227,0.386,0.386,17.652,22,riffle_clumpy
0,22,18,5,45,0.489,27,0.6,3,2,0.6,4,0,27,18,9,14,22,0.2,0.311,0.489,17.645,23,riffle_clumpy
0,20,24,2,46,0.435,22,0.478,5,3,0.625,1,4,22,24,10,18,18,0.217,0.391,0.391,17.643,24,riffle_clumpy
0,19,20,7,46,0.413,26,0.565,4,2,0.667,3,1,27,19,5,18,23,0.109,0.391,0.5,17.665,25,riffle_clumpy
0,23,21,4,48,0.479,27,0.562,3,5,0.375,4,3,29,19,10,20,18,0.208,0.417,0.375,17.66,26,riffle_clumpy
0,23,19,3,45,0.511,26,0.578,4,3,0.571,2,2,25,20,13,15,17,0.289,0.333,0.378,17.667,27,riffle_clumpy
0,15,25,2,42,0.357,17,0.405,6,2,0.75,0,0,29,13,6,14,22,0.143,0.333,0.524,17.676,28,riffle_clumpy
0,25,19,0,44,0.568,25,0.568,2,2,0.5,2,1,25,19,14,13,17,0.318,0.295,0.386,17.676,29,riffle_clumpy
0,19,23,2,44,0.432,21,0.477,3,4,0.429,1,3,26,18,11,12,21,0.25,0.273,0.477,17.685,30,riffle_clumpy
0,19,25,3,47,0.404,22,0.468,5,0,1.0,2,2,33,14,7,18,22,0.149,0.383,0.468,17.695,31,riffle_clumpy
0,20,23,2,45,0.444,22,0.489,7,3,0.7,1,1,29,16,9,12,24,0.2,0.267,0.533,17.684,32,riffle_clumpy
0,19,24,2,45,0.422,21,0.467,3,1,0.75,3,2,26,19,8,19,18,0.178,0.422,0.4,17.676,33,riffle_clumpy
0,23,19,4,46,0.5,27,0.587,5,2,0.714,1,3,28,18,14,14,18,0.304,0.304,0.391,17.698,34,riffle_clumpy
0,19,21,3,43,0.442,22,0.512,2,4,0.333,0,1,26,17,15,14,14,0.349,0.326,0.326,17.696,35,riffle_clumpy
0,21,23,1,45,0.467,22,0.489,4,2,0.667,0,1,23,22,12,21,12,0.267,0.467,0.267,17.706,36,riffle_clumpy
0,24,18,5,47,0.511,29,0.617,3,3,0.5,6,3,24,23,12,17,18,0.255,0.362,0.383,17.674,37,riffle_clumpy
0,21,19,3,43,0.488,24,0.558,2,4,0.333,1,1,25,18,13,12,18,0.302,0.279,0.419,17.653,38,riffle_clumpy
0,20,20,4,44,0.455,24,0.545,5,4,0.556,1,1,28,16,12,11,21,0.273,0.25,0.477,17.655,39,riffle_clumpy
0,18,23,5,46,0.391,23,0.5,2,0,1.0,4,0,29,17,10,14,22,0.217,0.304,0.478,17.646,40,riffle_clumpy
0,20,20,7,47,0.426,27,0.574,4,2,0.667,3,4,32,15,10,17,20,0.213,0.362,0.426,17.641,41,riffle_clumpy
0,18,26,2,46,0.391,20,0.435,1,1,0.5,1,0,34,12,10,11,25,0.217,0.239,0.543,17.635,42,riffle_clumpy
0,20,20,5,45,0.444,25,0.556,2,2,0.5,1,1,27,18,12,15,18,0.267,0.333,0.4,17.658,43,riffle_clumpy
0,19,20,4,43,0.442,23,0.535,3,0,1.0,2,0,26,17,12,16,15,0.279,0.372,0.349,17.666,44,riffle_clumpy
0,14,29,4,47,0.298,18,0.383,2,2,0.5,2,3,31,16,6,20,21,0.128,0.426,0.447,17.667,45,riffle_clumpy
0,20,24,3,47,0.426,23,0.489,1,3,0.25,3,3,24,23,7,20,20,0.149,0.426,0.426,17.645,46,riffle_clumpy
0,22,21,2,45,0.489,24,0.533,3,2,0.6,2,3,28,17,12,9,24,0.267,0.2,0.533,17.635,47,riffle_clumpy
0,23,19,3,45,0.511,26,0.578,3,0,1.0,1,1,31,14,14,13,18,0.311,0.289,0.4,17.639,48,riffle_clumpy
0,23,18,4,45,0.511,27,0.6,0,1,0.0,4,0,26,19,14,13,18,0.311,0.289,0.4,17.637,49,riffle_clumpy
0,21,22,3,46,0.457,24,0.522,2,5,0.286,3,4,31,15,9,15,22,0.196,0.326,0.478,17.621,50,riffle_clumpy
0,18,24,2,44,0.409,20,0.455,2,4,0.333,2,3,31,13,12,11,21,0.273,0.25,0.477,17.62,51,riffle_clumpy
0,18,23,2,43,0.419,20,0.465,5,2,0.714,2,2,26,17,9,14,20,0.209,0.326,0.465,17.634,52,riffle_clumpy
0,23,19,3,45,0.511,26,0.578,2,1,0.667,3,2,30,15,13,11,21,0.289,0.244,0.467,17.633,53,riffle_clumpy
0,18,22,3,43,0.419,21,0.488,1,3,0.25,2,1,29,14,10,14,19,0.233,0.326,0.442,17.637,54,riffle_clumpy
0,26,18,0,44,0.591,26,0.591,3,2,0.6,1,1,23,21,9,21,14,0.205,0.477,0.318,17.641,55,riffle_clumpy
0,26,20,3,49,0.531,29,0.592,3,2,0.6,2,1,28,21,13,17,19,0.265,0.347,0.388,17.642,56,riffle_clumpy
0,30,15,1,46,0.652,31,0.674,5,0,1.0,6,0,26,20,13,10,23,0.283,0.217,0.5,17.626,57,riffle_clumpy
0,19,23,4,46,0.413,23,0.5,2,0,1.0,1,1,29,17,12,11,23,0.261,0.239,0.5,17.627,58,riffle_clumpy
0,15,29,5,49,0.306,20,0.408,1,2,0.333,0,4,29,20,8,16,25,0.163,0.327,0.51,17.628,59,riffle_clumpy
0,12,30,4,46,0.261,16,0.348,0,3,0.0,1,1,29,17,7,14,25,0.152,0.304,0.543,17.63,60,riffle_clumpy
0,21,21,4,46,0.457,25,0.543,1,5,0.167,4,2,25,21,11,13,22,0.239,0.283,0.478,17.624,61,riffle_clumpy
0,22,19,6,47,0.468,28,0.596,4,1,0.8,2,0,29,18,11,18,18,0.234,0.383,0.383,17.629,62,riffle_clumpy
0,16,25,4,45,0.356,20,0.444,2,1,0.667,2,3,34,11,10,10,25,0.222,0.222,0.556,17.633,63,riffle_clumpy
0,20,23,2,45,0.444,22,0.489,2,2,0.5,3,3,32,13,9,16,20,0.2,0.356,0.444,17.629,64,riffle_clumpy
0,25,17,3,45,0.556,28,0.622,5,2,0.714,2,3,25,20,13,13,19,0.289,0.289,0.422,17.632,65,riffle_clumpy
0,16,25,2,43,0.372,18,0.419,2,5,0.286,1,3,31,12,8,12,23,0.186,0.279,0.535,17.628,66,riffle_clumpy
0,19,20,6,45,0.422,25,0.556,0,2,0.0,1,2,32,13,8,11,26,0.178,0.244,0.578,17.622,67,riffle_clumpy
0,19,21,4,44,0.432,23,0.523,3,2,0.6,3,0,26,18,9,16,19,0.205,0.364,0.432,17.621,68,riffle_clumpy
0,22,23,2,47,0.468,24,0.511,0,2,0.0,3,3,31,16,10,14,23,0.213,0.298,0.489,17.624,69,riffle_clumpy
0,25,19,2,46,0.543,27,0.587,3,2,0.6,1,1,26,20,15,9,22,0.326,0.196,0.478,17.619,70,riffle_clumpy
0,18,21,8,47,0.383,26,0.553,2,4,0.333,2,1,30,17,5,21,21,0.106,0.447,0.447,17.623,71,riffle_clumpy
0,22,20,4,46,0.478,26,0.565,2,1,0.667,3,1,26,20,9,21,16,0.196,0.457,0.348,17.629,72,riffle_clumpy
0,22,16,5,43,0.512,27,0.628,5,2,0.714,0,1,22,21,13,17,13,0.302,0.395,0.302,17.639,73,riffle_clumpy
0,17,24,3,44,0.386,20,0.455,4,0,1.0,1,2,25,19,9,17,18,0.205,0.386,0.409,17.634,74,riffle_clumpy
0,20,25,3,48,0.417,23,0.479,6,5,0.545,1,1,29,19,9,18,21,0.188,0.375,0.438,17.637,75,riffle_clumpy
0,16,26,2,44,0.364,18,0.409,2,2,0.5,2,3,25,19,8,17,19,0.182,0.386,0.432,17.639,76,riffle_clumpy
0,25,18,1,44,0.568,26,0.591,7,2,0.778,6,0,24,20,13,14,17,0.295,0.318,0.386,17.628,77,riffle_clumpy
0,24,20,3,47,0.511,27,0.574,4,3,0.571,5,1,32,15,11,11,25,0.234,0.234,0.532,17.61,78,riffle_clumpy
0,17,23,6,46,0.37,23,0.5,5,4,0.556,2,3,32,14,10,12,24,0.217,0.261,0.522,17.608,79,riffle_clumpy
0,16,26,2,44,0.364,18,0.409,3,0,1.0,3,3,29,15,9,12,23,0.205,0.273,0.523,17.604,80,riffle_clumpy
0,14,25,10,49,0.286,24,0.49,0,2,0.0,2,1,32,17,6,21,22,0.122,0.429,0.449,17.607,81,riffle_clumpy
0,21,19,7,47,0.447,28,0.596,0,1,0.0,3,1,26,21,12,14,21,0.255,0.298,0.447,17.606,82,riffle_clumpy
0,18,22,3,43,0.419,21,0.488,5,3,0.625,2,1,25,18,8,19,16,0.186,0.442,0.372,17.613,83,riffle_clumpy
0,19,24,5,48,0.396,24,0.5,2,2,0.5,0,3,30,18,11,14,23,0.229,0.292,0.479,17.615,84,riffle_clumpy
0,16,21,7,44,0.364,23,0.523,4,2,0.667,0,2,25,19,10,17,17,0.227,0.386,0.386,17.621,85,riffle_clumpy
0,21,21,4,46,0.457,25,0.543,7,1,0.875,2,2,29,17,13,12,21,0.283,0.261,0.457,17.626,86,riffle_clumpy
0,25,16,5,46,0.543,30,0.652,2,0,1.0,1,4,26,20,17,12,17,0.37,0.261,0.37,17.622,87,riffle_clumpy
0,19,21,6,46,0.413,25,0.543,4,1,0.8,2,2,30,16,10,12,24,0.217,0.261,0.522,17.617,88,riffle_clumpy
0,14,23,6,43,0.326,20,0.465,3,3,0.5,0,0,27,16,10,18,15,0.233,0.419,0.349,17.628,89,riffle_clumpy
0,20,22,5,47,0.426,25,0.532,3,3,0.5,3,0,27,20,12,12,23,0.255,0.255,0.489,17.629,90,riffle_clumpy
0,22,20,2,44,0.5,24,0.545,4,3,0.571,3,1,25,19,8,18,18,0.182,0.409,0.409,17.634,91,riffle_clumpy
0,18,24,3,45,0.4,21,0.467,2,1,0.667,0,0,24,21,9,22,14,0.2,0.489,0.311,17.641,92,riffle_clumpy
0,25,21,3,49,0.51,28,0.571,3,4,0.429,1,3,30,19,14,11,24,0.286,0.224,0.49,17.645,93,riffle_clumpy
0,19,18,7,44,0.432,26,0.591,1,1,0.5,1,2,23,21,13,16,15,0.295,0.364,0.341,17.646,94,riffle_clumpy
0,24,18,2,44,0.545,26,0.591,4,0,1.0,3,3,26,18,14,9,21,0.318,0.205,0.477,17.643,95,riffle_clumpy
0,21,21,3,45,0.467,24,0.533,2,2,0.5,4,3,25,20,12,12,21,0.267,0.267,0.467,17.636,96,riffle_clumpy
0,24,17,3,44,0.545,27,0.614,4,3,0.571,3,4,29,15,13,15,16,0.295,0.341,0.364,18.56,1,riffle_clumpy
0,18,24,4,46,0.391,22,0.478,3,3,0.5,1,4,30,16,10,14,22,0.217,0.304,0.478,18.308,2,riffle_clumpy
0,25,19,7,51,0.49,32,0.627,4,1,0.8,3,2,28,23,12,12,27,0.235,0.235,0.529,17.694,3,riffle_clumpy
0,15,27,3,45,0.333,18,0.4,0,2,0.0,2,1,28,17,10,15,20,0.222,0.333,0.444,17.626,4,riffle_clumpy
0,21,19,6,46,0.457,27,0.587,5,4,0.556,3,2,27,19,14,12,20,0.304,0.261,0.435,17.528,5,riffle_clumpy
0,14,23,7,44,0.318,21,0.477,2,2,0.5,1,3,31,13,5,17,22,0.114,0.386,0.5,17.549,6,riffle_clumpy
0,19,21,3,43,0.442,22,0.512,4,1,0.8,0,1,26,17,8,14,21,0.186,0.326,0.488,17.589,7,riffle_clumpy
0,21,25,2,48,0.438,23,0.479,1,1,0.5,4,3,27,21,12,14,22,0.25,0.292,0.458,17.545,8,riffle_clumpy
0,19,18,7,44,0.432,26,0.591,4,1,0.8,4,4,27,17,13,13,18,0.295,0.295,0.409,17.525,9,riffle_clumpy
0,20,25,2,47,0.426,22,0.468,4,2,0.667,3,1,29,18,14,11,22,0.298,0.234,0.468,17.509,10,riffle_clumpy
0,16,27,2,45,0.356,18,0.4,3,1,0.75,3,2,25,20,12,13,20,0.267,0.289,0.444,17.521,11,riffle_clumpy
0,20,21,4,45,0.444,24,0.533,1,1,0.5,3,4,27,18,13,13,19,0.289,0.289,0.422,17.481,12,riffle_clumpy
0,17,21,10,48,0.354,27,0.562,2,2,0.5,1,3,33,15,11,20,17,0.229,0.417,0.354,17.511,13,riffle_clumpy
0,15,25,4,44,0.341,19,0.432,2,2,0.5,2,4,28,16,6,17,21,0.136,0.386,0.477,17.486,14,riffle_clumpy
0,21,24,2,47,0.447,23,0.489,5,0,1.0,3,3,27,20,12,12,23,0.255,0.255,0.489,17.481,15,riffle_clumpy
0,17,23,4,44,0.386,21,0.477,0,1,0.0,1,2,30,14,9,17,18,0.205,0.386,0.409,17.478,16,riffle_clumpy
0,23,14,7,44,0.523,30,0.682,5,0,1.0,3,1,28,16,16,13,15,0.364,0.295,0.341,17.501,17,riffle_clumpy
0,15,28,5,48,0.312,20,0.417,3,3,0.5,1,2,32,16,8,13,27,0.167,0.271,0.562,17.49,18,riffle_clumpy
0,17,23,5,45,0.378,22,0.489,3,0,1.0,0,4,27,18,9,18,18,0.2,0.4,0.4,17.52,19,riffle_clumpy
0,17,27,1,45,0.378,18,0.4,1,2,0.333,0,2,21,24,15,16,14,0.333,0.356,0.311,17.535,20,riffle_clumpy
0,14,30,2,46,0.304,16,0.348,2,3,0.4,0,3,27,19,8,16,22,0.174,0.348,0.478,17.581,21,riffle_clumpy
0,22,18,5,45,0.489,27,0.6,1,4,0.2,3,3,28,17,10,18,17,0.222,0.4,0.378,17.606,22,riffle_clumpy
0,20,24,2,46,0.435,22,0.478,1,2,0.333,6,1,33,13,11,11,24,0.239,0.239,0.522,17.576,23,riffle_clumpy
0,24,20,3,47,0.511,27,0.574,2,0,1.0,3,3,26,21,10,17,20,0.213,0.362,0.426,17.584,24,riffle_clumpy
0,15,27,2,44,0.341,17,0.386,1,1,0.5,2,2,33,11,4,15,25,0.091,0.341,0.568,17.596,25,riffle_clumpy
0,21,18,6,45,0.467,27,0.6,3,3,0.5,1,4,25,20,11,18,16,0.244,0.4,0.356,17.609,26,riffle_clumpy
0,16,22,6,44,0.364,22,0.5,3,1,0.75,1,3,29,15,9,14,21,0.205,0.318,0.477,17.629,27,riffle_clumpy
0,21,18,5,44,0.477,26,0.591,2,4,0.333,1,2,26,18,13,13,18,0.295,0.295,0.409,17.645,28,riffle_clumpy
0,24,17,4,45,0.533,28,0.622,2,0,1.0,3,2,21,24,14,15,16,0.311,0.333,0.356,17.641,29,riffle_clumpy
0,21,19,7,47,0.447,28,0.596,7,2,0.778,2,1,27,20,10,20,17,0.213,0.426,0.362,17.667,30,riffle_clumpy
0,24,20,3,47,0.511,27,0.574,5,3,0.625,2,4,22,25,15,11,21,0.319,0.234,0.447,17.664,31,riffle_clumpy
0,14,25,6,45,0.311,20,0.444,1,2,0.333,0,2,31,14,9,18,18,0.2,0.4,0.4,17.68,32,riffle_clumpy
0,19,20,5,44,0.432,24,0.545,3,0,1.0,3,1,30,14,11,13,20,0.25,0.295,0.455,17.689,33,riffle_clumpy
0,21,20,7,48,0.438,28,0.583,5,2,0.714,2,2,29,19,11,18,19,0.229,0.375,0.396,17.708,34,riffle_clumpy
0,20,22,5,47,0.426,25,0.532,2,2,0.5,3,2,30,17,8,18,21,0.17,0.383,0.447,17.718,35,riffle_clumpy
0,20,21,4,45,0.444,24,0.533,5,3,0.625,1,2,28,17,10,16,19,0.222,0.356,0.422,17.718,36,riffle_clumpy
0,23,20,3,46,0.5,26,0.565,2,1,0.667,3,2,32,14,9,12,25,0.196,0.261,0.543,17.713,37,riffle_clumpy
0,15,28,2,45,0.333,17,0.378,1,7,0.125,5,0,21,24,9,19,17,0.2,0.422,0.378,17.722,38,riffle_clumpy
0,20,19,6,45,0.444,26,0.578,4,3,0.571,0,1,26,19,11,15,19,0.244,0.333,0.422,17.719,39,riffle_clumpy
0,20,23,3,46,0.435,23,0.5,8,1,0.889,3,3,23,23,11,17,18,0.239,0.37,0.391,17.707,40,riffle_clumpy
0,17,22,5,44,0.386,22,0.5,2,2,0.5,2,1,24,20,13,14,17,0.295,0.318,0.386,17.702,41,riffle_clumpy
0,23,17,6,46,0.5,29,0.63,1,1,0.5,5,1,21,25,10,16,20,0.217,0.348,0.435,17.683,42,riffle_clumpy
0,16,28,2,46,0.348,18,0.391,4,3,0.571,1,4,28,18,13,12,21,0.283,0.261,0.457,17.696,43,riffle_clumpy
0,14,27,4,45,0.311,18,0.4,3,2,0.6,1,4,31,14,6,18,21,0.133,0.4,0.467,17.712,44,riffle_clumpy
0,21,21,3,45,0.467,24,0.533,5,2,0.714,2,1,26,19,12,14,19,0.267,0.311,0.422,17.687,45,riffle_clumpy
0,17,18,9,44,0.386,26,0.591,3,5,0.375,1,2,34,10,8,10,26,0.182,0.227,0.591,17.701,46,riffle_clumpy
0,23,22,2,47,0.489,25,0.532,5,2,0.714,1,0,27,20,12,15,20,0.255,0.319,0.426,17.703,47,riffle_clumpy
0,25,19,2,46,0.543,27,0.587,5,3,0.625,2,2,27,19,10,20,16,0.217,0.435,0.348,17.707,48,riffle_clumpy
0,16,20,8,44,0.364,24,0.545,2,2,0.5,2,1,31,13,10,11,23,0.227,0.25,0.523,17.703,49,riffle_clumpy
0,23,21,3,47,0.489,26,0.553,1,1,0.5,1,1,26,21,12,15,20,0.255,0.319,0.426,17.708,50,riffle_clumpy
0,25,17,2,44,0.568,27,0.614,4,1,0.8,3,0,24,20,12,12,20,0.273,0.273,0.455,17.71,51,riffle_clumpy
0,21,22,5,48,0.438,26,0.542,3,7,0.3,0,2,29,19,10,13,25,0.208,0.271,0.521,17.709,52,riffle_clumpy
0,24,20,2,46,0.522,26,0.565,4,1,0.8,5,3,29,17,13,12,21,0.283,0.261,0.457,17.704,53,riffle_clumpy
0,25,18,1,44,0.568,26,0.591,4,1,0.8,4,1,21,23,17,13,14,0.386,0.295,0.318,17.706,54,riffle_clumpy
0,14,27,2,43,0.326,16,0.372,3,2,0.6,1,3,29,14,10,9,24,0.233,0.209,0.558,17.707,55,riffle_clumpy
0,16,22,7,45,0.356,23,0.511,4,2,0.667,2,2,26,19,8,19,18,0.178,0.422,0.4,17.694,56,riffle_clumpy
0,19,25,2,46,0.413,21,0.457,6,5,0.545,0,1,28,18,10,16,20,0.217,0.348,0.435,17.7,57,riffle_clumpy
0,21,16,9,46,0.457,30,0.652,2,1,0.667,2,0,26,20,10,14,22,0.217,0.304,0.478,17.699,58,riffle_clumpy
0,24,20,2,46,0.522,26,0.565,5,2,0.714,4,1,24,22,14,11,21,0.304,0.239,0.457,17.681,59,riffle_clumpy
0,10,33,2,45,0.222,12,0.267,2,0,1.0,0,6,30,15,7,15,23,0.156,0.333,0.511,17.687,60,riffle_clumpy
0,22,18,5,45,0.489,27,0.6,6,2,0.75,2,2,24,21,12,14,19,0.267,0.311,0.422,17.683,61,riffle_clumpy
0,21,24,3,48,0.438,24,0.5,3,1,0.75,3,4,30,18,14,14,20,0.292,0.292,0.417,17.683,62,riffle_clumpy
0,24,19,4,47,0.511,28,0.596,4,2,0.667,4,1,21,26,13,16,18,0.277,0.34,0.383,17.674,63,riffle_clumpy
0,24,20,1,45,0.533,25,0.556,6,4,0.6,1,2,33,12,10,12,23,0.222,0.267,0.511,17.673,64,riffle_clumpy
0,20,24,2,46,0.435,22,0.478,2,2,0.5,5,3,34,12,9,12,25,0.196,0.261,0.543,17.674,65,riffle_clumpy
0,26,14,6,46,0.565,32,0.696,4,1,0.8,2,2,27,19,19,6,21,0.413,0.13,0.457,17.663,66,riffle_clumpy
0,16,28,2,46,0.348,18,0.391,4,1,0.8,0,1,28,18,10,16,20,0.217,0.348,0.435,17.655,67,riffle_clumpy
0,21,20,3,44,0.477,24,0.545,4,1,0.8,2,0,32,12,11,14,19,0.25,0.318,0.432,17.654,68,riffle_clumpy
0,15,25,5,45,0.333,20,0.444,4,1,0.8,1,1,28,17,10,14,21,0.222,0.311,0.467,17.655,69,riffle_clumpy
0,23,14,6,43,0.535,29,0.674,3,0,1.0,1,1,26,17,13,14,16,0.302,0.326,0.372,17.656,70,riffle_clumpy
0,20,23,3,46,0.435,23,0.5,5,2,0.714,2,1,27,19,14,11,21,0.304,0.239,0.457,17.652,71,riffle_clumpy
0,18,21,6,45,0.4,24,0.533,2,0,1.0,5,2,30,15,10,12,23,0.222,0.267,0.511,17.645,72,riffle_clumpy
0,22,20,3,45,0.489,25,0.556,3,2,0.6,3,1,23,22,16,13,16,0.356,0.289,0.356,17.654,73,riffle_clumpy
0,15,23,5,43,0.349,20,0.465,2,4,0.333,2,2,26,17,7,20,16,0.163,0.465,0.372,17.662,74,riffle_clumpy
0,20,23,2,45,0.444,22,0.489,3,4,0.429,1,2,25,20,14,13,18,0.311,0.289,0.4,17.656,75,riffle_clumpy
0,21,21,3,45,0.467,24,0.533,5,6,0.455,1,3,29,16,16,12,17,0.356,0.267,0.378,17.658,76,riffle_clumpy
0,17,21,7,45,0.378,24,0.533,3,3,0.5,3,2,27,18,7,18,20,0.156,0.4,0.444,17.657,77,riffle_clumpy
0,19,20,5,44,0.432,24,0.545,1,2,0.333,2,0,31,13,12,13,19,0.273,0.295,0.432,17.653,78,riffle_clumpy
0,22,18,4,44,0.5,26,0.591,2,2,0.5,3,3,28,16,14,14,16,0.318,0.318,0.364,17.649,79,riffle_clumpy
0,21,17,5,43,0.488,26,0.605,2,0,1.0,2,2,24,19,13,19,11,0.302,0.442,0.256,17.653,80,riffle_clumpy
0,19,21,7,47,0.404,26,0.553,1,2,0.333,3,1,30,17,11,12,24,0.234,0.255,0.511,17.658,81,riffle_clumpy
0,22,20,2,44,0.5,24,0.545,2,3,0.4,3,0,25,19,15,12,17,0.341,0.273,0.386,17.652,82,riffle_clumpy
0,24,16,8,48,0.5,32,0.667,3,2,0.6,2,2,23,25,8,20,20,0.167,0.417,0.417,17.648,83,riffle_clumpy
0,23,22,3,48,0.479,26,0.542,2,6,0.25,5,0,20,28,10,19,19,0.208,0.396,0.396,17.645,84,riffle_clumpy
0,20,20,5,45,0.444,25,0.556,5,2,0.714,0,2,29,16,10,16,19,0.222,0.356,0.422,17.652,85,riffle_clumpy
0,20,23,5,48,0.417,25,0.521,6,1,0.857,4,1,26,22,10,17,21,0.208,0.354,0.438,17.653,86,riffle_clumpy
0,21,21,5,47,0.447,26,0.553,3,2,0.6,4,4,31,16,6,16,25,0.128,0.34,0.532,17.647,87,riffle_clumpy
0,23,16,5,44,0.523,28,0.636,0,0,0,3,0,26,18,13,11,20,0.295,0.25,0.455,17.645,88,riffle_clumpy
0,20,22,5,47,0.426,25,0.532,0,0,0,5,4,27,20,9,15,23,0.191,0.319,0.489,17.644,89,riffle_clumpy
0,18,22,6,46,0.391,24,0.522,4,3,0.571,1,5,31,15,9,13,24,0.196,0.283,0.522,17.655,90,riffle_clumpy
0,22,20,4,46,0.478,26,0.565,3,2,0.6,0,1,36,10,9,15,22,0.196,0.326,0.478,17.658,91,riffle_clumpy
0,20,22,4,46,0.435,24,0.522,2,3,0.4,5,2,24,22,9,18,19,0.196,0.391,0.413,17.653,92,riffle_clumpy
0,14,24,4,42,0.333,18,0.429,1,1,0.5,0,2,30,12,7,16,19,0.167,0.381,0.452,17.659,93,riffle_clumpy
0,22,19,5,46,0.478,27,0.587,1,2,0.333,2,1,28,18,11,17,18,0.239,0.37,0.391,17.659,94,riffle_clumpy
0,22,23,2,47,0.468,24,0.511,1,3,0.25,2,3,26,21,13,16,18,0.277,0.34,0.383,17.659,95,riffle_clumpy
0,23,18,5,46,0.5,28,0.609,2,1,0.667,1,3,28,18,15,12,19,0.326,0.261,0.413,17.662,96,riffle_clumpy
0,16,23,5,44,0.364,21,0.477,1,3,0.25,1,3,27,17,9,17,18,0.205,0.386,0.409,18.034,1,riffle_clumpy
0,21,22,4,47,0.447,25,0.532,6,2,0.75,1,5,26,21,12,14,21,0.255,0.298,0.447,17.607,2,riffle_clumpy
0,17,24,4,45,0.378,21,0.467,5,0,1.0,2,1,24,21,11,18,16,0.244,0.4,0.356,17.64,3,riffle_clumpy
0,19,22,3,44,0.432,22,0.5,5,1,0.833,1,0,23,21,10,12,22,0.227,0.273,0.5,17.568,4,riffle_clumpy
0,19,21,6,46,0.413,25,0.543,1,3,0.25,0,1,23,23,14,19,13,0.304,0.413,0.283,17.575,5,riffle_clumpy
0,17,20,8,45,0.378,25,0.556,4,1,0.8,1,0,22,23,10,19,16,0.222,0.422,0.356,17.621,6,riffle_clumpy
0,18,21,5,44,0.409,23,0.523,6,2,0.75,1,3,31,13,12,12,20,0.273,0.273,0.455,17.737,7,riffle_clumpy
0,22,20,4,46,0.478,26,0.565,4,0,1.0,4,6,30,16,9,13,24,0.196,0.283,0.522,17.605,8,riffle_clumpy
0,15,27,3,45,0.333,18,0.4,2,1,0.667,2,5,29,16,7,17,21,0.156,0.378,0.467,17.632,9,riffle_clumpy
0,20,23,3,46,0.435,23,0.5,1,2,0.333,4,3,28,18,9,16,21,0.196,0.348,0.457,17.679,10,riffle_clumpy
0,24,19,4,47,0.511,28,0.596,3,0,1.0,0,1,26,21,14,16,17,0.298,0.34,0.362,17.722,11,riffle_clumpy
0,16,22,5,43,0.372,21,0.488,3,2,0.6,1,2,27,16,10,12,21,0.233,0.279,0.488,17.723,12,riffle_clumpy
0,21,19,7,47,0.447,28,0.596,3,1,0.75,1,3,25,22,8,21,18,0.17,0.447,0.383,17.73,13,riffle_clumpy
0,17,28,4,49,0.347,21,0.429,3,5,0.375,3,2,30,19,7,19,23,0.143,0.388,0.469,17.701,14,riffle_clumpy
0,20,20,5,45,0.444,25,0.556,2,2,0.5,4,3,26,19,9,16,20,0.2,0.356,0.444,17.686,15,riffle_clumpy
0,14,25,6,45,0.311,20,0.444,1,2,0.333,1,2,25,20,10,16,19,0.222,0.356,0.422,17.683,16,riffle_clumpy
0,16,25,5,46,0.348,21,0.457,1,2,0.333,2,1,25,21,10,17,19,0.217,0.37,0.413,17.702,17,riffle_clumpy
0,24,19,4,47,0.511,28,0.596,2,2,0.5,3,1,26,21,13,17,17,0.277,0.362,0.362,17.738,18,riffle_clumpy
0,14,25,6,45,0.311,20,0.444,2,0,1.0,2,4,30,15,6,14,25,0.133,0.311,0.556,17.737,19,riffle_clumpy
0,22,21,3,46,0.478,25,0.543,2,1,0.667,5,1,27,19,10,12,24,0.217,0.261,0.522,17.717,20,riffle_clumpy
0,16,24,7,47,0.34,23,0.489,0,3,0.0,2,3,30,17,7,16,24,0.149,0.34,0.511,17.727,21,riffle_clumpy
0,22,22,2,46,0.478,24,0.522,2,2,0.5,2,3,33,13,11,11,24,0.239,0.239,0.522,17.714,22,riffle_clumpy
0,20,22,4,46,0.435,24,0.522,4,3,0.571,3,2,31,15,9,14,23,0.196,0.304,0.5,17.706,23,riffle_clumpy
0,20,21,4,45,0.444,24,0.533,3,1,0.75,3,0,29,16,8,11,26,0.178,0.244,0.578,17.676,24,riffle_clumpy
0,15,27,5,47,0.319,20,0.426,1,1,0.5,1,3,21,26,10,20,17,0.213,0.426,0.362,17.683,25,riffle_clumpy
0,20,24,2,46,0.435,22,0.478,7,2,0.778,0,3,29,17,12,16,18,0.261,0.348,0.391,17.681,26,riffle_clumpy
0,21,23,2,46,0.457,23,0.5,1,3,0.25,1,4,27,19,16,13,17,0.348,0.283,0.37,17.678,27,riffle_clumpy
0,19,24,3,46,0.413,22,0.478,5,4,0.556,3,2,28,18,9,13,24,0.196,0.283,0.522,17.667,28,riffle_clumpy
0,17,19,7,43,0.395,24,0.558,5,1,0.833,2,2,27,16,13,10,20,0.302,0.233,0.465,17.644,29,riffle_clumpy
0,17,28,2,47,0.362,19,0.404,2,1,0.667,1,2,28,19,10,19,18,0.213,0.404,0.383,17.644,30,riffle_clumpy
0,26,17,3,46,0.565,29,0.63,1,3,0.25,3,0,25,21,13,13,20,0.283,0.283,0.435,17.638,31,riffle_clumpy
0,15,26,4,45,0.333,19,0.422,5,3,0.625,3,2,28,17,9,17,19,0.2,0.378,0.422,17.637,32,riffle_clumpy
0,16,27,3,46,0.348,19,0.413,0,0,0,1,4,27,19,11,11,24,0.239,0.239,0.522,17.644,33,riffle_clumpy
0,14,24,6,44,0.318,20,0.455,1,1,0.5,1,0,28,16,8,16,20,0.182,0.364,0.455,17.643,34,riffle_clumpy
0,24,18,3,45,0.533,27,0.6,4,4,0.5,1,0,28,17,10,17,18,0.222,0.378,0.4,17.65,35,riffle_clumpy
0,16,20,8,44,0.364,24,0.545,2,1,0.667,1,1,28,16,8,14,22,0.182,0.318,0.5,17.654,36,riffle_clumpy
0,19,23,4,46,0.413,23,0.5,1,4,0.2,3,0,24,22,11,17,18,0.239,0.37,0.391,17.633,37,riffle_clumpy
0,15,30,3,48,0.312,18,0.375,3,8,0.273,2,4,30,18,8,20,20,0.167,0.417,0.417,17.624,38,riffle_clumpy
0,19,22,3,44,0.432,22,0.5,2,1,0.667,2,3,28,16,9,11,24,0.205,0.25,0.545,17.625,39,riffle_clumpy
0,21,17,7,45,0.467,28,0.622,3,2,0.6,1,4,28,17,10,15,20,0.222,0.333,0.444,17.629,40,riffle_clumpy
0,22,20,7,49,0.449,29,0.592,3,0,1.0,2,1,33,16,15,8,26,0.306,0.163,0.531,17.623,41,riffle_clumpy
0,21,21,2,44,0.477,23,0.523,4,4,0.5,2,2,31,13,7,15,22,0.159,0.341,0.5,17.629,42,riffle_clumpy
0,16,28,3,47,0.34,19,0.404,4,1,0.8,2,5,31,16,12,11,24,0.255,0.234,0.511,17.602,43,riffle_clumpy
0,20,22,2,44,0.455,22,0.5,2,1,0.667,1,2,24,20,11,17,16,0.25,0.386,0.364,17.602,44,riffle_clumpy
0,20,20,7,47,0.426,27,0.574,3,3,0.5,1,3,22,25,12,17,18,0.255,0.362,0.383,17.614,45,riffle_clumpy
0,16,26,6,48,0.333,22,0.458,2,3,0.4,1,2,32,16,9,17,22,0.188,0.354,0.458,17.622,46,riffle_clumpy
0,18,26,7,51,0.353,25,0.49,1,2,0.333,2,2,27,24,13,19,19,0.255,0.373,0.373,17.639,47,riffle_clumpy
0,13,27,5,45,0.289,18,0.4,2,0,1.0,0,3,33,12,7,14,24,0.156,0.311,0.533,17.621,48,riffle_clumpy
0,19,23,4,46,0.413,23,0.5,2,2,0.5,1,4,23,23,12,13,21,0.261,0.283,0.457,17.612,49,riffle_clumpy
0,17,25,4,46,0.37,21,0.457,3,1,0.75,3,2,26,20,8,15,23,0.174,0.326,0.5,17.617,50,riffle_clumpy
0,20,22,4,46,0.435,24,0.522,2,0,1.0,0,4,31,15,13,12,21,0.283,0.261,0.457,17.61,51,riffle_clumpy
0,20,19,7,46,0.435,27,0.587,5,2,0.714,3,2,28,18,9,19,18,0.196,0.413,0.391,17.611,52,riffle_clumpy
0,20,26,3,49,0.408,23,0.469,4,0,1.0,3,4,28,21,10,18,21,0.204,0.367,0.429,17.615,53,riffle_clumpy
0,23,19,6,48,0.479,29,0.604,6,3,0.667,1,5,26,22,16,12,20,0.333,0.25,0.417,17.616,54,riffle_clumpy
0,21,24,1,46,0.457,22,0.478,1,3,0.25,1,2,29,17,10,15,21,0.217,0.326,0.457,17.621,55,riffle_clumpy
0,26,20,1,47,0.553,27,0.574,7,0,1.0,3,2,23,24,18,12,17,0.383,0.255,0.362,17.621,56,riffle_clumpy
0,19,19,6,44,0.432,25,0.568,4,2,0.667,2,2,24,20,11,11,22,0.25,0.25,0.5,17.62,57,riffle_clumpy
0,28,14,3,45,0.622,31,0.689,3,1,0.75,3,0,23,22,14,15,16,0.311,0.333,0.356,17.622,58,riffle_clumpy
0,17,24,6,47,0.362,23,0.489,3,2,0.6,2,2,31,16,9,10,28,0.191,0.213,0.596,17.628,59,riffle_clumpy
0,17,26,4,47,0.362,21,0.447,4,4,0.5,2,2,27,20,9,16,22,0.191,0.34,0.468,17.634,60,riffle_clumpy
0,22,23,1,46,0.478,23,0.5,4,5,0.444,2,3,22,24,11,15,20,0.239,0.326,0.435,17.642,61,riffle_clumpy
0,13,22,11,46,0.283,24,0.522,2,4,0.333,1,4,26,20,8,17,21,0.174,0.37,0.457,17.648,62,riffle_clumpy
0,17,24,4,45,0.378,21,0.467,0,1,0.0,1,1,27,18,9,20,16,0.2,0.444,0.356,17.644,63,riffle_clumpy
0,19,28,2,49,0.388,21,0.429,5,3,0.625,1,3,27,22,12,21,16,0.245,0.429,0.327,17.648,64,riffle_clumpy
0,19,19,7,45,0.422,26,0.578,3,3,0.5,3,5,30,15,12,12,21,0.267,0.267,0.467,17.651,65,riffle_clumpy
0,18,22,3,43,0.419,21,0.488,1,2,0.333,2,4,27,16,8,17,18,0.186,0.395,0.419,17.649,66,riffle_clumpy
0,16,23,7,46,0.348,23,0.5,5,2,0.714,1,2,31,15,7,17,22,0.152,0.37,0.478,17.651,67,riffle_clumpy
0,18,24,2,44,0.409,20,0.455,4,2,0.667,1,2,31,13,11,11,22,0.25,0.25,0.5,17.649,68,riffle_clumpy
0,16,24,6,46,0.348,22,0.478,2,3,0.4,1,4,27,19,9,15,22,0.196,0.326,0.478,17.652,69,riffle_clumpy
0,18,28,2,48,0.375,20,0.417,1,9,0.1,1,2,26,22,10,23,15,0.208,0.479,0.312,17.66,70,riffle_clumpy
0,20,24,2,46,0.435,22,0.478,4,2,0.667,3,5,32,14,10,14,22,0.217,0.304,0.478,17.656,71,riffle_clumpy
0,20,20,5,45,0.444,25,0.556,2,1,0.667,2,1,31,14,11,10,24,0.244,0.222,0.533,17.642,72,riffle_clumpy
0,22,18,4,44,0.5,26,0.591,2,4,0.333,2,0,22,22,12,15,17,0.273,0.341,0.386,17.641,73,riffle_clumpy
0,19,18,8,45,0.422,27,0.6,3,1,0.75,1,1,22,23,7,22,16,0.156,0.489,0.356,17.644,74,riffle_clumpy
0,24,21,0,45,0.533,24,0.533,3,1,0.75,5,3,30,15,9,15,21,0.2,0.333,0.467,17.647,75,riffle_clumpy
0,23,19,5,47,0.489,28,0.596,2,1,0.667,3,5,29,18,10,16,21,0.213,0.34,0.447,17.658,76,riffle_clumpy
0,16,22,8,46,0.348,24,0.522,0,1,0.0,1,2,28,18,6,17,23,0.13,0.37,0.5,17.661,77,riffle_clumpy
0,22,19,4,45,0.489,26,0.578,2,0,1.0,3,2,33,12,9,15,21,0.2,0.333,0.467,17.664,78,riffle_clumpy
0,20,19,5,44,0.455,25,0.568,5,2,0.714,1,1,22,22,9,13,22,0.205,0.295,0.5,17.664,79,riffle_clumpy
0,24,19,6,49,0.49,30,0.612,3,0,1.0,1,2,35,14,13,15,21,0.265,0.306,0.429,17.672,80,riffle_clumpy
0,19,19,6,44,0.432,25,0.568,3,4,0.429,1,1,25,19,9,15,20,0.205,0.341,0.455,17.674,81,riffle_clumpy
0,13,23,9,45,0.289,22,0.489,1,0,1.0,2,1,32,13,6,20,19,0.133,0.444,0.422,17.684,82,riffle_clumpy
0,19,25,4,48,0.396,23,0.479,4,3,0.571,3,1,28,20,6,18,24,0.125,0.375,0.5,17.678,83,riffle_clumpy
0,28,16,1,45,0.622,29,0.644,6,1,0.857,1,3,26,19,14,10,21,0.311,0.222,0.467,17.673,84,riffle_clumpy
0,24,17,3,44,0.545,27,0.614,2,0,1.0,1,4,31,13,10,12,22,0.227,0.273,0.5,17.678,85,riffle_clumpy
0,12,30,3,45,0.267,15,0.333,2,3,0.4,1,0,29,16,9,16,20,0.2,0.356,0.444,17.68,86,riffle_clumpy
0,19,23,3,45,0.422,22,0.489,2,4,0.333,0,3,27,18,10,19,16,0.222,0.422,0.356,17.688,87,riffle_clumpy
0,17,26,3,46,0.37,20,0.435,2,3,0.4,3,1,29,17,11,12,23,0.239,0.261,0.5,17.683,88,riffle_clumpy
0,18,27,4,49,0.367,22,0.449,0,4,0.0,3,1,29,20,9,17,23,0.184,0.347,0.469,17.683,89,riffle_clumpy
0,24,17,4,45,0.533,28,0.622,5,1,0.833,4,1,29,16,10,12,23,0.222,0.267,0.511,17.675,90,riffle_clumpy
0,16,24,4,44,0.364,20,0.455,0,0,0,2,1,29,15,6,17,21,0.136,0.386,0.477,17.676,91,riffle_clumpy
0,18,22,5,45,0.4,23,0.511,2,2,0.5,2,0,29,16,9,16,20,0.2,0.356,0.444,17.665,92,riffle_clumpy
0,27,16,3,46,0.587,30,0.652,4,2,0.667,4,0,27,19,10,16,20,0.217,0.348,0.435,17.663,93,riffle_clumpy
0,18,19,6,43,0.419,24,0.558,2,4,0.333,1,1,26,17,12,10,21,0.279,0.233,0.488,17.67,94,riffle_clumpy
0,27,16,4,47,0.574,31,0.66,6,2,0.75,1,1,24,23,14,17,16,0.298,0.362,0.34,17.67,95,riffle_clumpy
0,18,25,3,46,0.391,21,0.457,0,0,0,2,3,26,20,8,16,22,0.174,0.348,0.478,17.66,96,riffle_clumpy
0,18,27,2,47,0.383,20,0.426,3,1,0.75,2,1,31,16,11,9,27,0.234,0.191,0.574,17.697,1,riffle_clumpy
0,23,21,1,45,0.511,24,0.533,4,7,0.364,2,1,24,21,15,12,18,0.333,0.267,0.4,17.707,2,riffle_clumpy
0,17,22,4,43,0.395,21,0.488,4,2,0.667,1,1,25,18,11,15,17,0.256,0.349,0.395,17.678,3,riffle_clumpy
0,16,25,4,45,0.356,20,0.444,1,0,1.0,0,4,30,15,10,16,19,0.222,0.356,0.422,17.798,4,riffle_clumpy
0,24,19,3,46,0.522,27,0.587,4,1,0.8,3,0,28,18,14,14,18,0.304,0.304,0.391,17.718,5,riffle_clumpy
0,16,22,5,43,0.372,21,0.488,3,3,0.5,2,0,30,13,7,11,25,0.163,0.256,0.581,17.783,6,riffle_clumpy
0,20,21,3,44,0.455,23,0.523,7,1,0.875,3,3,26,18,9,13,22,0.205,0.295,0.5,17.725,7,riffle_clumpy
0,26,16,2,44,0.591,28,0.636,2,0,1.0,4,0,28,16,15,13,16,0.341,0.295,0.364,17.648,8,riffle_clumpy
0,27,17,3,47,0.574,30,0.638,5,0,1.0,4,0,25,22,13,16,18,0.277,0.34,0.383,17.631,9,riffle_clumpy
0,16,27,3,46,0.348,19,0.413,3,2,0.6,3,2,30,16,6,15,25,0.13,0.326,0.543,17.61,10,riffle_clumpy
0,18,20,6,44,0.409,24,0.545,2,0,1.0,2,5,29,15,11,12,21,0.25,0.273,0.477,17.604,11,riffle_clumpy
0,16,23,5,44,0.364,21,0.477,3,3,0.5,3,3,22,22,10,15,19,0.227,0.341,0.432,17.635,12,riffle_clumpy
0,20,21,6,47,0.426,26,0.553,3,3,0.5,4,2,32,15,8,18,21,0.17,0.383,0.447,17.649,13,riffle_clumpy
0,19,23,6,48,0.396,25,0.521,2,4,0.333,3,3,33,15,13,16,19,0.271,0.333,0.396,17.693,14,riffle_clumpy
0,21,18,5,44,0.477,26,0.591,4,0,1.0,2,2,33,11,10,10,24,0.227,0.227,0.545,17.694,15,riffle_clumpy
0,20,22,4,46,0.435,24,0.522,1,3,0.25,2,2,26,20,13,11,22,0.283,0.239,0.478,17.73,16,riffle_clumpy
0,21,25,2,48,0.438,23,0.479,5,1,0.833,2,3,27,21,10,13,25,0.208,0.271,0.521,17.727,17,riffle_clumpy
0,18,23,6,47,0.383,24,0.511,5,1,0.833,1,2,25,22,13,18,16,0.277,0.383,0.34,17.783,18,riffle_clumpy
0,14,35,3,52,0.269,17,0.327,5,3,0.625,2,5,32,20,8,18,26,0.154,0.346,0.5,17.803,19,riffle_clumpy
0,19,24,3,46,0.413,22,0.478,4,3,0.571,1,5,28,18,6,14,26,0.13,0.304,0.565,17.806,20,riffle_clumpy
0,20,21,5,46,0.435,25,0.543,2,3,0.4,3,0,24,22,9,18,19,0.196,0.391,0.413,17.818,21,riffle_clumpy
0,19,21,6,46,0.413,25,0.543,2,2,0.5,3,4,25,21,12,14,20,0.261,0.304,0.435,17.763,22,riffle_clumpy
0,19,22,4,45,0.422,23,0.511,2,1,0.667,2,2,32,13,5,15,25,0.111,0.333,0.556,17.773,23,riffle_clumpy
0,19,25,3,47,0.404,22,0.468,3,2,0.6,3,3,31,16,7,15,25,0.149,0.319,0.532,17.777,24,riffle_clumpy
0,12,27,4,43,0.279,16,0.372,1,3,0.25,0,1,24,19,8,17,18,0.186,0.395,0.419,17.802,25,riffle_clumpy
0,18,22,4,44,0.409,22,0.5,2,5,0.286,1,2,26,18,8,17,19,0.182,0.386,0.432,17.827,26,riffle_clumpy
0,23,21,1,45,0.511,24,0.533,2,1,0.667,2,1,25,20,12,17,16,0.267,0.378,0.356,17.803,27,riffle_clumpy
0,21,23,4,48,0.438,25,0.521,3,4,0.429,2,3,25,23,12,17,19,0.25,0.354,0.396,17.804,28,riffle_clumpy
0,15,25,4,44,0.341,19,0.432,0,4,0.0,3,0,27,17,6,15,23,0.136,0.341,0.523,17.81,29,riffle_clumpy
0,22,23,2,47,0.468,24,0.511,3,2,0.6,2,6,35,12,12,11,24,0.255,0.234,0.511,17.792,30,riffle_clumpy
0,17,27,0,44,0.386,17,0.386,2,2,0.5,4,1,26,18,7,14,23,0.159,0.318,0.523,17.783,31,riffle_clumpy
0,21,18,5,44,0.477,26,0.591,7,0,1.0,3,0,23,21,12,11,21,0.273,0.25,0.477,17.764,32,riffle_clumpy
0,19,23,3,45,0.422,22,0.489,5,5,0.5,3,0,28,17,11,11,23,0.244,0.244,0.511,17.761,33,riffle_clumpy
0,23,18,2,43,0.535,25,0.581,2,3,0.4,1,0,26,17,15,12,16,0.349,0.279,0.372,17.749,34,riffle_clumpy
0,23,18,5,46,0.5,28,0.609,2,1,0.667,6,3,27,19,14,9,23,0.304,0.196,0.5,17.751,35,riffle_clumpy
0,18,21,5,44,0.409,23,0.523,3,5,0.375,3,2,22,22,10,21,13,0.227,0.477,0.295,17.765,36,riffle_clumpy
0,21,21,3,45,0.467,24,0.533,1,2,0.333,2,4,25,20,8,22,15,0.178,0.489,0.333,17.771,37,riffle_clumpy
0,22,18,7,47,0.468,29,0.617,4,1,0.8,5,2,29,18,9,16,22,0.191,0.34,0.468,17.768,38,riffle_clumpy
0,17,28,4,49,0.347,21,0.429,1,1,0.5,2,2,36,13,8,14,27,0.163,0.286,0.551,17.771,39,riffle_clumpy
0,16,25,4,45,0.356,20,0.444,2,3,0.4,3,5,30,15,11,11,23,0.244,0.244,0.511,17.771,40,riffle_clumpy
0,24,19,3,46,0.522,27,0.587,5,3,0.625,1,0,27,19,13,12,21,0.283,0.261,0.457,17.77,41,riffle_clumpy
0,21,19,4,44,0.477,25,0.568,2,3,0.4,0,1,24,20,13,15,16,0.295,0.341,0.364,17.761,42,riffle_clumpy
0,24,20,4,48,0.5,28,0.583,6,1,0.857,1,2,25,23,11,22,15,0.229,0.458,0.312,17.769,43,riffle_clumpy
0,13,32,4,49,0.265,17,0.347,0,1,0.0,2,2,32,17,6,18,25,0.122,0.367,0.51,17.781,44,riffle_clumpy
0,20,19,3,42,0.476,23,0.548,3,1,0.75,1,0,21,21,13,13,16,0.31,0.31,0.381,17.784,45,riffle_clumpy
0,20,22,3,45,0.444,23,0.511,3,2,0.6,1,1,29,16,11,13,21,0.244,0.289,0.467,17.768,46,riffle_clumpy
0,20,21,4,45,0.444,24,0.533,5,1,0.833,4,2,24,21,7,16,22,0.156,0.356,0.489,17.761,47,riffle_clumpy
0,22,23,3,48,0.458,25,0.521,2,5,0.286,2,4,29,19,14,14,20,0.292,0.292,0.417,17.744,48,riffle_clumpy
0,24,18,3,45,0.533,27,0.6,5,0,1.0,1,2,28,17,12,15,18,0.267,0.333,0.4,17.744,49,riffle_clumpy
0,23,18,3,44,0.523,26,0.591,2,1,0.667,1,1,31,13,12,14,18,0.273,0.318,0.409,17.751,50,riffle_clumpy
0,16,29,5,50,0.32,21,0.42,4,5,0.444,1,4,25,25,10,23,17,0.2,0.46,0.34,17.752,51,riffle_clumpy
0,20,22,3,45,0.444,23,0.511,3,1,0.75,3,5,33,12,11,9,25,0.244,0.2,0.556,17.754,52,riffle_clumpy
0,25,19,2,46,0.543,27,0.587,4,1,0.8,3,2,27,19,16,8,22,0.348,0.174,0.478,17.748,53,riffle_clumpy
0,25,22,1,48,0.521,26,0.542,2,4,0.333,4,3,27,21,19,12,17,0.396,0.25,0.354,17.744,54,riffle_clumpy
0,25,18,4,47,0.532,29,0.617,0,2,0.0,3,1,26,21,14,14,19,0.298,0.298,0.404,17.742,55,riffle_clumpy
0,18,25,7,50,0.36,25,0.5,4,3,0.571,3,2,27,23,10,17,23,0.2,0.34,0.46,17.744,56,riffle_clumpy
0,16,24,4,44,0.364,20,0.455,2,2,0.5,1,2,30,14,10,14,20,0.227,0.318,0.455,17.73,57,riffle_clumpy
0,20,22,2,44,0.455,22,0.5,2,1,0.667,2,1,32,12,9,12,23,0.205,0.273,0.523,17.741,58,riffle_clumpy
0,23,17,5,45,0.511,28,0.622,3,0,1.0,3,0,29,16,13,14,18,0.289,0.311,0.4,17.744,59,riffle_clumpy
0,18,25,1,44,0.409,19,0.432,3,3,0.5,2,2,20,24,10,19,15,0.227,0.432,0.341,17.744,60,riffle_clumpy
0,21,16,8,45,0.467,29,0.644,1,0,1.0,5,2,31,14,6,16,23,0.133,0.356,0.511,17.76,61,riffle_clumpy
0,19,20,3,42,0.452,22,0.524,5,0,1.0,2,0,25,17,14,11,17,0.333,0.262,0.405,17.749,62,riffle_clumpy
0,18,26,0,44,0.409,18,0.409,5,1,0.833,1,3,27,17,8,18,18,0.182,0.409,0.409,17.739,63,riffle_clumpy
0,21,19,5,45,0.467,26,0.578,2,1,0.667,3,1,28,17,12,11,22,0.267,0.244,0.489,17.737,64,riffle_clumpy
0,18,22,6,46,0.391,24,0.522,3,3,0.5,3,3,29,17,10,12,24,0.217,0.261,0.522,17.744,65,riffle_clumpy
0,19,22,5,46,0.413,24,0.522,1,0,1.0,0,0,34,12,13,16,17,0.283,0.348,0.37,17.755,66,riffle_clumpy
0,22,17,6,45,0.489,28,0.622,3,2,0.6,5,2,29,16,9,13,23,0.2,0.289,0.511,17.743,67,riffle_clumpy
0,23,16,6,45,0.511,29,0.644,4,2,0.667,2,2,22,23,14,11,20,0.311,0.244,0.444,17.749,68,riffle_clumpy
0,26,18,4,48,0.542,30,0.625,3,2,0.6,2,0,28,20,14,14,20,0.292,0.292,0.417,17.75,69,riffle_clumpy
0,25,17,2,44,0.568,27,0.614,5,2,0.714,4,2,26,18,12,10,22,0.273,0.227,0.5,17.746,70,riffle_clumpy
0,22,19,3,44,0.5,25,0.568,2,1,0.667,3,1,25,19,12,13,19,0.273,0.295,0.432,17.741,71,riffle_clumpy
0,24,15,4,43,0.558,28,0.651,1,1,0.5,1,2,29,14,13,11,19,0.302,0.256,0.442,17.746,72,riffle_clumpy
0,16,23,5,44,0.364,21,0.477,2,3,0.4,1,2,25,19,11,13,20,0.25,0.295,0.455,17.741,73,riffle_clumpy
0,20,25,1,46,0.435,21,0.457,3,5,0.375,3,3,30,16,12,11,23,0.261,0.239,0.5,17.739,74,riffle_clumpy
0,16,26,6,48,0.333,22,0.458,3,1,0.75,1,4,26,22,10,16,22,0.208,0.333,0.458,17.733,75,riffle_clumpy
0,23,22,5,50,0.46,28,0.56,3,5,0.375,1,1,27,23,12,19,19,0.24,0.38,0.38,17.737,76,riffle_clumpy
0,22,19,4,45,0.489,26,0.578,1,2,0.333,0,1,29,16,8,15,22,0.178,0.333,0.489,17.726,77,riffle_clumpy
0,23,23,1,47,0.489,24,0.511,0,1,0.0,6,3,28,19,15,9,23,0.319,0.191,0.489,17.72,78,riffle_clumpy
0,18,20,5,43,0.419,23,0.535,2,3,0.4,2,2,27,16,11,12,20,0.256,0.279,0.465,17.713,79,riffle_clumpy
0,23,21,2,46,0.5,25,0.543,4,0,1.0,1,3,30,16,13,9,24,0.283,0.196,0.522,17.703,80,riffle_clumpy
0,26,18,2,46,0.565,28,0.609,4,4,0.5,4,2,28,18,10,14,22,0.217,0.304,0.478,17.696,81,riffle_clumpy
0,23,17,4,44,0.523,27,0.614,6,1,0.857,5,1,25,19,12,12,20,0.273,0.273,0.455,17.696,82,riffle_clumpy
0,19,22,4,45,0.422,23,0.511,1,4,0.2,0,1,29,16,13,14,18,0.289,0.311,0.4,17.695,83,riffle_clumpy
0,18,21,6,45,0.4,24,0.533,1,2,0.333,4,3,33,12,9,15,21,0.2,0.333,0.467,17.695,84,riffle_clumpy
0,22,17,5,44,0.5,27,0.614,4,2,0.667,0,2,25,19,15,11,18,0.341,0.25,0.409,17.701,85,riffle_clumpy
0,24,21,4,49,0.49,28,0.571,2,1,0.667,0,2,25,24,12,18,19,0.245,0.367,0.388,17.7,86,riffle_clumpy
0,21,20,3,44,0.477,24,0.545,5,3,0.625,1,0,26,18,12,16,16,0.273,0.364,0.364,17.705,87,riffle_clumpy
0,27,14,6,47,0.574,33,0.702,6,2,0.75,5,3,27,20,11,15,21,0.234,0.319,0.447,17.714,88,riffle_clumpy
0,22,18,5,45,0.489,27,0.6,5,2,0.714,4,2,29,16,13,14,18,0.289,0.311,0.4,17.723,89,riffle_clumpy
0,24,18,3,45,0.533,27,0.6,4,2,0.667,2,3,23,22,13,13,19,0.289,0.289,0.422,17.723,90,riffle_clumpy
0,23,22,3,48,0.479,26,0.542,5,2,0.714,3,2,35,13,12,10,26,0.25,0.208,0.542,17.719,91,riffle_clumpy
0,22,20,3,45,0.489,25,0.556,3,4,0.429,2,1,23,22,10,15,20,0.222,0.333,0.444,17.716,92,riffle_clumpy
0,15,29,4,48,0.312,19,0.396,0,2,0.0,1,2,31,17,9,16,23,0.188,0.333,0.479,17.722,93,riffle_clumpy
0,22,17,7,46,0.478,29,0.63,4,2,0.667,0,0,26,20,16,15,15,0.348,0.326,0.326,17.732,94,riffle_clumpy
0,20,23,3,46,0.435,23,0.5,4,4,0.5,4,0,28,18,9,15,22,0.196,0.326,0.478,17.73,95,riffle_clumpy
0,25,18,2,45,0.556,27,0.6,2,4,0.333,5,1,23,22,9,17,19,0.2,0.378,0.422,17.731,96,riffle_clumpy
0,15,20,10,45,0.333,25,0.556,3,1,0.75,2,1,29,16,8,17,20,0.178,0.378,0.444,18.258,1,riffle_clumpy
0,14,28,4,46,0.304,18,0.391,0,4,0.0,1,3,33,13,8,18,20,0.174,0.391,0.435,17.967,2,riffle_clumpy
0,21,23,1,45,0.467,22,0.489,2,0,1.0,3,2,29,16,9,14,22,0.2,0.311,0.489,17.796,3,riffle_clumpy
0,17,26,6,49,0.347,23,0.469,1,3,0.25,1,2,36,13,9,15,25,0.184,0.306,0.51,17.976,4,riffle_clumpy
0,20,19,5,44,0.455,25,0.568,3,3,0.5,2,0,26,18,9,14,21,0.205,0.318,0.477,17.786,5,riffle_clumpy
0,16,25,5,46,0.348,21,0.457,4,2,0.667,3,1,26,20,8,19,19,0.174,0.413,0.413,17.859,6,riffle_clumpy
0,24,21,5,50,0.48,29,0.58,3,1,0.75,3,3,31,19,14,11,25,0.28,0.22,0.5,17.757,7,riffle_clumpy
0,21,18,6,45,0.467,27,0.6,6,1,0.857,2,1,27,18,11,14,20,0.244,0.311,0.444,17.819,8,riffle_clumpy
0,22,20,4,46,0.478,26,0.565,4,1,0.8,3,2,24,22,13,14,19,0.283,0.304,0.413,17.827,9,riffle_clumpy
0,20,23,1,44,0.455,21,0.477,2,1,0.667,2,0,29,15,9,13,22,0.205,0.295,0.5,17.734,10,riffle_clumpy
0,21,19,5,45,0.467,26,0.578,1,3,0.25,4,1,23,22,13,14,18,0.289,0.311,0.4,17.746,11,riffle_clumpy
0,20,23,5,48,0.417,25,0.521,2,2,0.5,3,3,22,26,13,17,18,0.271,0.354,0.375,17.774,12,riffle_clumpy
0,17,27,3,47,0.362,20,0.426,1,1,0.5,3,2,30,17,6,17,24,0.128,0.362,0.511,17.722,13,riffle_clumpy
0,19,20,6,45,0.422,25,0.556,3,3,0.5,2,2,25,20,10,15,20,0.222,0.333,0.444,17.776,14,riffle_clumpy
0,19,21,4,44,0.432,23,0.523,2,4,0.333,1,3,26,18,11,17,16,0.25,0.386,0.364,17.8,15,riffle_clumpy
0,22,19,3,44,0.5,25,0.568,4,4,0.5,0,2,29,15,13,8,23,0.295,0.182,0.523,17.786,16,riffle_clumpy
0,17,22,5,44,0.386,22,0.5,2,0,1.0,1,3,22,22,8,18,18,0.182,0.409,0.409,17.809,17,riffle_clumpy
0,15,28,2,45,0.333,17,0.378,0,2,0.0,0,2,26,19,9,17,19,0.2,0.378,0.422,17.832,18,riffle_clumpy
0,21,26,0,47,0.447,21,0.447,1,3,0.25,1,4,33,14,12,8,27,0.255,0.17,0.574,17.804,19,riffle_clumpy
0,18,22,3,43,0.419,21,0.488,3,0,1.0,1,3,27,16,12,9,22,0.279,0.209,0.512,17.77,20,riffle_clumpy
0,28,19,1,48,0.583,29,0.604,5,3,0.625,2,1,25,23,22,11,15,0.458,0.229,0.312,17.774,21,riffle_clumpy
0,22,22,0,44,0.5,22,0.5,4,1,0.8,2,3,26,18,15,11,18,0.341,0.25,0.409,17.757,22,riffle_clumpy
0,16,25,6,47,0.34,22,0.468,3,2,0.6,3,2,29,18,9,19,19,0.191,0.404,0.404,17.751,23,riffle_clumpy
0,18,27,4,49,0.367,22,0.449,6,1,0.857,1,4,28,21,8,18,23,0.163,0.367,0.469,17.751,24,riffle_clumpy
0,20,21,2,43,0.465,22,0.512,3,5,0.375,2,0,21,22,11,18,14,0.256,0.419,0.326,17.756,25,riffle_clumpy
0,21,21,5,47,0.447,26,0.553,4,0,1.0,2,0,27,20,12,10,25,0.255,0.213,0.532,17.74,26,riffle_clumpy
0,28,16,6,50,0.56,34,0.68,6,1,0.857,2,0,29,21,15,17,18,0.3,0.34,0.36,17.732,27,riffle_clumpy
0,14,22,7,43,0.326,21,0.488,3,3,0.5,0,1,28,15,8,11,24,0.186,0.256,0.558,17.736,28,riffle_clumpy
0,24,19,1,44,0.545,25,0.568,3,3,0.5,2,2,25,19,15,12,17,0.341,0.273,0.386,17.719,29,riffle_clumpy
0,18,23,5,46,0.391,23,0.5,1,0,1.0,5,5,26,20,11,17,18,0.239,0.37,0.391,17.735,30,riffle_clumpy
0,15,26,5,46,0.326,20,0.435,1,1,0.5,3,4,24,22,8,13,25,0.174,0.283,0.543,17.717,31,riffle_clumpy
0,17,28,1,46,0.37,18,0.391,4,0,1.0,1,3,29,17,11,15,20,0.239,0.326,0.435,17.716,32,riffle_clumpy
0,23,25,1,49,0.469,24,0.49,2,0,1.0,3,4,29,20,15,11,23,0.306,0.224,0.469,17.692,33,riffle_clumpy
0,18,19,8,45,0.4,26,0.578,5,1,0.833,5,2,24,21,9,17,19,0.2,0.378,0.422,17.693,34,riffle_clumpy
0,23,20,6,49,0.469,29,0.592,3,2,0.6,0,2,33,16,13,19,17,0.265,0.388,0.347,17.711,35,riffle_clumpy
0,17,24,3,44,0.386,20,0.455,2,1,0.667,3,1,29,15,11,14,19,0.25,0.318,0.432,17.712,36,riffle_clumpy
0,19,19,6,44,0.432,25,0.568,2,1,0.667,2,0,26,18,12,12,20,0.273,0.273,0.455,17.704,37,riffle_clumpy
0,21,20,4,45,0.467,25,0.556,2,1,0.667,1,3,31,14,10,12,23,0.222,0.267,0.511,17.695,38,riffle_clumpy
0,22,20,3,45,0.489,25,0.556,7,3,0.7,1,2,27,18,9,18,18,0.2,0.4,0.4,17.714,39,riffle_clumpy
0,21,18,7,46,0.457,28,0.609,2,1,0.667,3,0,34,12,9,16,21,0.196,0.348,0.457,17.705,40,riffle_clumpy
0,24,16,6,46,0.522,30,0.652,2,0,1.0,3,2,23,23,14,14,18,0.304,0.304,0.391,17.695,41,riffle_clumpy
0,22,18,5,45,0.489,27,0.6,2,1,0.667,2,1,26,19,10,19,16,0.222,0.422,0.356,17.705,42,riffle_clumpy
0,18,26,3,47,0.383,21,0.447,0,2,0.0,3,3,31,16,8,9,30,0.17,0.191,0.638,17.689,43,riffle_clumpy
0,24,15,5,44,0.545,29,0.659,5,1,0.833,2,4,26,18,16,13,15,0.364,0.295,0.341,17.684,44,riffle_clumpy
0,20,24,2,46,0.435,22,0.478,2,2,0.5,3,1,26,20,12,14,20,0.261,0.304,0.435,17.696,45,riffle_clumpy
0,17,25,2,44,0.386,19,0.432,4,3,0.571,2,3,27,17,10,14,20,0.227,0.318,0.455,17.709,46,riffle_clumpy
0,22,19,3,44,0.5,25,0.568,2,3,0.4,3,3,30,14,8,11,25,0.182,0.25,0.568,17.701,47,riffle_clumpy
0,18,25,3,46,0.391,21,0.457,3,3,0.5,1,2,25,21,10,17,19,0.217,0.37,0.413,17.698,48,riffle_clumpy
0,20,22,3,45,0.444,23,0.511,2,1,0.667,2,2,29,16,7,15,23,0.156,0.333,0.511,17.698,49,riffle_clumpy
0,15,28,3,46,0.326,18,0.391,2,2,0.5,3,2,29,17,8,14,24,0.174,0.304,0.522,17.682,50,riffle_clumpy
0,17,25,4,46,0.37,21,0.457,5,1,0.833,6,5,25,21,9,13,24,0.196,0.283,0.522,17.666,51,riffle_clumpy
0,18,18,8,44,0.409,26,0.591,5,1,0.833,2,3,31,13,8,11,25,0.182,0.25,0.568,17.667,52,riffle_clumpy
0,19,21,6,46,0.413,25,0.543,2,3,0.4,1,2,33,13,9,18,19,0.196,0.391,0.413,17.665,53,riffle_clumpy
0,16,25,6,47,0.34,22,0.468,0,3,0.0,4,2,27,20,9,16,22,0.191,0.34,0.468,17.664,54,riffle_clumpy
0,16,23,7,46,0.348,23,0.5,2,3,0.4,2,1,25,21,10,16,20,0.217,0.348,0.435,17.663,55,riffle_clumpy
0,22,20,4,46,0.478,26,0.565,6,2,0.75,1,1,28,18,11,23,12,0.239,0.5,0.261,17.677,56,riffle_clumpy
0,27,17,2,46,0.587,29,0.63,4,0,1.0,2,3,24,22,15,15,16,0.326,0.326,0.348,17.683,57,riffle_clumpy
0,23,21,3,47,0.489,26,0.553,4,3,0.571,5,2,29,18,10,13,24,0.213,0.277,0.511,17.676,58,riffle_clumpy
0,18,22,4,44,0.409,22,0.5,3,1,0.75,4,1,23,21,11,14,19,0.25,0.318,0.432,17.671,59,riffle_clumpy
0,16,27,6,49,0.327,22,0.449,2,4,0.333,2,1,28,21,7,26,16,0.143,0.531,0.327,17.669,60,riffle_clumpy
0,19,25,3,47,0.404,22,0.468,3,4,0.429,4,5,30,17,6,18,23,0.128,0.383,0.489,17.665,61,riffle_clumpy
0,18,22,5,45,0.4,23,0.511,3,4,0.429,1,3,28,17,14,13,18,0.311,0.289,0.4,17.673,62,riffle_clumpy
0,23,17,4,44,0.523,27,0.614,6,1,0.857,2,2,19,25,11,17,16,0.25,0.386,0.364,17.674,63,riffle_clumpy
0,20,21,4,45,0.444,24,0.533,3,3,0.5,5,2,26,19,9,14,22,0.2,0.311,0.489,17.67,64,riffle_clumpy
0,17,24,4,45,0.378,21,0.467,3,2,0.6,5,1,27,18,5,18,22,0.111,0.4,0.489,17.665,65,riffle_clumpy
0,20,21,6,47,0.426,26,0.553,3,4,0.429,1,3,24,23,12,14,21,0.255,0.298,0.447,17.666,66,riffle_clumpy
0,21,20,4,45,0.467,25,0.556,2,1,0.667,2,3,25,20,16,10,19,0.356,0.222,0.422,17.654,67,riffle_clumpy
0,22,22,1,45,0.489,23,0.511,1,1,0.5,2,2,25,20,15,15,15,0.333,0.333,0.333,17.653,68,riffle_clumpy
0,22,22,2,46,0.478,24,0.522,0,4,0.0,2,2,32,14,10,11,25,0.217,0.239,0.543,17.655,69,riffle_clumpy
0,19,19,7,45,0.422,26,0.578,2,3,0.4,0,1,29,16,11,9,25,0.244,0.2,0.556,17.649,70,riffle_clumpy
0,20,19,4,43,0.465,24,0.558,3,2,0.6,2,0,21,22,14,13,16,0.326,0.302,0.372,17.642,71,riffle_clumpy
0,18,21,5,44,0.409,23,0.523,5,4,0.556,0,3,32,12,5,12,27,0.114,0.273,0.614,17.641,72,riffle_clumpy
0,20,20,6,46,0.435,26,0.565,4,2,0.667,3,2,26,20,13,13,20,0.283,0.283,0.435,17.65,73,riffle_clumpy
0,19,20,5,44,0.432,24,0.545,3,2,0.6,3,0,28,16,12,11,21,0.273,0.25,0.477,17.65,74,riffle_clumpy
0,16,25,3,44,0.364,19,0.432,4,7,0.364,2,1,26,18,8,12,24,0.182,0.273,0.545,17.646,75,riffle_clumpy
0,20,22,3,45,0.444,23,0.511,2,3,0.4,2,1,35,10,10,14,21,0.222,0.311,0.467,17.646,76,riffle_clumpy
0,23,22,0,45,0.511,23,0.511,1,1,0.5,3,2,28,17,10,13,22,0.222,0.289,0.489,17.636,77,riffle_clumpy
0,19,25,3,47,0.404,22,0.468,2,2,0.5,4,2,27,20,9,16,22,0.191,0.34,0.468,17.629,78,riffle_clumpy
0,24,16,4,44,0.545,28,0.636,5,1,0.833,2,2,27,17,16,12,16,0.364,0.273,0.364,17.634,79,riffle_clumpy
0,17,21,7,45,0.378,24,0.533,3,2,0.6,2,4,34,11,6,14,25,0.133,0.311,0.556,17.638,80,riffle_clumpy
0,19,25,4,48,0.396,23,0.479,4,0,1.0,3,4,33,15,8,17,23,0.167,0.354,0.479,17.635,81,riffle_clumpy
0,18,22,5,45,0.4,23,0.511,4,1,0.8,6,1,25,20,5,20,20,0.111,0.444,0.444,17.629,82,riffle_clumpy
0,20,25,2,47,0.426,22,0.468,3,3,0.5,4,3,27,20,11,15,21,0.234,0.319,0.447,17.626,83,riffle_clumpy
0,15,25,6,46,0.326,21,0.457,3,2,0.6,0,4,29,17,5,19,22,0.109,0.413,0.478,17.631,84,riffle_clumpy
0,19,23,4,46,0.413,23,0.5,3,4,0.429,4,1,23,23,12,13,21,0.261,0.283,0.457,17.622,85,riffle_clumpy
0,26,14,4,44,0.591,30,0.682,5,1,0.833,0,1,27,17,15,14,15,0.341,0.318,0.341,17.63,86,riffle_clumpy
0,15,27,3,45,0.333,18,0.4,5,4,0.556,2,3,34,11,10,9,26,0.222,0.2,0.578,17.633,87,riffle_clumpy
0,20,20,5,45,0.444,25,0.556,1,2,0.333,1,3,28,17,8,23,14,0.178,0.511,0.311,17.638,88,riffle_clumpy
0,12,30,2,44,0.273,14,0.318,1,1,0.5,1,4,29,15,5,17,22,0.114,0.386,0.5,17.641,89,riffle_clumpy
0,18,27,0,45,0.4,18,0.4,2,0,1.0,3,3,30,15,11,12,22,0.244,0.267,0.489,17.637,90,riffle_clumpy
0,15,28,3,46,0.326,18,0.391,2,1,0.667,3,2,29,17,6,17,23,0.13,0.37,0.5,17.638,91,riffle_clumpy
0,20,20,5,45,0.444,25,0.556,1,4,0.2,2,4,19,26,13,19,13,0.289,0.422,0.289,17.64,92,riffle_clumpy
0,19,25,1,45,0.422,20,0.444,4,3,0.571,3,2,28,17,9,14,22,0.2,0.311,0.489,17.631,93,riffle_clumpy
0,22,20,2,44,0.5,24,0.545,0,3,0.0,4,1,26,18,11,15,18,0.25,0.341,0.409,17.628,94,riffle_clumpy
0,15,23,6,44,0.341,21,0.477,1,2,0.333,3,1,27,17,7,18,19,0.159,0.409,0.432,17.627,95,riffle_clumpy
0,20,20,3,43,0.465,23,0.535,2,3,0.4,3,1,24,19,13,10,20,0.302,0.233,0.465,17.629,96,riffle_clumpy
0,21,24,1,46,0.457,22,0.478,6,2,0.75,2,3,27,19,11,14,21,0.239,0.304,0.457,17.759,1,riffle_clumpy
0,19,19,5,43,0.442,24,0.558,4,3,0.571,2,2,29,14,10,13,20,0.233,0.302,0.465,17.414,2,riffle_clumpy
0,22,19,5,46,0.478,27,0.587,3,3,0.5,4,2,27,19,11,14,21,0.239,0.304,0.457,17.367,3,riffle_clumpy
0,23,20,3,46,0.5,26,0.565,1,2,0.333,3,1,28,18,11,13,22,0.239,0.283,0.478,17.612,4,riffle_clumpy
0,18,24,3,45,0.4,21,0.467,1,3,0.25,2,3,24,21,9,19,17,0.2,0.422,0.378,17.644,5,riffle_clumpy
0,27,18,4,49,0.551,31,0.633,7,1,0.875,1,2,26,23,16,17,16,0.327,0.347,0.327,17.626,6,riffle_clumpy
0,27,17,3,47,0.574,30,0.638,8,1,0.889,3,1,22,25,10,19,18,0.213,0.404,0.383,17.632,7,riffle_clumpy
0,25,16,3,44,0.568,28,0.636,2,0,1.0,1,0,31,13,14,11,19,0.318,0.25,0.432,17.649,8,riffle_clumpy
0,26,15,5,46,0.565,31,0.674,4,1,0.8,4,1,26,20,14,12,20,0.304,0.261,0.435,17.502,9,riffle_clumpy
0,19,23,3,45,0.422,22,0.489,3,4,0.429,0,0,22,23,13,18,14,0.289,0.4,0.311,17.529,10,riffle_clumpy
0,23,19,2,44,0.523,25,0.568,3,3,0.5,2,0,26,18,10,13,21,0.227,0.295,0.477,17.548,11,riffle_clumpy
0,21,22,4,47,0.447,25,0.532,1,4,0.2,0,1,22,25,13,17,17,0.277,0.362,0.362,17.648,12,riffle_clumpy
0,21,22,3,46,0.457,24,0.522,2,6,0.25,3,1,26,20,11,17,18,0.239,0.37,0.391,17.683,13,riffle_clumpy
0,26,19,2,47,0.553,28,0.596,1,2,0.333,2,3,28,19,9,15,23,0.191,0.319,0.489,17.69,14,riffle_clumpy
0,16,22,8,46,0.348,24,0.522,4,5,0.444,2,2,28,18,9,15,22,0.196,0.326,0.478,17.735,15,riffle_clumpy
0,11,23,9,43,0.256,20,0.465,4,1,0.8,0,2,32,11,3,17,23,0.07,0.395,0.535,17.761,16,riffle_clumpy
0,19,23,5,47,0.404,24,0.511,2,2,0.5,4,2,27,20,10,12,25,0.213,0.255,0.532,17.677,17,riffle_clumpy
0,21,18,5,44,0.477,26,0.591,2,1,0.667,2,1,28,16,11,9,24,0.25,0.205,0.545,17.634,18,riffle_clumpy
0,22,19,4,45,0.489,26,0.578,4,1,0.8,0,2,22,23,14,18,13,0.311,0.4,0.289,17.652,19,riffle_clumpy
0,16,27,3,46,0.348,19,0.413,5,4,0.556,1,6,29,17,6,18,22,0.13,0.391,0.478,17.637,20,riffle_clumpy
0,26,15,3,44,0.591,29,0.659,4,1,0.8,3,5,30,14,15,5,24,0.341,0.114,0.545,17.605,21,riffle_clumpy
0,24,16,5,45,0.533,29,0.644,2,1,0.667,4,2,25,20,15,12,18,0.333,0.267,0.4,17.585,22,riffle_clumpy
0,17,25,3,45,0.378,20,0.444,2,0,1.0,1,2,26,19,11,11,23,0.244,0.244,0.511,17.605,23,riffle_clumpy
0,15,26,4,45,0.333,19,0.422,3,2,0.6,1,4,29,16,9,17,19,0.2,0.378,0.422,17.642,24,riffle_clumpy
0,21,19,3,43,0.488,24,0.558,3,3,0.5,3,4,28,15,9,15,19,0.209,0.349,0.442,17.65,25,riffle_clumpy
0,26,15,3,44,0.591,29,0.659,4,1,0.8,1,1,25,19,15,11,18,0.341,0.25,0.409,17.638,26,riffle_clumpy
0,21,17,4,42,0.5,25,0.595,3,3,0.5,2,1,29,13,15,12,15,0.357,0.286,0.357,17.645,27,riffle_clumpy
0,22,17,5,44,0.5,27,0.614,3,2,0.6,0,0,27,17,15,13,16,0.341,0.295,0.364,17.678,28,riffle_clumpy
0,15,28,4,47,0.319,19,0.404,1,6,0.143,4,1,28,19,6,15,26,0.128,0.319,0.553,17.669,29,riffle_clumpy
0,20,21,4,45,0.444,24,0.533,2,0,1.0,2,3,29,16,11,14,20,0.244,0.311,0.444,17.658,30,riffle_clumpy
0,24,15,4,43,0.558,28,0.651,9,1,0.9,2,3,27,16,14,12,17,0.326,0.279,0.395,17.663,31,riffle_clumpy
0,19,21,8,48,0.396,27,0.562,3,1,0.75,4,1,30,18,6,12,30,0.125,0.25,0.625,17.67,32,riffle_clumpy
0,18,20,7,45,0.4,25,0.556,2,3,0.4,2,1,29,16,10,14,21,0.222,0.311,0.467,17.66,33,riffle_clumpy
0,24,17,4,45,0.533,28,0.622,4,4,0.5,7,0,21,24,14,14,17,0.311,0.311,0.378,17.661,34,riffle_clumpy
0,21,20,4,45,0.467,25,0.556,2,0,1.0,3,2,28,17,13,15,17,0.289,0.333,0.378,17.673,35,riffle_clumpy
0,16,29,1,46,0.348,17,0.37,4,4,0.5,3,2,29,17,8,13,25,0.174,0.283,0.543,17.654,36,riffle_clumpy
0,25,19,1,45,0.556,26,0.578,4,2,0.667,2,2,27,18,18,10,17,0.4,0.222,0.378,17.654,37,riffle_clumpy
0,20,22,3,45,0.444,23,0.511,2,4,0.333,3,2,32,13,11,15,19,0.244,0.333,0.422,17.662,38,riffle_clumpy
0,18,28,1,47,0.383,19,0.404,4,3,0.571,4,3,25,22,8,14,25,0.17,0.298,0.532,17.644,39,riffle_clumpy
0,24,16,4,44,0.545,28,0.636,4,0,1.0,1,1,32,12,11,10,23,0.25,0.227,0.523,17.643,40,riffle_clumpy
0,21,23,5,49,0.429,26,0.531,7,5,0.583,1,1,28,21,10,19,20,0.204,0.388,0.408,17.639,41,riffle_clumpy
0,19,25,2,46,0.413,21,0.457,5,2,0.714,1,4,28,18,13,12,21,0.283,0.261,0.457,17.631,42,riffle_clumpy
0,22,19,3,44,0.5,25,0.568,1,0,1.0,3,4,32,12,13,12,19,0.295,0.273,0.432,17.619,43,riffle_clumpy
0,19,21,5,45,0.422,24,0.533,1,0,1.0,3,1,31,14,11,14,20,0.244,0.311,0.444,17.621,44,riffle_clumpy
0,18,26,3,47,0.383,21,0.447,1,2,0.333,3,2,25,22,9,14,24,0.191,0.298,0.511,17.617,45,riffle_clumpy
0,24,16,4,44,0.545,28,0.636,5,1,0.833,1,3,23,21,15,14,15,0.341,0.318,0.341,17.625,46,riffle_clumpy
0,31,13,2,46,0.674,33,0.717,4,1,0.8,4,1,22,24,23,9,14,0.5,0.196,0.304,17.619,47,riffle_clumpy
0,21,22,3,46,0.457,24,0.522,3,1,0.75,3,0,26,20,11,18,17,0.239,0.391,0.37,17.613,48,riffle_clumpy
0,16,27,4,47,0.34,20,0.426,3,2,0.6,0,3,26,21,10,17,20,0.213,0.362,0.426,17.616,49,riffle_clumpy
0,12,24,8,44,0.273,20,0.455,2,4,0.333,0,3,30,14,6,17,21,0.136,0.386,0.477,17.621,50,riffle_clumpy
0,17,22,7,46,0.37,24,0.522,4,1,0.8,4,5,32,14,8,14,24,0.174,0.304,0.522,17.619,51,riffle_clumpy
0,19,22,4,45,0.422,23,0.511,4,5,0.444,1,1,29,16,9,13,23,0.2,0.289,0.511,17.624,52,riffle_clumpy
0,20,25,3,48,0.417,23,0.479,5,2,0.714,1,5,33,15,4,15,29,0.083,0.312,0.604,17.625,53,riffle_clumpy
0,16,21,7,44,0.364,23,0.523,3,3,0.5,2,1,25,19,5,20,19,0.114,0.455,0.432,17.624,54,riffle_clumpy
0,22,21,2,45,0.489,24,0.533,3,4,0.429,2,2,27,18,12,10,23,0.267,0.222,0.511,17.619,55,riffle_clumpy
0,18,20,6,44,0.409,24,0.545,2,2,0.5,3,1,30,14,5,18,21,0.114,0.409,0.477,17.633,56,riffle_clumpy
0,22,21,1,44,0.5,23,0.523,2,3,0.4,3,0,27,17,18,8,18,0.409,0.182,0.409,17.634,57,riffle_clumpy
0,21,25,1,47,0.447,22,0.468,4,3,0.571,2,5,28,19,10,12,25,0.213,0.255,0.532,17.622,58,riffle_clumpy
0,21,25,1,47,0.447,22,0.468,3,2,0.6,1,2,26,21,12,16,19,0.255,0.34,0.404,17.621,59,riffle_clumpy
0,19,20,5,44,0.432,24,0.545,3,2,0.6,1,2,27,17,12,14,18,0.273,0.318,0.409,17.61,60,riffle_clumpy
0,23,22,1,46,0.5,24,0.522,4,0,1.0,1,3,29,17,17,7,22,0.37,0.152,0.478,17.606,61,riffle_clumpy
0,15,23,6,44,0.341,21,0.477,3,2,0.6,3,1,26,18,6,19,19,0.136,0.432,0.432,17.613,62,riffle_clumpy
0,20,25,2,47,0.426,22,0.468,5,4,0.556,4,4,32,15,9,10,28,0.191,0.213,0.596,17.61,63,riffle_clumpy
0,17,27,1,45,0.378,18,0.4,2,1,0.667,3,2,27,18,10,18,17,0.222,0.4,0.378,17.618,64,riffle_clumpy
0,15,24,5,44,0.341,20,0.455,2,2,0.5,1,3,31,13,10,10,24,0.227,0.227,0.545,17.613,65,riffle_clumpy
0,19,24,4,47,0.404,23,0.489,1,1,0.5,2,1,30,17,9,12,26,0.191,0.255,0.553,17.607,66,riffle_clumpy
0,16,27,4,47,0.34,20,0.426,2,1,0.667,3,0,26,21,7,21,19,0.149,0.447,0.404,17.598,67,riffle_clumpy
0,26,21,3,50,0.52,29,0.58,3,2,0.6,2,2,28,22,11,17,22,0.22,0.34,0.44,17.597,68,riffle_clumpy
0,23,16,7,46,0.5,30,0.652,5,1,0.833,3,1,25,21,14,15,17,0.304,0.326,0.37,17.592,69,riffle_clumpy
0,24,17,4,45,0.533,28,0.622,3,0,1.0,2,0,27,18,16,13,16,0.356,0.289,0.356,17.59,70,riffle_clumpy
0,24,22,2,48,0.5,26,0.542,2,2,0.5,3,4,29,19,9,19,20,0.188,0.396,0.417,17.58,71,riffle_clumpy
0,18,26,3,47,0.383,21,0.447,3,3,0.5,2,0,27,20,8,18,21,0.17,0.383,0.447,17.571,72,riffle_clumpy
0,21,21,3,45,0.467,24,0.533,4,4,0.5,2,1,25,20,15,13,17,0.333,0.289,0.378,17.563,73,riffle_clumpy
0,20,19,5,44,0.455,25,0.568,4,3,0.571,4,2,29,15,11,10,23,0.25,0.227,0.523,17.558,74,riffle_clumpy
0,17,27,1,45,0.378,18,0.4,1,5,0.167,2,2,28,17,10,16,19,0.222,0.356,0.422,17.566,75,riffle_clumpy
0,19,25,2,46,0.413,21,0.457,2,6,0.25,3,2,30,16,9,15,22,0.196,0.326,0.478,17.562,76,riffle_clumpy
0,17,22,4,43,0.395,21,0.488,3,1,0.75,2,2,22,21,11,19,13,0.256,0.442,0.302,17.563,77,riffle_clumpy
0,17,19,9,45,0.378,26,0.578,2,0,1.0,5,0,27,18,8,14,23,0.178,0.311,0.511,17.558,78,riffle_clumpy
0,25,20,3,48,0.521,28,0.583,5,4,0.556,2,3,27,21,14,13,21,0.292,0.271,0.438,17.561,79,riffle_clumpy
0,25,24,2,51,0.49,27,0.529,6,2,0.75,1,3,24,27,13,22,16,0.255,0.431,0.314,17.567,80,riffle_clumpy
0,26,19,2,47,0.553,28,0.596,7,1,0.875,3,2,25,22,15,12,20,0.319,0.255,0.426,17.559,81,riffle_clumpy
0,20,20,6,46,0.435,26,0.565,2,3,0.4,3,1,26,20,11,17,18,0.239,0.37,0.391,17.554,82,riffle_clumpy
0,21,25,1,47,0.447,22,0.468,1,2,0.333,1,2,31,16,9,17,21,0.191,0.362,0.447,17.554,83,riffle_clumpy
0,20,18,6,44,0.455,26,0.591,2,2,0.5,2,3,26,18,9,16,19,0.205,0.364,0.432,17.56,84,riffle_clumpy
0,15,24,6,45,0.333,21,0.467,2,0,1.0,1,5,28,17,6,19,20,0.133,0.422,0.444,17.567,85,riffle_clumpy
0,20,21,3,44,0.455,23,0.523,5,1,0.833,4,2,26,18,11,11,22,0.25,0.25,0.5,17.563,86,riffle_clumpy
0,16,22,8,46,0.348,24,0.522,3,4,0.429,3,3,36,10,7,17,22,0.152,0.37,0.478,17.567,87,riffle_clumpy
0,14,27,4,45,0.311,18,0.4,0,3,0.0,0,4,28,17,10,11,24,0.222,0.244,0.533,17.576,88,riffle_clumpy
0,20,21,4,45,0.444,24,0.533,5,2,0.714,2,2,34,11,10,8,27,0.222,0.178,0.6,17.581,89,riffle_clumpy
0,22,22,5,49,0.449,27,0.551,5,2,0.714,1,1,29,20,15,15,19,0.306,0.306,0.388,17.582,90,riffle_clumpy
0,24,18,4,46,0.522,28,0.609,3,2,0.6,1,3,30,16,14,13,19,0.304,0.283,0.413,17.581,91,riffle_clumpy
0,27,20,2,49,0.551,29,0.592,3,3,0.5,4,2,34,15,14,14,21,0.286,0.286,0.429,17.578,92,riffle_clumpy
0,22,19,5,46,0.478,27,0.587,3,6,0.333,2,1,26,20,10,14,22,0.217,0.304,0.478,17.58,93,riffle_clumpy
0,22,16,6,44,0.5,28,0.636,5,1,0.833,1,1,27,17,12,17,15,0.273,0.386,0.341,17.587,94,riffle_clumpy
0,18,25,1,44,0.409,19,0.432,2,0,1.0,1,4,28,16,8,15,21,0.182,0.341,0.477,17.585,95,riffle_clumpy
0,19,26,3,48,0.396,22,0.458,2,1,0.667,2,2,33,15,7,16,25,0.146,0.333,0.521,17.584,96,riffle_clumpy
0,17,22,6,45,0.378,23,0.511,0,4,0.0,2,2,28,17,8,19,18,0.178,0.422,0.4,18.242,1,riffle_clumpy
0,26,17,7,50,0.52,33,0.66,3,5,0.375,2,2,32,18,18,15,17,0.36,0.3,0.34,18.23,2,riffle_clumpy
0,17,32,0,49,0.347,17,0.347,4,3,0.571,2,6,31,18,10,12,27,0.204,0.245,0.551,17.846,3,riffle_clumpy
0,14,26,3,43,0.326,17,0.395,2,5,0.286,1,1,26,17,10,11,22,0.233,0.256,0.512,17.783,4,riffle_clumpy
0,20,19,4,43,0.465,24,0.558,4,2,0.667,2,2,30,13,10,12,21,0.233,0.279,0.488,17.671,5,riffle_clumpy
0,18,23,3,44,0.409,21,0.477,2,4,0.333,3,2,25,19,10,16,18,0.227,0.364,0.409,17.706,6,riffle_clumpy
0,15,22,8,45,0.333,23,0.511,3,3,0.5,1,0,27,18,9,17,19,0.2,0.378,0.422,17.785,7,riffle_clumpy
0,23,23,3,49,0.469,26,0.531,1,5,0.167,0,5,26,23,13,19,17,0.265,0.388,0.347,17.835,8,riffle_clumpy
0,18,23,6,47,0.383,24,0.511,1,4,0.2,2,3,25,22,8,22,17,0.17,0.468,0.362,17.792,9,riffle_clumpy
0,21,19,4,44,0.477,25,0.568,2,1,0.667,2,2,26,18,9,14,21,0.205,0.318,0.477,17.788,10,riffle_clumpy
0,19,21,5,45,0.422,24,0.533,4,2,0.667,3,2,26,19,9,15,21,0.2,0.333,0.467,17.773,11,riffle_clumpy
0,16,20,9,45,0.356,25,0.556,4,2,0.667,3,2,29,16,10,13,22,0.222,0.289,0.489,17.828,12,riffle_clumpy
0,20,18,5,43,0.465,25,0.581,3,0,1.0,0,0,24,19,11,17,15,0.256,0.395,0.349,17.849,13,riffle_clumpy
0,24,14,8,46,0.522,32,0.696,1,3,0.25,2,1,28,18,15,12,19,0.326,0.261,0.413,17.847,14,riffle_clumpy
0,16,26,4,46,0.348,20,0.435,4,2,0.667,2,1,29,17,6,18,22,0.13,0.391,0.478,17.842,15,riffle_clumpy
0,27,17,3,47,0.574,30,0.638,6,1,0.857,3,2,27,20,19,8,20,0.404,0.17,0.426,17.853,16,riffle_clumpy
0,18,23,3,44,0.409,21,0.477,3,3,0.5,2,3,29,15,10,15,19,0.227,0.341,0.432,17.833,17,riffle_clumpy
0,19,24,4,47,0.404,23,0.489,1,4,0.2,2,0,27,20,11,16,20,0.234,0.34,0.426,17.814,18,riffle_clumpy
0,19,23,5,47,0.404,24,0.511,4,1,0.8,1,3,31,16,9,15,23,0.191,0.319,0.489,17.815,19,riffle_clumpy
0,19,23,3,45,0.422,22,0.489,2,5,0.286,2,1,31,14,8,9,28,0.178,0.2,0.622,17.816,20,riffle_clumpy
0,28,16,4,48,0.583,32,0.667,1,3,0.25,5,1,28,20,17,10,21,0.354,0.208,0.438,17.77,21,riffle_clumpy
0,19,22,4,45,0.422,23,0.511,2,4,0.333,2,2,29,16,8,15,22,0.178,0.333,0.489,17.767,22,riffle_clumpy
0,13,27,5,45,0.289,18,0.4,4,1,0.8,2,4,34,11,9,9,27,0.2,0.2,0.6,17.74,23,riffle_clumpy
0,15,24,6,45,0.333,21,0.467,1,4,0.2,1,3,30,15,7,18,20,0.156,0.4,0.444,17.771,24,riffle_clumpy
0,18,20,8,46,0.391,26,0.565,1,3,0.25,2,0,23,23,9,16,21,0.196,0.348,0.457,17.777,25,riffle_clumpy
0,19,21,6,46,0.413,25,0.543,2,2,0.5,3,5,27,19,11,12,23,0.239,0.261,0.5,17.775,26,riffle_clumpy
0,19,19,7,45,0.422,26,0.578,3,1,0.75,1,2,30,15,9,14,22,0.2,0.311,0.489,17.785,27,riffle_clumpy
0,23,18,3,44,0.523,26,0.591,1,1,0.5,2,0,27,17,15,12,17,0.341,0.273,0.386,17.777,28,riffle_clumpy
0,20,21,4,45,0.444,24,0.533,2,0,1.0,0,4,27,18,12,14,19,0.267,0.311,0.422,17.768,29,riffle_clumpy
0,22,18,5,45,0.489,27,0.6,3,5,0.375,2,2,28,17,13,13,19,0.289,0.289,0.422,17.774,30,riffle_clumpy
0,19,24,2,45,0.422,21,0.467,1,3,0.25,3,2,30,15,12,15,18,0.267,0.333,0.4,17.787,31,riffle_clumpy
0,24,18,3,45,0.533,27,0.6,4,2,0.667,1,2,28,17,17,9,19,0.378,0.2,0.422,17.799,32,riffle_clumpy
0,17,26,5,48,0.354,22,0.458,5,3,0.625,1,3,27,21,9,20,19,0.188,0.417,0.396,17.807,33,riffle_clumpy
0,22,23,4,49,0.449,26,0.531,7,2,0.778,1,2,24,25,14,16,19,0.286,0.327,0.388,17.816,34,riffle_clumpy
0,16,21,9,46,0.348,25,0.543,3,5,0.375,1,0,25,21,9,19,18,0.196,0.413,0.391,17.815,35,riffle_clumpy
0,20,21,4,45,0.444,24,0.533,1,3,0.25,4,2,33,12,9,12,24,0.2,0.267,0.533,17.8,36,riffle_clumpy
0,17,24,6,47,0.362,23,0.489,2,4,0.333,1,3,31,16,8,16,23,0.17,0.34,0.489,17.808,37,riffle_clumpy
0,19,24,3,46,0.413,22,0.478,3,2,0.6,0,0,25,21,12,12,22,0.261,0.261,0.478,17.804,38,riffle_clumpy
0,22,14,8,44,0.5,30,0.682,4,3,0.571,0,0,26,18,10,17,17,0.227,0.386,0.386,17.824,39,riffle_clumpy
0,21,19,5,45,0.467,26,0.578,3,2,0.6,3,1,28,17,8,17,20,0.178,0.378,0.444,17.817,40,riffle_clumpy
0,22,22,3,47,0.468,25,0.532,2,0,1.0,6,0,20,27,14,15,18,0.298,0.319,0.383,17.782,41,riffle_clumpy
0,28,17,3,48,0.583,31,0.646,4,3,0.571,3,0,20,28,13,19,16,0.271,0.396,0.333,17.781,42,riffle_clumpy
0,19,24,1,44,0.432,20,0.455,6,3,0.667,0,3,29,15,11,10,23,0.25,0.227,0.523,17.777,43,riffle_clumpy
0,20,22,4,46,0.435,24,0.522,5,0,1.0,2,6,21,25,8,14,24,0.174,0.304,0.522,17.769,44,riffle_clumpy
0,22,21,3,46,0.478,25,0.543,3,1,0.75,3,3,26,20,12,13,21,0.261,0.283,0.457,17.765,45,riffle_clumpy
0,22,22,2,46,0.478,24,0.522,2,2,0.5,5,3,32,14,9,8,29,0.196,0.174,0.63,17.729,46,riffle_clumpy
0,19,21,7,47,0.404,26,0.553,7,8,0.467,1,1,31,16,9,16,22,0.191,0.34,0.468,17.74,47,riffle_clumpy
0,25,15,3,43,0.581,28,0.651,5,3,0.625,2,1,22,21,17,10,16,0.395,0.233,0.372,17.729,48,riffle_clumpy
0,18,19,7,44,0.409,25,0.568,5,2,0.714,2,1,30,14,8,14,22,0.182,0.318,0.5,17.732,49,riffle_clumpy
0,25,15,3,43,0.581,28,0.651,5,2,0.714,1,0,23,20,15,15,13,0.349,0.349,0.302,17.738,50,riffle_clumpy
0,21,18,5,44,0.477,26,0.591,2,1,0.667,2,2,27,17,11,21,12,0.25,0.477,0.273,17.74,51,riffle_clumpy
0,19,22,5,46,0.413,24,0.522,1,5,0.167,3,1,27,19,10,20,16,0.217,0.435,0.348,17.744,52,riffle_clumpy
0,22,16,8,46,0.478,30,0.652,4,2,0.667,3,1,25,21,12,18,16,0.261,0.391,0.348,17.746,53,riffle_clumpy
0,22,19,5,46,0.478,27,0.587,2,2,0.5,6,2,30,16,11,9,26,0.239,0.196,0.565,17.726,54,riffle_clumpy
0,18,28,3,49,0.367,21,0.429,2,3,0.4,2,2,33,16,6,13,30,0.122,0.265,0.612,17.722,55,riffle_clumpy
0,21,24,2,47,0.447,23,0.489,1,1,0.5,1,8,28,19,10,16,21,0.213,0.34,0.447,17.727,56,riffle_clumpy
0,22,20,5,47,0.468,27,0.574,2,2,0.5,3,3,26,21,15,12,20,0.319,0.255,0.426,17.728,57,riffle_clumpy
0,25,18,2,45,0.556,27,0.6,1,2,0.333,1,0,28,17,16,12,17,0.356,0.267,0.378,17.727,58,riffle_clumpy
0,22,20,5,47,0.468,27,0.574,2,3,0.4,1,1,27,20,12,18,17,0.255,0.383,0.362,17.733,59,riffle_clumpy
0,21,22,2,45,0.467,23,0.511,4,1,0.8,3,3,27,18,10,17,18,0.222,0.378,0.4,17.733,60,riffle_clumpy
0,16,25,5,46,0.348,21,0.457,3,1,0.75,0,1,31,15,12,13,21,0.261,0.283,0.457,17.735,61,riffle_clumpy
0,17,22,6,45,0.378,23,0.511,3,2,0.6,2,3,29,16,8,13,24,0.178,0.289,0.533,17.73,62,riffle_clumpy
0,15,26,3,44,0.341,18,0.409,3,1,0.75,2,3,30,14,7,12,25,0.159,0.273,0.568,17.719,63,riffle_clumpy
0,22,19,5,46,0.478,27,0.587,5,2,0.714,4,2,26,20,8,17,21,0.174,0.37,0.457,17.717,64,riffle_clumpy
0,19,21,4,44,0.432,23,0.523,3,2,0.6,1,2,30,14,8,12,24,0.182,0.273,0.545,17.719,65,riffle_clumpy
0,17,26,4,47,0.362,21,0.447,3,5,0.375,4,0,28,19,7,14,26,0.149,0.298,0.553,17.704,66,riffle_clumpy
0,15,24,5,44,0.341,20,0.455,3,1,0.75,4,1,25,19,8,14,22,0.182,0.318,0.5,17.695,67,riffle_clumpy
0,21,18,7,46,0.457,28,0.609,4,0,1.0,3,3,30,16,12,11,23,0.261,0.239,0.5,17.686,68,riffle_clumpy
0,25,24,4,53,0.472,29,0.547,4,0,1.0,1,3,31,22,14,15,24,0.264,0.283,0.453,17.686,69,riffle_clumpy
0,11,27,7,45,0.244,18,0.4,2,1,0.667,1,3,29,16,3,19,23,0.067,0.422,0.511,17.686,70,riffle_clumpy
0,15,25,5,45,0.333,20,0.444,5,0,1.0,2,2,26,19,10,13,22,0.222,0.289,0.489,17.676,71,riffle_clumpy
0,19,26,1,46,0.413,20,0.435,2,1,0.667,1,4,33,13,12,9,25,0.261,0.196,0.543,17.666,72,riffle_clumpy
0,25,22,2,49,0.51,27,0.551,4,3,0.571,2,3,29,20,12,16,21,0.245,0.327,0.429,17.67,73,riffle_clumpy
0,22,16,7,45,0.489,29,0.644,2,0,1.0,1,1,26,19,13,18,14,0.289,0.4,0.311,17.676,74,riffle_clumpy
0,16,28,2,46,0.348,18,0.391,2,3,0.4,1,2,25,21,10,17,19,0.217,0.37,0.413,17.681,75,riffle_clumpy
0,20,25,3,48,0.417,23,0.479,2,5,0.286,5,2,35,13,7,15,26,0.146,0.312,0.542,17.666,76,riffle_clumpy
0,21,23,2,46,0.457,23,0.5,1,2,0.333,3,3,30,16,11,12,23,0.239,0.261,0.5,17.656,77,riffle_clumpy
0,22,20,3,45,0.489,25,0.556,1,3,0.25,4,0,31,14,13,14,18,0.289,0.311,0.4,17.659,78,riffle_clumpy
0,15,25,4,44,0.341,19,0.432,1,2,0.333,4,2,25,19,8,12,24,0.182,0.273,0.545,17.647,79,riffle_clumpy
0,22,21,5,48,0.458,27,0.562,5,2,0.714,3,1,31,17,9,12,27,0.188,0.25,0.562,17.648,80,riffle_clumpy
0,27,16,1,44,0.614,28,0.636,1,3,0.25,2,0,24,20,14,17,13,0.318,0.386,0.295,17.65,81,riffle_clumpy
0,14,29,2,45,0.311,16,0.356,0,4,0.0,0,5,27,18,10,12,23,0.222,0.267,0.511,17.647,82,riffle_clumpy
0,24,16,5,45,0.533,29,0.644,2,1,0.667,2,1,25,20,14,15,16,0.311,0.333,0.356,17.645,83,riffle_clumpy
0,20,19,6,45,0.444,26,0.578,3,3,0.5,2,0,27,18,13,13,19,0.289,0.289,0.422,17.646,84,riffle_clumpy
0,20,21,5,46,0.435,25,0.543,4,2,0.667,2,2,27,19,10,18,18,0.217,0.391,0.391,17.652,85,riffle_clumpy
0,25,17,2,44,0.568,27,0.614,4,2,0.667,2,1,28,16,15,12,17,0.341,0.273,0.386,17.648,86,riffle_clumpy
0,13,32,1,46,0.283,14,0.304,3,1,0.75,1,3,34,12,5,15,26,0.109,0.326,0.565,17.65,87,riffle_clumpy
0,17,30,1,48,0.354,18,0.375,3,4,0.429,0,1,26,22,12,17,19,0.25,0.354,0.396,17.656,88,riffle_clumpy
0,18,23,7,48,0.375,25,0.521,3,2,0.6,2,2,30,18,12,13,23,0.25,0.271,0.479,17.657,89,riffle_clumpy
0,27,13,5,45,0.6,32,0.711,3,3,0.5,2,3,27,18,15,12,18,0.333,0.267,0.4,17.658,90,riffle_clumpy
0,26,15,5,46,0.565,31,0.674,3,5,0.375,4,0,30,16,12,15,19,0.261,0.326,0.413,17.662,91,riffle_clumpy
0,25,20,4,49,0.51,29,0.592,4,1,0.8,1,3,33,16,7,16,26,0.143,0.327,0.531,17.664,92,riffle_clumpy
0,16,26,5,47,0.34,21,0.447,2,2,0.5,4,5,29,18,9,12,26,0.191,0.255,0.553,17.654,93,riffle_clumpy
0,22,16,6,44,0.5,28,0.636,3,4,0.429,2,1,29,15,12,14,18,0.273,0.318,0.409,17.646,94,riffle_clumpy
0,20,21,3,44,0.455,23,0.523,3,0,1.0,1,1,26,18,9,17,18,0.205,0.386,0.409,17.652,95,riffle_clumpy
0,25,17,2,44,0.568,27,0.614,6,1,0.857,3,0,28,16,14,6,24,0.318,0.136,0.545,17.645,96,riffle_clumpy
0,21,21,4,46,0.457,25,0.543,3,3,0.5,6,1,34,12,4,20,22,0.087,0.435,0.478,17.943,1,riffle_clumpy
0,19,22,3,44,0.432,22,0.5,1,1,0.5,1,3,26,18,14,11,19,0.318,0.25,0.432,18.017,2,riffle_clumpy
0,15,23,5,43,0.349,20,0.465,3,2,0.6,2,1,29,14,4,16,23,0.093,0.372,0.535,17.947,3,riffle_clumpy
0,21,25,4,50,0.42,25,0.5,6,2,0.75,3,0,24,26,14,12,24,0.28,0.24,0.48,17.937,4,riffle_clumpy
0,18,23,5,46,0.391,23,0.5,6,1,0.857,1,3,33,13,11,13,22,0.239,0.283,0.478,17.897,5,riffle_clumpy
0,24,20,1,45,0.533,25,0.556,3,3,0.5,4,3,31,14,12,8,25,0.267,0.178,0.556,17.844,6,riffle_clumpy
0,17,24,4,45,0.378,21,0.467,2,2,0.5,0,2,29,16,10,20,15,0.222,0.444,0.333,17.803,7,riffle_clumpy
0,19,23,3,45,0.422,22,0.489,1,2,0.333,2,6,26,19,7,19,19,0.156,0.422,0.422,17.788,8,riffle_clumpy
0,23,17,2,42,0.548,25,0.595,3,1,0.75,2,1,23,19,14,11,17,0.333,0.262,0.405,17.774,9,riffle_clumpy
0,17,25,4,46,0.37,21,0.457,5,0,1.0,4,1,30,16,9,14,23,0.196,0.304,0.5,17.679,10,riffle_clumpy
0,19,23,3,45,0.422,22,0.489,0,3,0.0,4,1,33,12,9,11,25,0.2,0.244,0.556,17.687,11,riffle_clumpy
0,18,26,1,45,0.4,19,0.422,2,4,0.333,1,0,16,29,13,20,12,0.289,0.444,0.267,17.685,12,riffle_clumpy
0,26,15,3,44,0.591,29,0.659,1,3,0.25,2,2,32,12,14,14,16,0.318,0.318,0.364,17.685,13,riffle_clumpy
0,22,16,7,45,0.489,29,0.644,1,2,0.333,3,2,30,15,11,12,22,0.244,0.267,0.489,17.652,14,riffle_clumpy
0,15,23,9,47,0.319,24,0.511,2,1,0.667,1,2,31,16,12,13,22,0.255,0.277,0.468,17.687,15,riffle_clumpy
0,23,15,7,45,0.511,30,0.667,3,1,0.75,2,1,23,22,10,21,14,0.222,0.467,0.311,17.722,16,riffle_clumpy
0,16,26,3,45,0.356,19,0.422,2,2,0.5,1,5,24,21,11,17,17,0.244,0.378,0.378,17.741,17,riffle_clumpy
0,12,29,4,45,0.267,16,0.356,1,2,0.333,2,3,30,15,7,15,23,0.156,0.333,0.511,17.758,18,riffle_clumpy
0,22,17,4,43,0.512,26,0.605,5,4,0.556,0,5,28,15,14,12,17,0.326,0.279,0.395,17.792,19,riffle_clumpy
0,29,13,4,46,0.63,33,0.717,7,2,0.778,3,2,33,13,15,12,19,0.326,0.261,0.413,17.802,20,riffle_clumpy
0,17,22,5,44,0.386,22,0.5,5,1,0.833,0,1,21,23,7,21,16,0.159,0.477,0.364,17.815,21,riffle_clumpy
0,20,21,3,44,0.455,23,0.523,3,1,0.75,1,2,26,18,13,14,17,0.295,0.318,0.386,17.826,22,riffle_clumpy
0,18,22,3,43,0.419,21,0.488,4,2,0.667,2,3,27,16,10,14,19,0.233,0.326,0.442,17.819,23,riffle_clumpy
0,19,19,4,42,0.452,23,0.548,1,4,0.2,1,1,21,21,12,18,12,0.286,0.429,0.286,17.815,24,riffle_clumpy
0,19,19,7,45,0.422,26,0.578,3,1,0.75,1,1,30,15,12,16,17,0.267,0.356,0.378,17.768,25,riffle_clumpy
0,22,22,3,47,0.468,25,0.532,1,3,0.25,4,3,28,19,9,13,25,0.191,0.277,0.532,17.768,26,riffle_clumpy
0,17,23,4,44,0.386,21,0.477,1,2,0.333,1,3,25,19,9,13,22,0.205,0.295,0.5,17.751,27,riffle_clumpy
0,21,24,4,49,0.429,25,0.51,1,2,0.333,1,5,33,16,10,17,22,0.204,0.347,0.449,17.755,28,riffle_clumpy
0,28,17,3,48,0.583,31,0.646,6,1,0.857,4,0,28,20,17,10,21,0.354,0.208,0.438,17.745,29,riffle_clumpy
0,21,19,3,43,0.488,24,0.558,3,1,0.75,3,1,21,22,13,16,14,0.302,0.372,0.326,17.735,30,riffle_clumpy
0,21,17,8,46,0.457,29,0.63,2,3,0.4,2,1,33,13,7,13,26,0.152,0.283,0.565,17.725,31,riffle_clumpy
0,17,20,8,45,0.378,25,0.556,4,3,0.571,0,0,24,21,9,18,18,0.2,0.4,0.4,17.743,32,riffle_clumpy
0,17,23,6,46,0.37,23,0.5,1,3,0.25,1,2,31,15,10,12,24,0.217,0.261,0.522,17.759,33,riffle_clumpy
0,15,25,4,44,0.341,19,0.432,1,3,0.25,3,1,31,13,9,10,25,0.205,0.227,0.568,17.742,34,riffle_clumpy
0,23,18,1,42,0.548,24,0.571,6,2,0.75,4,0,21,21,13,13,16,0.31,0.31,0.381,17.73,35,riffle_clumpy
0,19,20,5,44,0.432,24,0.545,0,2,0.0,1,1,24,20,9,17,18,0.205,0.386,0.409,17.722,36,riffle_clumpy
0,20,20,6,46,0.435,26,0.565,3,1,0.75,3,2,27,19,9,16,21,0.196,0.348,0.457,17.723,37,riffle_clumpy
0,16,21,8,45,0.356,24,0.533,1,2,0.333,3,4,25,20,9,18,18,0.2,0.4,0.4,17.716,38,riffle_clumpy
0,24,18,4,46,0.522,28,0.609,3,0,1.0,1,0,30,16,10,16,20,0.217,0.348,0.435,17.722,39,riffle_clumpy
0,20,24,3,47,0.426,23,0.489,5,3,0.625,2,2,25,22,12,21,14,0.255,0.447,0.298,17.73,40,riffle_clumpy
0,17,24,5,46,0.37,22,0.478,1,1,0.5,4,2,33,13,4,16,26,0.087,0.348,0.565,17.712,41,riffle_clumpy
0,19,23,1,43,0.442,20,0.465,0,3,0.0,0,2,24,19,13,16,14,0.302,0.372,0.326,17.704,42,riffle_clumpy
0,14,26,5,45,0.311,19,0.422,1,2,0.333,3,5,27,18,7,12,26,0.156,0.267,0.578,17.709,43,riffle_clumpy
0,18,24,4,46,0.391,22,0.478,2,1,0.667,1,1,25,21,11,14,21,0.239,0.304,0.457,17.725,44,riffle_clumpy
0,18,21,4,43,0.419,22,0.512,4,1,0.8,1,1,27,16,8,13,22,0.186,0.302,0.512,17.726,45,riffle_clumpy
0,20,18,6,44,0.455,26,0.591,5,1,0.833,2,1,26,18,11,16,17,0.25,0.364,0.386,17.725,46,riffle_clumpy
0,21,23,2,46,0.457,23,0.5,3,1,0.75,3,2,30,16,12,18,16,0.261,0.391,0.348,17.715,47,riffle_clumpy
0,17,25,5,47,0.362,22,0.468,1,0,1.0,2,1,32,15,5,19,23,0.106,0.404,0.489,17.711,48,riffle_clumpy
0,22,17,7,46,0.478,29,0.63,3,1,0.75,4,3,29,17,12,12,22,0.261,0.261,0.478,17.722,49,riffle_clumpy
0,19,24,3,46,0.413,22,0.478,5,7,0.417,1,3,27,19,12,14,20,0.261,0.304,0.435,17.717,50,riffle_clumpy
0,22,23,2,47,0.468,24,0.511,3,0,1.0,2,2,28,19,14,12,21,0.298,0.255,0.447,17.731,51,riffle_clumpy
0,24,20,5,49,0.49,29,0.592,3,1,0.75,5,2,28,21,10,20,19,0.204,0.408,0.388,17.718,52,riffle_clumpy
0,20,20,6,46,0.435,26,0.565,5,3,0.625,3,0,34,12,11,15,20,0.239,0.326,0.435,17.721,53,riffle_clumpy
0,15,30,2,47,0.319,17,0.362,4,4,0.5,4,3,29,18,8,16,23,0.17,0.34,0.489,17.722,54,riffle_clumpy
0,12,28,6,46,0.261,18,0.391,4,2,0.667,1,2,32,14,8,14,24,0.174,0.304,0.522,17.73,55,riffle_clumpy
0,20,22,3,45,0.444,23,0.511,5,4,0.556,0,4,25,20,11,15,19,0.244,0.333,0.422,17.731,56,riffle_clumpy
0,20,20,5,45,0.444,25,0.556,2,4,0.333,4,2,22,23,9,15,21,0.2,0.333,0.467,17.726,57,riffle_clumpy
0,19,24,2,45,0.422,21,0.467,2,1,0.667,1,4,30,15,10,11,24,0.222,0.244,0.533,17.724,58,riffle_clumpy
0,15,24,6,45,0.333,21,0.467,3,4,0.429,0,6,29,16,7,16,22,0.156,0.356,0.489,17.734,59,riffle_clumpy
0,18,24,3,45,0.4,21,0.467,6,2,0.75,1,2,28,17,10,16,19,0.222,0.356,0.422,17.733,60,riffle_clumpy
0,20,21,3,44,0.455,23,0.523,7,0,1.0,1,2,22,22,10,18,16,0.227,0.409,0.364,17.73,61,riffle_clumpy
0,25,21,0,46,0.543,25,0.543,3,3,0.5,3,4,27,19,14,11,21,0.304,0.239,0.457,17.728,62,riffle_clumpy
0,20,18,8,46,0.435,28,0.609,3,4,0.429,1,4,27,19,11,16,19,0.239,0.348,0.413,17.725,63,riffle_clumpy
0,17,26,2,45,0.378,19,0.422,2,2,0.5,2,2,28,17,5,16,24,0.111,0.356,0.533,17.724,64,riffle_clumpy
0,21,23,5,49,0.429,26,0.531,4,2,0.667,3,4,28,21,9,14,26,0.184,0.286,0.531,17.733,65,riffle_clumpy
0,27,15,5,47,0.574,32,0.681,2,0,1.0,4,2,23,24,16,13,18,0.34,0.277,0.383,17.724,66,riffle_clumpy
0,19,19,7,45,0.422,26,0.578,5,2,0.714,0,1,27,18,12,18,15,0.267,0.4,0.333,17.738,67,riffle_clumpy
0,19,18,7,44,0.432,26,0.591,5,4,0.556,1,3,31,13,11,14,19,0.25,0.318,0.432,17.742,68,riffle_clumpy
0,18,23,4,45,0.4,22,0.489,1,4,0.2,1,2,27,18,10,18,17,0.222,0.4,0.378,17.744,69,riffle_clumpy
0,17,22,3,42,0.405,20,0.476,5,0,1.0,0,0,33,9,12,14,16,0.286,0.333,0.381,17.751,70,riffle_clumpy
0,27,17,3,47,0.574,30,0.638,4,2,0.667,5,2,26,21,14,14,19,0.298,0.298,0.404,17.743,71,riffle_clumpy
0,21,21,5,47,0.447,26,0.553,3,3,0.5,1,1,29,18,13,13,21,0.277,0.277,0.447,17.743,72,riffle_clumpy
0,16,23,5,44,0.364,21,0.477,3,1,0.75,1,2,30,14,10,13,21,0.227,0.295,0.477,17.744,73,riffle_clumpy
0,18,22,6,46,0.391,24,0.522,2,2,0.5,1,1,29,17,8,14,24,0.174,0.304,0.522,17.737,74,riffle_clumpy
0,27,17,4,48,0.562,31,0.646,3,5,0.375,2,2,33,15,17,9,22,0.354,0.188,0.458,17.734,75,riffle_clumpy
0,18,21,7,46,0.391,25,0.543,3,0,1.0,2,1,28,18,8,12,26,0.174,0.261,0.565,17.737,76,riffle_clumpy
0,16,28,3,47,0.34,19,0.404,2,2,0.5,1,1,27,20,11,18,18,0.234,0.383,0.383,17.74,77,riffle_clumpy
0,24,18,5,47,0.511,29,0.617,6,1,0.857,1,0,30,17,11,9,27,0.234,0.191,0.574,17.735,78,riffle_clumpy
0,16,24,6,46,0.348,22,0.478,3,3,0.5,1,3,29,17,8,16,22,0.174,0.348,0.478,17.736,79,riffle_clumpy
0,17,20,7,44,0.386,24,0.545,1,3,0.25,1,2,27,17,11,12,21,0.25,0.273,0.477,17.736,80,riffle_clumpy
0,19,19,7,45,0.422,26,0.578,0,5,0.0,6,3,33,12,7,10,28,0.156,0.222,0.622,17.737,81,riffle_clumpy
0,19,23,2,44,0.432,21,0.477,5,1,0.833,1,2,26,18,9,15,20,0.205,0.341,0.455,17.738,82,riffle_clumpy
0,21,18,6,45,0.467,27,0.6,4,1,0.8,0,2,30,15,9,15,21,0.2,0.333,0.467,17.74,83,riffle_clumpy
0,22,21,8,51,0.431,30,0.588,3,4,0.429,3,3,28,23,10,19,22,0.196,0.373,0.431,17.739,84,riffle_clumpy
0,18,21,6,45,0.4,24,0.533,1,0,1.0,5,4,27,18,7,17,21,0.156,0.378,0.467,17.739,85,riffle_clumpy
0,14,30,1,45,0.311,15,0.333,0,3,0.0,1,2,27,18,8,17,20,0.178,0.378,0.444,17.746,86,riffle_clumpy
0,19,23,3,45,0.422,22,0.489,3,6,0.333,3,4,26,19,8,16,21,0.178,0.356,0.467,17.746,87,riffle_clumpy
0,23,17,4,44,0.523,27,0.614,4,1,0.8,4,2,29,15,12,13,19,0.273,0.295,0.432,17.745,88,riffle_clumpy
0,20,27,0,47,0.426,20,0.426,5,2,0.714,0,2,26,21,11,14,22,0.234,0.298,0.468,17.744,89,riffle_clumpy
0,22,17,7,46,0.478,29,0.63,1,0,1.0,0,0,28,18,13,14,19,0.283,0.304,0.413,17.744,90,riffle_clumpy
0,21,22,1,44,0.477,22,0.5,3,1,0.75,3,0,31,13,9,11,24,0.205,0.25,0.545,17.733,91,riffle_clumpy
0,17,22,7,46,0.37,24,0.522,0,3,0.0,5,2,30,16,7,14,25,0.152,0.304,0.543,17.725,92,riffle_clumpy
0,19,26,1,46,0.413,20,0.435,3,3,0.5,3,2,26,20,7,16,23,0.152,0.348,0.5,17.717,93,riffle_clumpy
0,21,18,4,43,0.488,25,0.581,2,2,0.5,2,3,27,16,12,11,20,0.279,0.256,0.465,17.713,94,riffle_clumpy
0,14,30,1,45,0.311,15,0.333,3,0,1.0,3,4,30,15,8,10,27,0.178,0.222,0.6,17.699,95,riffle_clumpy
0,22,19,5,46,0.478,27,0.587,1,2,0.333,3,3,29,17,14,10,22,0.304,0.217,0.478,17.69,96,riffle_clumpy
0,17,27,2,46,0.37,19,0.413,3,0,1.0,2,1,29,17,6,18,22,0.13,0.391,0.478,16.968,1,riffle_clumpy
0,20,16,7,43,0.465,27,0.628,3,1,0.75,0,2,24,19,14,14,15,0.326,0.326,0.349,17.509,2,riffle_clumpy
0,22,18,7,47,0.468,29,0.617,3,2,0.6,5,1,27,20,14,12,21,0.298,0.255,0.447,17.744,3,riffle_clumpy
0,22,22,2,46,0.478,24,0.522,1,1,0.5,2,4,29,17,12,13,21,0.261,0.283,0.457,17.67,4,riffle_clumpy
0,19,20,4,43,0.442,23,0.535,4,2,0.667,2,3,26,17,11,15,17,0.256,0.349,0.395,17.777,5,riffle_clumpy
0,19,25,2,46,0.413,21,0.457,1,0,1.0,1,3,31,15,12,12,22,0.261,0.261,0.478,17.766,6,riffle_clumpy
0,21,17,7,45,0.467,28,0.622,6,1,0.857,2,2,28,17,13,14,18,0.289,0.311,0.4,17.753,7,riffle_clumpy
0,21,21,3,45,0.467,24,0.533,4,1,0.8,3,2,33,12,10,11,24,0.222,0.244,0.533,17.667,8,riffle_clumpy
0,23,20,4,47,0.489,27,0.574,2,1,0.667,2,1,25,22,13,17,17,0.277,0.362,0.362,17.702,9,riffle_clumpy
0,24,14,8,46,0.522,32,0.696,5,1,0.833,6,2,27,19,15,11,20,0.326,0.239,0.435,17.723,10,riffle_clumpy
0,18,21,8,47,0.383,26,0.553,2,4,0.333,2,2,29,18,10,18,19,0.213,0.383,0.404,17.779,11,riffle_clumpy
0,17,23,3,43,0.395,20,0.465,1,1,0.5,0,1,27,16,13,11,19,0.302,0.256,0.442,17.752,12,riffle_clumpy
0,19,22,6,47,0.404,25,0.532,1,2,0.333,0,5,29,18,12,14,21,0.255,0.298,0.447,17.749,13,riffle_clumpy
0,13,29,4,46,0.283,17,0.37,0,3,0.0,0,3,33,13,7,16,23,0.152,0.348,0.5,17.781,14,riffle_clumpy
0,20,23,1,44,0.455,21,0.477,2,3,0.4,2,3,21,23,9,17,18,0.205,0.386,0.409,17.753,15,riffle_clumpy
0,18,23,3,44,0.409,21,0.477,1,1,0.5,1,1,29,15,7,12,25,0.159,0.273,0.568,17.771,16,riffle_clumpy
0,23,20,4,47,0.489,27,0.574,5,0,1.0,1,2,30,17,11,14,22,0.234,0.298,0.468,17.776,17,riffle_clumpy
0,22,17,5,44,0.5,27,0.614,4,1,0.8,2,1,26,18,15,12,17,0.341,0.273,0.386,17.814,18,riffle_clumpy
0,18,24,2,44,0.409,20,0.455,4,1,0.8,2,1,29,15,8,11,25,0.182,0.25,0.568,17.74,19,riffle_clumpy
0,21,20,3,44,0.477,24,0.545,6,1,0.857,1,1,27,17,12,12,20,0.273,0.273,0.455,17.748,20,riffle_clumpy
0,15,27,4,46,0.326,19,0.413,2,2,0.5,2,4,27,19,7,15,24,0.152,0.326,0.522,17.729,21,riffle_clumpy
0,23,22,1,46,0.5,24,0.522,3,1,0.75,2,3,29,17,10,13,23,0.217,0.283,0.5,17.766,22,riffle_clumpy
0,18,20,7,45,0.4,25,0.556,3,0,1.0,3,2,31,14,10,12,23,0.222,0.267,0.511,17.764,23,riffle_clumpy
0,17,26,2,45,0.378,19,0.422,5,4,0.556,1,3,26,19,13,16,16,0.289,0.356,0.356,17.785,24,riffle_clumpy
0,17,24,3,44,0.386,20,0.455,1,2,0.333,3,0,30,14,10,16,18,0.227,0.364,0.409,17.772,25,riffle_clumpy
0,25,19,3,47,0.532,28,0.596,4,1,0.8,3,1,31,16,14,12,21,0.298,0.255,0.447,17.763,26,riffle_clumpy
0,20,20,4,44,0.455,24,0.545,5,1,0.833,2,0,30,14,8,12,24,0.182,0.273,0.545,17.759,27,riffle_clumpy
0,18,23,5,46,0.391,23,0.5,2,5,0.286,3,2,27,19,12,16,18,0.261,0.348,0.391,17.76,28,riffle_clumpy
0,21,20,5,46,0.457,26,0.565,2,2,0.5,6,3,30,16,11,11,24,0.239,0.239,0.522,17.733,29,riffle_clumpy
0,19,22,2,43,0.442,21,0.488,4,1,0.8,0,2,26,17,11,11,21,0.256,0.256,0.488,17.745,30,riffle_clumpy
0,14,25,5,44,0.318,19,0.432,4,3,0.571,3,3,26,18,8,14,22,0.182,0.318,0.5,17.733,31,riffle_clumpy
0,19,23,4,46,0.413,23,0.5,2,3,0.4,1,4,32,14,9,12,25,0.196,0.261,0.543,17.763,32,riffle_clumpy
0,18,24,5,47,0.383,23,0.489,2,3,0.4,2,3,30,17,12,15,20,0.255,0.319,0.426,17.737,33,riffle_clumpy
0,14,21,8,43,0.326,22,0.512,0,2,0.0,1,2,29,14,10,13,20,0.233,0.302,0.465,17.758,34,riffle_clumpy
0,17,21,6,44,0.386,23,0.523,2,5,0.286,0,1,29,15,10,14,20,0.227,0.318,0.455,17.777,35,riffle_clumpy
0,20,18,7,45,0.444,27,0.6,3,1,0.75,2,2,31,14,13,11,21,0.289,0.244,0.467,17.764,36,riffle_clumpy
0,19,28,2,49,0.388,21,0.429,3,2,0.6,3,2,29,20,8,15,26,0.163,0.306,0.531,17.742,37,riffle_clumpy
0,18,21,5,44,0.409,23,0.523,1,2,0.333,2,4,27,17,10,16,18,0.227,0.364,0.409,17.732,38,riffle_clumpy
0,25,19,2,46,0.543,27,0.587,0,2,0.0,2,1,26,20,18,12,16,0.391,0.261,0.348,17.709,39,riffle_clumpy
0,26,15,4,45,0.578,30,0.667,2,1,0.667,3,2,23,22,15,13,17,0.333,0.289,0.378,17.708,40,riffle_clumpy
0,21,20,4,45,0.467,25,0.556,3,4,0.429,1,1,35,10,11,16,18,0.244,0.356,0.4,17.708,41,riffle_clumpy
0,18,24,5,47,0.383,23,0.489,4,2,0.667,1,4,25,22,10,15,22,0.213,0.319,0.468,17.712,42,riffle_clumpy
0,16,26,4,46,0.348,20,0.435,1,6,0.143,1,5,28,18,12,14,20,0.261,0.304,0.435,17.726,43,riffle_clumpy
0,16,27,2,45,0.356,18,0.4,2,4,0.333,1,3,27,18,12,14,19,0.267,0.311,0.422,17.722,44,riffle_clumpy
0,17,25,2,44,0.386,19,0.432,3,1,0.75,1,3,27,17,11,12,21,0.25,0.273,0.477,17.706,45,riffle_clumpy
0,27,15,5,47,0.574,32,0.681,4,1,0.8,4,4,28,19,16,9,22,0.34,0.191,0.468,17.705,46,riffle_clumpy
0,18,22,6,46,0.391,24,0.522,5,4,0.556,1,2,29,17,11,16,19,0.239,0.348,0.413,17.718,47,riffle_clumpy
0,21,19,4,44,0.477,25,0.568,5,3,0.625,4,1,24,20,11,14,19,0.25,0.318,0.432,17.718,48,riffle_clumpy
0,25,19,2,46,0.543,27,0.587,4,1,0.8,4,0,26,20,11,13,22,0.239,0.283,0.478,17.707,49,riffle_clumpy
0,20,24,2,46,0.435,22,0.478,2,2,0.5,1,2,25,21,14,13,19,0.304,0.283,0.413,17.702,50,riffle_clumpy
0,19,24,2,45,0.422,21,0.467,4,0,1.0,2,3,28,17,8,20,17,0.178,0.444,0.378,17.71,51,riffle_clumpy
0,28,19,1,48,0.583,29,0.604,3,2,0.6,5,3,29,19,10,18,20,0.208,0.375,0.417,17.71,52,riffle_clumpy
0,18,26,2,46,0.391,20,0.435,0,3,0.0,0,2,31,15,9,16,21,0.196,0.348,0.457,17.715,53,riffle_clumpy
0,28,17,2,47,0.596,30,0.638,5,3,0.625,1,1,27,20,16,12,19,0.34,0.255,0.404,17.718,54,riffle_clumpy
0,18,20,6,44,0.409,24,0.545,5,2,0.714,3,1,29,15,10,12,22,0.227,0.273,0.5,17.719,55,riffle_clumpy
0,21,20,3,44,0.477,24,0.545,2,2,0.5,0,2,27,17,14,11,19,0.318,0.25,0.432,17.731,56,riffle_clumpy
0,21,17,8,46,0.457,29,0.63,3,1,0.75,4,3,32,14,7,15,24,0.152,0.326,0.522,17.733,57,riffle_clumpy
0,21,20,5,46,0.457,26,0.565,1,1,0.5,1,2,28,18,14,10,22,0.304,0.217,0.478,17.73,58,riffle_clumpy
0,23,19,4,46,0.5,27,0.587,2,2,0.5,3,1,24,22,12,14,20,0.261,0.304,0.435,17.718,59,riffle_clumpy
0,18,22,5,45,0.4,23,0.511,3,1,0.75,3,3,28,17,9,14,22,0.2,0.311,0.489,17.717,60,riffle_clumpy
0,21,19,5,45,0.467,26,0.578,3,1,0.75,3,0,24,21,13,14,18,0.289,0.311,0.4,17.712,61,riffle_clumpy
0,13,26,7,46,0.283,20,0.435,2,2,0.5,1,4,28,18,7,19,20,0.152,0.413,0.435,17.708,62,riffle_clumpy
0,15,26,4,45,0.333,19,0.422,0,2,0.0,2,3,26,19,10,13,22,0.222,0.289,0.489,17.699,63,riffle_clumpy
0,17,24,2,43,0.395,19,0.442,3,4,0.429,1,1,26,17,11,11,21,0.256,0.256,0.488,17.701,64,riffle_clumpy
0,20,21,4,45,0.444,24,0.533,1,3,0.25,4,1,32,13,10,12,23,0.222,0.267,0.511,17.7,65,riffle_clumpy
0,13,27,4,44,0.295,17,0.386,2,3,0.4,0,3,31,13,8,9,27,0.182,0.205,0.614,17.698,66,riffle_clumpy
0,26,17,4,47,0.553,30,0.638,8,1,0.889,6,1,32,15,13,8,26,0.277,0.17,0.553,17.702,67,riffle_clumpy
0,24,20,3,47,0.511,27,0.574,2,1,0.667,3,5,28,19,13,12,22,0.277,0.255,0.468,17.695,68,riffle_clumpy
0,17,24,2,43,0.395,19,0.442,4,1,0.8,1,1,26,17,12,7,24,0.279,0.163,0.558,17.696,69,riffle_clumpy
0,18,26,1,45,0.4,19,0.422,3,3,0.5,2,3,30,15,11,9,25,0.244,0.2,0.556,17.694,70,riffle_clumpy
0,15,24,8,47,0.319,23,0.489,3,2,0.6,1,0,20,27,9,18,20,0.191,0.383,0.426,17.68,71,riffle_clumpy
0,18,24,5,47,0.383,23,0.489,0,3,0.0,3,3,29,18,11,14,22,0.234,0.298,0.468,17.68,72,riffle_clumpy
0,19,20,6,45,0.422,25,0.556,2,0,1.0,3,4,25,20,11,15,19,0.244,0.333,0.422,17.682,73,riffle_clumpy
0,18,21,6,45,0.4,24,0.533,4,5,0.444,2,1,24,21,13,12,20,0.289,0.267,0.444,17.686,74,riffle_clumpy
0,20,23,3,46,0.435,23,0.5,2,2,0.5,0,0,26,20,11,15,20,0.239,0.326,0.435,17.689,75,riffle_clumpy
0,23,19,5,47,0.489,28,0.596,3,1,0.75,1,3,31,16,10,19,18,0.213,0.404,0.383,17.692,76,riffle_clumpy
0,22,20,2,44,0.5,24,0.545,8,2,0.8,1,4,27,17,16,12,16,0.364,0.273,0.364,17.696,77,riffle_clumpy
0,25,19,1,45,0.556,26,0.578,3,1,0.75,1,2,26,19,10,16,19,0.222,0.356,0.422,17.693,78,riffle_clumpy
0,18,20,6,44,0.409,24,0.545,2,0,1.0,3,1,29,15,12,13,19,0.273,0.295,0.432,17.694,79,riffle_clumpy
0,23,17,3,43,0.535,26,0.605,3,2,0.6,2,2,31,12,14,10,19,0.326,0.233,0.442,17.689,80,riffle_clumpy
0,23,18,3,44,0.523,26,0.591,4,3,0.571,2,3,27,17,16,10,18,0.364,0.227,0.409,17.687,81,riffle_clumpy
0,22,22,4,48,0.458,26,0.542,3,1,0.75,5,4,26,22,10,14,24,0.208,0.292,0.5,17.68,82,riffle_clumpy
0,19,19,6,44,0.432,25,0.568,4,1,0.8,2,1,28,16,11,15,18,0.25,0.341,0.409,17.679,83,riffle_clumpy
0,16,23,6,45,0.356,22,0.489,1,3,0.25,3,2,24,21,8,19,18,0.178,0.422,0.4,17.68,84,riffle_clumpy
0,19,25,4,48,0.396,23,0.479,3,2,0.6,5,1,26,22,8,20,20,0.167,0.417,0.417,17.669,85,riffle_clumpy
0,22,21,3,46,0.478,25,0.543,4,0,1.0,1,3,26,20,16,10,20,0.348,0.217,0.435,17.67,86,riffle_clumpy
0,21,21,2,44,0.477,23,0.523,2,0,1.0,3,3,31,13,10,12,22,0.227,0.273,0.5,17.676,87,riffle_clumpy
0,27,13,4,44,0.614,31,0.705,2,0,1.0,4,0,21,23,16,10,18,0.364,0.227,0.409,17.677,88,riffle_clumpy
0,21,21,4,46,0.457,25,0.543,4,2,0.667,2,3,26,20,12,12,22,0.261,0.261,0.478,17.677,89,riffle_clumpy
0,24,17,4,45,0.533,28,0.622,2,2,0.5,3,1,32,13,14,7,24,0.311,0.156,0.533,17.662,90,riffle_clumpy
0,21,17,6,44,0.477,27,0.614,2,3,0.4,3,3,29,15,12,12,20,0.273,0.273,0.455,17.664,91,riffle_clumpy
0,17,23,4,44,0.386,21,0.477,5,2,0.714,1,2,28,16,7,17,20,0.159,0.386,0.455,17.664,92,riffle_clumpy
0,20,19,4,43,0.465,24,0.558,3,4,0.429,3,3,21,22,13,14,16,0.302,0.326,0.372,17.669,93,riffle_clumpy
0,20,21,5,46,0.435,25,0.543,3,4,0.429,3,2,29,17,8,17,21,0.174,0.37,0.457,17.674,94,riffle_clumpy
0,20,22,2,44,0.455,22,0.5,3,3,0.5,4,3,24,20,10,13,21,0.227,0.295,0.477,17.667,95,riffle_clumpy
0,20,22,5,47,0.426,25,0.532,3,1,0.75,2,3,31,16,10,13,24,0.213,0.277,0.511,17.667,96,riffle_clumpy
0,18,20,7,45,0.4,25,0.556,2,2,0.5,2,2,22,23,11,16,18,0.244,0.356,0.4,17.938,1,riffle_clumpy
0,18,20,7,45,0.4,25,0.556,3,2,0.6,3,2,31,14,11,16,18,0.244,0.356,0.4,18.306,2,riffle_clumpy
0,15,24,4,43,0.349,19,0.442,2,3,0.4,2,1,25,18,8,15,20,0.186,0.349,0.465,18.326,3,riffle_clumpy
0,15,28,4,47,0.319,19,0.404,2,1,0.667,2,7,29,18,7,15,25,0.149,0.319,0.532,18.13,4,riffle_clumpy
0,17,25,3,45,0.378,20,0.444,3,4,0.429,2,1,33,12,5,16,24,0.111,0.356,0.533,17.969,5,riffle_clumpy
0,22,19,4,45,0.489,26,0.578,4,2,0.667,4,1,25,20,11,13,21,0.244,0.289,0.467,17.884,6,riffle_clumpy
0,15,23,8,46,0.326,23,0.5,0,2,0.0,3,1,29,17,3,20,23,0.065,0.435,0.5,17.859,7,riffle_clumpy
0,18,23,4,45,0.4,22,0.489,4,3,0.571,0,3,29,16,6,15,24,0.133,0.333,0.533,17.824,8,riffle_clumpy
0,22,21,2,45,0.489,24,0.533,3,2,0.6,2,3,32,13,13,11,21,0.289,0.244,0.467,17.775,9,riffle_clumpy
0,18,25,3,46,0.391,21,0.457,3,3,0.5,1,3,31,15,8,15,23,0.174,0.326,0.5,17.784,10,riffle_clumpy
0,20,23,3,46,0.435,23,0.5,3,7,0.3,3,2,30,16,9,15,22,0.196,0.326,0.478,17.787,11,riffle_clumpy
0,19,23,4,46,0.413,23,0.5,4,4,0.5,5,2,26,20,9,16,21,0.196,0.348,0.457,17.778,12,riffle_clumpy
0,23,23,0,46,0.5,23,0.5,4,2,0.667,4,1,24,22,13,14,19,0.283,0.304,0.413,17.732,13,riffle_clumpy
0,21,21,3,45,0.467,24,0.533,3,4,0.429,3,2,29,16,10,15,20,0.222,0.333,0.444,17.693,14,riffle_clumpy
0,17,24,6,47,0.362,23,0.489,2,2,0.5,0,2,28,19,11,17,19,0.234,0.362,0.404,17.715,15,riffle_clumpy
0,22,22,4,48,0.458,26,0.542,1,1,0.5,3,3,25,23,12,15,21,0.25,0.312,0.438,17.704,16,riffle_clumpy
0,15,25,5,45,0.333,20,0.444,2,2,0.5,2,4,23,22,8,18,19,0.178,0.4,0.422,17.715,17,riffle_clumpy
0,14,26,6,46,0.304,20,0.435,1,5,0.167,3,4,31,15,6,16,24,0.13,0.348,0.522,17.71,18,riffle_clumpy
0,23,21,2,46,0.5,25,0.543,8,1,0.889,3,1,23,23,16,14,16,0.348,0.304,0.348,17.687,19,riffle_clumpy
0,16,25,5,46,0.348,21,0.457,1,1,0.5,2,2,26,20,7,18,21,0.152,0.391,0.457,17.676,20,riffle_clumpy
0,15,27,4,46,0.326,19,0.413,1,0,1.0,1,2,23,23,9,20,17,0.196,0.435,0.37,17.713,21,riffle_clumpy
0,22,23,2,47,0.468,24,0.511,3,3,0.5,2,7,33,14,10,12,25,0.213,0.255,0.532,17.731,22,riffle_clumpy
0,15,27,7,49,0.306,22,0.449,2,4,0.333,2,2,30,19,6,26,17,0.122,0.531,0.347,17.76,23,riffle_clumpy
0,21,22,4,47,0.447,25,0.532,4,2,0.667,4,4,28,19,14,15,18,0.298,0.319,0.383,17.757,24,riffle_clumpy
0,15,26,5,46,0.326,20,0.435,1,2,0.333,3,3,23,23,6,22,18,0.13,0.478,0.391,17.73,25,riffle_clumpy
0,24,19,3,46,0.522,27,0.587,3,0,1.0,2,1,26,20,13,20,13,0.283,0.435,0.283,17.717,26,riffle_clumpy
0,24,19,6,49,0.49,30,0.612,4,1,0.8,1,3,27,22,15,13,21,0.306,0.265,0.429,17.693,27,riffle_clumpy
0,25,21,3,49,0.51,28,0.571,3,4,0.429,3,4,25,24,15,16,18,0.306,0.327,0.367,17.693,28,riffle_clumpy
0,15,24,5,44,0.341,20,0.455,2,0,1.0,1,3,24,20,8,16,20,0.182,0.364,0.455,17.69,29,riffle_clumpy
0,16,24,7,47,0.34,23,0.489,2,3,0.4,2,0,25,22,10,20,17,0.213,0.426,0.362,17.687,30,riffle_clumpy
0,28,14,2,44,0.636,30,0.682,4,2,0.667,2,1,28,16,14,9,21,0.318,0.205,0.477,17.677,31,riffle_clumpy
0,21,21,4,46,0.457,25,0.543,5,2,0.714,1,5,28,18,12,13,21,0.261,0.283,0.457,17.69,32,riffle_clumpy
0,18,17,8,43,0.419,26,0.605,2,1,0.667,1,1,27,16,10,15,18,0.233,0.349,0.419,17.691,33,riffle_clumpy
0,19,23,4,46,0.413,23,0.5,7,2,0.778,6,0,30,16,9,12,25,0.196,0.261,0.543,17.699,34,riffle_clumpy
0,18,23,4,45,0.4,22,0.489,4,1,0.8,3,4,30,15,6,20,19,0.133,0.444,0.422,17.704,35,riffle_clumpy
0,17,23,3,43,0.395,20,0.465,3,5,0.375,2,0,23,20,9,14,20,0.209,0.326,0.465,17.703,36,riffle_clumpy
0,19,25,1,45,0.422,20,0.444,3,2,0.6,1,2,30,15,12,14,19,0.267,0.311,0.422,17.71,37,riffle_clumpy
0,26,16,4,46,0.565,30,0.652,1,0,1.0,4,2,28,18,15,11,20,0.326,0.239,0.435,17.683,38,riffle_clumpy
0,16,24,5,45,0.356,21,0.467,1,2,0.333,2,2,31,14,9,11,25,0.2,0.244,0.556,17.663,39,riffle_clumpy
0,22,19,4,45,0.489,26,0.578,5,2,0.714,2,2,25,20,13,13,19,0.289,0.289,0.422,17.669,40,riffle_clumpy
0,17,22,4,43,0.395,21,0.488,2,5,0.286,1,1,25,18,8,17,18,0.186,0.395,0.419,17.684,41,riffle_clumpy
0,23,19,5,47,0.489,28,0.596,3,1,0.75,0,2,31,16,10,16,21,0.213,0.34,0.447,17.699,42,riffle_clumpy
0,17,22,5,44,0.386,22,0.5,2,1,0.667,1,3,32,12,11,12,21,0.25,0.273,0.477,17.716,43,riffle_clumpy
0,14,26,7,47,0.298,21,0.447,4,3,0.571,1,3,31,16,5,21,21,0.106,0.447,0.447,17.727,44,riffle_clumpy
0,25,20,2,47,0.532,27,0.574,7,1,0.875,6,0,26,21,8,16,23,0.17,0.34,0.489,17.695,45,riffle_clumpy
0,26,16,5,47,0.553,31,0.66,2,1,0.667,2,4,28,19,13,14,20,0.277,0.298,0.426,17.687,46,riffle_clumpy
0,17,21,6,44,0.386,23,0.523,3,0,1.0,0,3,31,13,6,18,20,0.136,0.409,0.455,17.709,47,riffle_clumpy
0,12,30,2,44,0.273,14,0.318,1,2,0.333,0,6,31,13,7,15,22,0.159,0.341,0.5,17.718,48,riffle_clumpy
0,20,23,5,48,0.417,25,0.521,3,0,1.0,0,2,36,12,15,11,22,0.312,0.229,0.458,17.72,49,riffle_clumpy
0,18,20,8,46,0.391,26,0.565,2,0,1.0,3,1,32,14,5,14,27,0.109,0.304,0.587,17.715,50,riffle_clumpy
0,21,18,5,44,0.477,26,0.591,3,2,0.6,3,1,32,12,13,12,19,0.295,0.273,0.432,17.719,51,riffle_clumpy
0,22,19,4,45,0.489,26,0.578,7,2,0.778,1,2,22,23,13,15,17,0.289,0.333,0.378,17.72,52,riffle_clumpy
0,20,20,5,45,0.444,25,0.556,0,2,0.0,3,1,27,18,10,15,20,0.222,0.333,0.444,17.716,53,riffle_clumpy
0,22,20,2,44,0.5,24,0.545,0,5,0.0,5,1,31,13,9,14,21,0.205,0.318,0.477,17.72,54,riffle_clumpy
0,16,23,5,44,0.364,21,0.477,3,5,0.375,3,1,26,18,8,19,17,0.182,0.432,0.386,17.728,55,riffle_clumpy
0,19,21,5,45,0.422,24,0.533,2,0,1.0,0,0,32,13,12,14,19,0.267,0.311,0.422,17.732,56,riffle_clumpy
0,25,17,3,45,0.556,28,0.622,6,2,0.75,4,1,25,20,13,13,19,0.289,0.289,0.422,17.728,57,riffle_clumpy
0,21,22,4,47,0.447,25,0.532,4,1,0.8,3,2,32,15,15,10,22,0.319,0.213,0.468,17.709,58,riffle_clumpy
0,19,25,2,46,0.413,21,0.457,1,3,0.25,2,3,30,16,10,12,24,0.217,0.261,0.522,17.693,59,riffle_clumpy
0,27,11,5,43,0.628,32,0.744,2,2,0.5,2,1,31,12,13,11,19,0.302,0.256,0.442,17.707,60,riffle_clumpy
0,21,22,3,46,0.457,24,0.522,3,2,0.6,3,4,29,17,12,13,21,0.261,0.283,0.457,17.711,61,riffle_clumpy
0,19,21,5,45,0.422,24,0.533,3,4,0.429,3,2,27,18,9,13,23,0.2,0.289,0.511,17.706,62,riffle_clumpy
0,24,21,4,49,0.49,28,0.571,0,3,0.0,2,2,33,16,13,14,22,0.265,0.286,0.449,17.699,63,riffle_clumpy
0,18,22,4,44,0.409,22,0.5,2,2,0.5,2,2,29,15,12,12,20,0.273,0.273,0.455,17.695,64,riffle_clumpy
0,18,25,4,47,0.383,22,0.468,6,3,0.667,3,1,25,22,6,19,22,0.128,0.404,0.468,17.697,65,riffle_clumpy
0,23,19,7,49,0.469,30,0.612,3,2,0.6,5,2,32,17,11,15,23,0.224,0.306,0.469,17.691,66,riffle_clumpy
0,14,27,5,46,0.304,19,0.413,2,5,0.286,3,4,33,13,5,18,23,0.109,0.391,0.5,17.689,67,riffle_clumpy
0,20,19,7,46,0.435,27,0.587,4,2,0.667,2,4,25,21,13,13,20,0.283,0.283,0.435,17.693,68,riffle_clumpy
0,18,23,2,43,0.419,20,0.465,3,2,0.6,0,2,27,16,14,11,18,0.326,0.256,0.419,17.682,69,riffle_clumpy
0,20,18,5,43,0.465,25,0.581,3,2,0.6,3,0,26,17,12,13,18,0.279,0.302,0.419,17.688,70,riffle_clumpy
0,20,25,4,49,0.408,24,0.49,3,1,0.75,2,0,39,10,14,13,22,0.286,0.265,0.449,17.69,71,riffle_clumpy
0,27,12,4,43,0.628,31,0.721,6,1,0.857,3,0,19,24,21,7,15,0.488,0.163,0.349,17.689,72,riffle_clumpy
0,16,25,3,44,0.364,19,0.432,1,2,0.333,3,0,26,18,9,12,23,0.205,0.273,0.523,17.676,73,riffle_clumpy
0,20,17,6,43,0.465,26,0.605,4,1,0.8,3,0,25,18,9,16,18,0.209,0.372,0.419,17.679,74,riffle_clumpy
0,17,26,4,47,0.362,21,0.447,0,4,0.0,2,3,28,19,8,18,21,0.17,0.383,0.447,17.681,75,riffle_clumpy
0,25,20,1,46,0.543,26,0.565,4,1,0.8,2,3,22,24,14,14,18,0.304,0.304,0.391,17.685,76,riffle_clumpy
0,17,22,6,45,0.378,23,0.511,2,0,1.0,2,2,27,18,7,22,16,0.156,0.489,0.356,17.684,77,riffle_clumpy
0,22,18,6,46,0.478,28,0.609,6,4,0.6,4,1,26,20,11,18,17,0.239,0.391,0.37,17.691,78,riffle_clumpy
0,16,27,6,49,0.327,22,0.449,1,2,0.333,4,4,36,13,8,14,27,0.163,0.286,0.551,17.692,79,riffle_clumpy
0,22,21,4,47,0.468,26,0.553,3,1,0.75,1,5,30,17,16,14,17,0.34,0.298,0.362,17.694,80,riffle_clumpy
0,21,22,7,50,0.42,28,0.56,2,1,0.667,5,1,25,25,8,20,22,0.16,0.4,0.44,17.683,81,riffle_clumpy
0,14,26,5,45,0.311,19,0.422,0,2,0.0,2,3,28,17,9,18,18,0.2,0.4,0.4,17.684,82,riffle_clumpy
0,21,22,4,47,0.447,25,0.532,3,4,0.429,3,1,28,19,6,22,19,0.128,0.468,0.404,17.68,83,riffle_clumpy
0,23,20,2,45,0.511,25,0.556,2,2,0.5,1,3,30,15,17,13,15,0.378,0.289,0.333,17.673,84,riffle_clumpy
0,27,13,4,44,0.614,31,0.705,3,1,0.75,2,2,23,21,19,7,18,0.432,0.159,0.409,17.674,85,riffle_clumpy
0,23,22,1,46,0.5,24,0.522,4,3,0.571,4,1,27,19,12,10,24,0.261,0.217,0.522,17.67,86,riffle_clumpy
0,17,26,1,44,0.386,18,0.409,4,7,0.364,1,2,30,14,11,12,21,0.25,0.273,0.477,17.675,87,riffle_clumpy
0,19,19,5,43,0.442,24,0.558,5,1,0.833,1,0,25,18,11,17,15,0.256,0.395,0.349,17.674,88,riffle_clumpy
0,20,21,4,45,0.444,24,0.533,4,3,0.571,3,1,28,17,9,16,20,0.2,0.356,0.444,17.675,89,riffle_clumpy
0,21,24,1,46,0.457,22,0.478,2,1,0.667,3,5,32,14,10,12,24,0.217,0.261,0.522,17.668,90,riffle_clumpy
0,19,23,4,46,0.413,23,0.5,3,2,0.6,5,1,24,22,7,21,18,0.152,0.457,0.391,17.663,91,riffle_clumpy
0,24,22,0,46,0.522,24,0.522,4,2,0.667,4,3,32,14,14,9,23,0.304,0.196,0.5,17.658,92,riffle_clumpy
0,25,14,4,43,0.581,29,0.674,3,0,1.0,2,0,23,20,15,13,15,0.349,0.302,0.349,17.659,93,riffle_clumpy
0,20,23,3,46,0.435,23,0.5,4,5,0.444,1,1,24,22,13,19,14,0.283,0.413,0.304,17.665,94,riffle_clumpy
0,22,22,3,47,0.468,25,0.532,4,1,0.8,3,4,19,28,14,12,21,0.298,0.255,0.447,17.651,95,riffle_clumpy
0,19,26,1,46,0.413,20,0.435,1,2,0.333,3,6,24,22,12,12,22,0.261,0.261,0.478,17.647,96,riffle_clumpy
0,18,19,5,42,0.429,23,0.548,3,1,0.75,0,1,25,17,13,14,15,0.31,0.333,0.357,18.333,1,riffle_clumpy
0,19,22,4,45,0.422,23,0.511,3,3,0.5,3,4,28,17,7,21,17,0.156,0.467,0.378,18.218,2,riffle_clumpy
0,22,20,3,45,0.489,25,0.556,3,3,0.5,4,2,26,19,11,13,21,0.244,0.289,0.467,17.857,3,riffle_clumpy
0,18,25,2,45,0.4,20,0.444,3,4,0.429,1,4,28,17,13,14,18,0.289,0.311,0.4,17.991,4,riffle_clumpy
0,23,22,2,47,0.489,25,0.532,1,2,0.333,4,2,28,19,12,11,24,0.255,0.234,0.511,17.669,5,riffle_clumpy
0,20,22,5,47,0.426,25,0.532,4,1,0.8,1,3,27,20,10,16,21,0.213,0.34,0.447,17.635,6,riffle_clumpy
0,18,24,4,46,0.391,22,0.478,4,1,0.8,4,1,24,22,10,13,23,0.217,0.283,0.5,17.607,7,riffle_clumpy
0,25,22,1,48,0.521,26,0.542,5,0,1.0,3,3,33,15,9,20,19,0.188,0.417,0.396,17.665,8,riffle_clumpy
0,20,22,5,47,0.426,25,0.532,3,3,0.5,2,4,28,19,15,7,25,0.319,0.149,0.532,17.684,9,riffle_clumpy
0,20,24,2,46,0.435,22,0.478,1,3,0.25,4,1,29,17,10,15,21,0.217,0.326,0.457,17.622,10,riffle_clumpy
0,20,25,4,49,0.408,24,0.49,2,5,0.286,3,2,27,22,11,13,25,0.224,0.265,0.51,17.611,11,riffle_clumpy
0,20,22,3,45,0.444,23,0.511,3,3,0.5,3,1,26,19,10,12,23,0.222,0.267,0.511,17.65,12,riffle_clumpy
0,15,24,5,44,0.341,20,0.455,4,2,0.667,2,1,26,18,10,15,19,0.227,0.341,0.432,17.667,13,riffle_clumpy
0,19,24,4,47,0.404,23,0.489,4,3,0.571,1,1,28,19,11,21,15,0.234,0.447,0.319,17.716,14,riffle_clumpy
0,26,16,2,44,0.591,28,0.636,1,1,0.5,1,4,23,21,15,13,16,0.341,0.295,0.364,17.737,15,riffle_clumpy
0,25,16,4,45,0.556,29,0.644,5,3,0.625,2,3,25,20,18,9,18,0.4,0.2,0.4,17.747,16,riffle_clumpy
0,17,26,3,46,0.37,20,0.435,2,3,0.4,0,6,33,13,10,14,22,0.217,0.304,0.478,17.775,17,riffle_clumpy
0,17,25,4,46,0.37,21,0.457,5,2,0.714,3,2,26,20,11,12,23,0.239,0.261,0.5,17.712,18,riffle_clumpy
0,22,14,7,43,0.512,29,0.674,2,1,0.667,2,2,30,13,12,10,21,0.279,0.233,0.488,17.728,19,riffle_clumpy
0,17,26,1,44,0.386,18,0.409,3,1,0.75,2,3,29,15,10,12,22,0.227,0.273,0.5,17.713,20,riffle_clumpy
0,24,15,8,47,0.511,32,0.681,2,4,0.333,1,1,29,18,10,15,22,0.213,0.319,0.468,17.732,21,riffle_clumpy
0,23,18,6,47,0.489,29,0.617,3,3,0.5,3,2,29,18,13,14,20,0.277,0.298,0.426,17.735,22,riffle_clumpy
0,21,21,5,47,0.447,26,0.553,4,0,1.0,3,0,22,25,9,18,20,0.191,0.383,0.426,17.719,23,riffle_clumpy
0,17,29,1,47,0.362,18,0.383,4,2,0.667,0,5,32,15,10,14,23,0.213,0.298,0.489,17.706,24,riffle_clumpy
0,14,24,6,44,0.318,20,0.455,1,1,0.5,2,1,30,14,9,15,20,0.205,0.341,0.455,17.727,25,riffle_clumpy
0,21,20,5,46,0.457,26,0.565,4,4,0.5,1,1,27,19,16,14,16,0.348,0.304,0.348,17.713,26,riffle_clumpy
0,20,24,3,47,0.426,23,0.489,2,2,0.5,1,4,26,21,13,11,23,0.277,0.234,0.489,17.697,27,riffle_clumpy
0,23,18,5,46,0.5,28,0.609,2,3,0.4,1,2,25,21,14,13,19,0.304,0.283,0.413,17.686,28,riffle_clumpy
0,18,22,5,45,0.4,23,0.511,4,1,0.8,2,1,27,18,13,10,22,0.289,0.222,0.489,17.678,29,riffle_clumpy
0,11,30,5,46,0.239,16,0.348,1,4,0.2,1,3,32,14,5,18,23,0.109,0.391,0.5,17.691,30,riffle_clumpy
0,18,24,4,46,0.391,22,0.478,2,1,0.667,2,3,30,16,8,17,21,0.174,0.37,0.457,17.699,31,riffle_clumpy
0,24,19,2,45,0.533,26,0.578,4,4,0.5,2,3,21,24,15,11,19,0.333,0.244,0.422,17.679,32,riffle_clumpy
0,21,22,2,45,0.467,23,0.511,5,1,0.833,3,4,28,17,11,16,18,0.244,0.356,0.4,17.666,33,riffle_clumpy
0,23,17,6,46,0.5,29,0.63,3,4,0.429,4,1,26,20,13,11,22,0.283,0.239,0.478,17.679,34,riffle_clumpy
0,19,17,7,43,0.442,26,0.605,5,1,0.833,3,2,24,19,12,11,20,0.279,0.256,0.465,17.668,35,riffle_clumpy
0,19,26,1,46,0.413,20,0.435,2,2,0.5,0,4,29,17,12,14,20,0.261,0.304,0.435,17.674,36,riffle_clumpy
0,18,24,3,45,0.4,21,0.467,3,3,0.5,1,2,28,17,12,13,20,0.267,0.289,0.444,17.674,37,riffle_clumpy
0,19,26,1,46,0.413,20,0.435,1,5,0.167,1,1,29,17,16,14,16,0.348,0.304,0.348,17.683,38,riffle_clumpy
0,21,23,1,45,0.467,22,0.489,2,1,0.667,2,2,30,15,8,19,18,0.178,0.422,0.4,17.687,39,riffle_clumpy
0,19,23,4,46,0.413,23,0.5,2,2,0.5,3,3,28,18,12,14,20,0.261,0.304,0.435,17.688,40,riffle_clumpy
0,18,23,6,47,0.383,24,0.511,1,2,0.333,3,4,33,14,11,13,23,0.234,0.277,0.489,17.696,41,riffle_clumpy
0,20,21,7,48,0.417,27,0.562,2,3,0.4,3,3,36,12,10,14,24,0.208,0.292,0.5,17.698,42,riffle_clumpy
0,23,20,3,46,0.5,26,0.565,4,2,0.667,4,2,27,19,11,13,22,0.239,0.283,0.478,17.688,43,riffle_clumpy
0,20,22,4,46,0.435,24,0.522,1,3,0.25,1,3,27,19,8,17,21,0.174,0.37,0.457,17.691,44,riffle_clumpy
0,18,22,6,46,0.391,24,0.522,1,3,0.25,4,0,26,20,10,12,24,0.217,0.261,0.522,17.686,45,riffle_clumpy
0,18,22,5,45,0.4,23,0.511,3,3,0.5,2,5,30,15,9,11,25,0.2,0.244,0.556,17.685,46,riffle_clumpy
0,13,27,4,44,0.295,17,0.386,3,2,0.6,1,0,28,16,9,15,20,0.205,0.341,0.455,17.676,47,riffle_clumpy
0,19,21,5,45,0.422,24,0.533,2,3,0.4,3,1,22,23,13,14,18,0.289,0.311,0.4,17.67,48,riffle_clumpy
0,22,19,4,45,0.489,26,0.578,4,0,1.0,3,4,27,18,9,15,21,0.2,0.333,0.467,17.675,49,riffle_clumpy
0,18,23,3,44,0.409,21,0.477,4,1,0.8,2,2,23,21,9,22,13,0.205,0.5,0.295,17.686,50,riffle_clumpy
0,16,27,3,46,0.348,19,0.413,2,3,0.4,1,2,33,13,7,13,26,0.152,0.283,0.565,17.688,51,riffle_clumpy
0,19,22,4,45,0.422,23,0.511,1,1,0.5,1,3,28,17,12,15,18,0.267,0.333,0.4,17.676,52,riffle_clumpy
0,19,22,2,43,0.442,21,0.488,2,1,0.667,2,2,25,18,10,15,18,0.233,0.349,0.419,17.679,53,riffle_clumpy
0,25,20,1,46,0.543,26,0.565,2,2,0.5,5,1,19,27,16,15,15,0.348,0.326,0.326,17.658,54,riffle_clumpy
0,21,26,2,49,0.429,23,0.469,4,4,0.5,3,2,32,17,12,14,23,0.245,0.286,0.469,17.671,55,riffle_clumpy
0,19,24,2,45,0.422,21,0.467,2,0,1.0,2,0,27,18,9,18,18,0.2,0.4,0.4,17.67,56,riffle_clumpy
0,17,28,2,47,0.362,19,0.404,1,0,1.0,4,3,29,18,9,13,25,0.191,0.277,0.532,17.663,57,riffle_clumpy
0,18,21,5,44,0.409,23,0.523,1,1,0.5,1,1,29,15,9,14,21,0.205,0.318,0.477,17.672,58,riffle_clumpy
0,22,24,1,47,0.468,23,0.489,2,2,0.5,2,4,28,19,8,12,27,0.17,0.255,0.574,17.665,59,riffle_clumpy
0,18,25,2,45,0.4,20,0.444,3,2,0.6,1,2,32,13,9,13,23,0.2,0.289,0.511,17.668,60,riffle_clumpy
0,22,21,6,49,0.449,28,0.571,4,3,0.571,2,1,30,19,12,10,27,0.245,0.204,0.551,17.67,61,riffle_clumpy
0,18,27,2,47,0.383,20,0.426,3,2,0.6,1,3,28,19,10,22,15,0.213,0.468,0.319,17.656,62,riffle_clumpy
0,16,26,4,46,0.348,20,0.435,1,3,0.25,4,4,29,17,6,16,24,0.13,0.348,0.522,17.664,63,riffle_clumpy
0,19,19,6,44,0.432,25,0.568,2,1,0.667,2,4,29,15,13,15,16,0.295,0.341,0.364,17.672,64,riffle_clumpy
0,19,24,2,45,0.422,21,0.467,2,1,0.667,0,3,30,15,13,11,21,0.289,0.244,0.467,17.662,65,riffle_clumpy
0,17,25,3,45,0.378,20,0.444,2,4,0.333,1,3,27,18,6,17,22,0.133,0.378,0.489,17.659,66,riffle_clumpy
0,17,22,5,44,0.386,22,0.5,2,1,0.667,1,2,30,14,11,15,18,0.25,0.341,0.409,17.664,67,riffle_clumpy
0,21,22,1,44,0.477,22,0.5,4,2,0.667,4,2,28,16,13,14,17,0.295,0.318,0.386,17.656,68,riffle_clumpy
0,17,26,4,47,0.362,21,0.447,2,1,0.667,2,1,31,16,7,14,26,0.149,0.298,0.553,17.657,69,riffle_clumpy
0,25,13,4,42,0.595,29,0.69,3,1,0.75,3,2,26,16,12,15,15,0.286,0.357,0.357,17.661,70,riffle_clumpy
0,23,19,3,45,0.511,26,0.578,5,3,0.625,1,2,24,21,10,15,20,0.222,0.333,0.444,17.663,71,riffle_clumpy
0,18,25,2,45,0.4,20,0.444,5,5,0.5,3,4,33,12,8,13,24,0.178,0.289,0.533,17.656,72,riffle_clumpy
0,14,28,6,48,0.292,20,0.417,1,2,0.333,2,1,33,15,5,20,23,0.104,0.417,0.479,17.653,73,riffle_clumpy
0,20,21,6,47,0.426,26,0.553,5,1,0.833,2,2,28,19,7,13,27,0.149,0.277,0.574,17.656,74,riffle_clumpy
0,20,20,3,43,0.465,23,0.535,4,2,0.667,1,2,28,15,8,14,21,0.186,0.326,0.488,17.652,75,riffle_clumpy
0,18,21,6,45,0.4,24,0.533,1,2,0.333,2,0,26,19,9,17,19,0.2,0.378,0.422,17.662,76,riffle_clumpy
0,21,20,5,46,0.457,26,0.565,2,1,0.667,2,0,28,18,11,14,21,0.239,0.304,0.457,17.664,77,riffle_clumpy
0,21,18,4,43,0.488,25,0.581,3,2,0.6,1,1,31,12,13,8,22,0.302,0.186,0.512,17.667,78,riffle_clumpy
0,21,21,3,45,0.467,24,0.533,1,0,1.0,1,1,31,14,10,14,21,0.222,0.311,0.467,17.667,79,riffle_clumpy
0,17,24,4,45,0.378,21,0.467,1,4,0.2,1,1,32,13,8,17,20,0.178,0.378,0.444,17.666,80,riffle_clumpy
0,19,22,4,45,0.422,23,0.511,5,1,0.833,4,4,27,18,11,11,23,0.244,0.244,0.511,17.652,81,riffle_clumpy
0,18,19,7,44,0.409,25,0.568,2,2,0.5,2,2,26,18,10,17,17,0.227,0.386,0.386,17.651,82,riffle_clumpy
0,22,22,4,48,0.458,26,0.542,3,2,0.6,3,3,30,18,11,14,23,0.229,0.292,0.479,17.651,83,riffle_clumpy
0,20,25,2,47,0.426,22,0.468,3,4,0.429,5,2,28,19,9,17,21,0.191,0.362,0.447,17.639,84,riffle_clumpy
0,25,18,3,46,0.543,28,0.609,2,1,0.667,4,4,27,19,12,13,21,0.261,0.283,0.457,17.623,85,riffle_clumpy
0,19,23,5,47,0.404,24,0.511,1,2,0.333,2,1,29,18,9,21,17,0.191,0.447,0.362,17.632,86,riffle_clumpy
0,18,23,4,45,0.4,22,0.489,3,1,0.75,2,5,31,14,13,9,23,0.289,0.2,0.511,17.628,87,riffle_clumpy
0,20,19,4,43,0.465,24,0.558,2,0,1.0,1,2,26,17,14,9,20,0.326,0.209,0.465,17.626,88,riffle_clumpy
0,20,19,6,45,0.444,26,0.578,6,1,0.857,4,1,29,16,7,17,21,0.156,0.378,0.467,17.633,89,riffle_clumpy
0,25,19,0,44,0.568,25,0.568,3,0,1.0,3,1,27,17,15,12,17,0.341,0.273,0.386,17.628,90,riffle_clumpy
0,20,23,3,46,0.435,23,0.5,5,2,0.714,3,1,26,20,11,12,23,0.239,0.261,0.5,17.619,91,riffle_clumpy
0,17,26,4,47,0.362,21,0.447,3,4,0.429,1,5,33,14,10,13,24,0.213,0.277,0.511,17.624,92,riffle_clumpy
0,25,17,3,45,0.556,28,0.622,1,0,1.0,1,2,29,16,14,13,18,0.311,0.289,0.4,17.632,93,riffle_clumpy
0,23,18,5,46,0.5,28,0.609,3,2,0.6,2,2,26,20,11,20,15,0.239,0.435,0.326,17.634,94,riffle_clumpy
0,15,26,4,45,0.333,19,0.422,1,1,0.5,2,1,27,18,9,14,22,0.2,0.311,0.489,17.632,95,riffle_clumpy
0,24,16,4,44,0.545,28,0.636,5,1,0.833,0,2,30,14,11,13,20,0.25,0.295,0.455,17.633,96,riffle_clumpy
0,17,25,3,45,0.378,20,0.444,2,2,0.5,1,1,27,18,10,15,20,0.222,0.333,0.444,17.8,1,riffle_clumpy
0,23,20,4,47,0.489,27,0.574,4,2,0.667,0,0,31,16,11,17,19,0.234,0.362,0.404,18.098,2,riffle_clumpy
0,24,16,6,46,0.522,30,0.652,2,2,0.5,3,2,21,25,16,17,13,0.348,0.37,0.283,17.988,3,riffle_clumpy
0,16,22,7,45,0.356,23,0.511,3,3,0.5,2,0,23,22,9,20,16,0.2,0.444,0.356,18.12,4,riffle_clumpy
0,21,19,4,44,0.477,25,0.568,1,0,1.0,4,4,28,16,13,12,19,0.295,0.273,0.432,18.035,5,riffle_clumpy
0,23,22,3,48,0.479,26,0.542,4,1,0.8,2,2,27,21,15,16,17,0.312,0.333,0.354,18.0,6,riffle_clumpy
0,19,22,3,44,0.432,22,0.5,3,1,0.75,2,2,24,20,12,12,20,0.273,0.273,0.455,17.959,7,riffle_clumpy
0,19,23,4,46,0.413,23,0.5,5,2,0.714,1,4,29,17,13,13,20,0.283,0.283,0.435,17.924,8,riffle_clumpy
0,17,20,9,46,0.37,26,0.565,3,1,0.75,3,1,20,26,9,15,22,0.196,0.326,0.478,17.84,9,riffle_clumpy
0,19,22,5,46,0.413,24,0.522,4,1,0.8,3,4,28,18,8,17,21,0.174,0.37,0.457,17.775,10,riffle_clumpy
0,17,29,1,47,0.362,18,0.383,3,4,0.429,1,2,31,16,9,15,23,0.191,0.319,0.489,17.719,11,riffle_clumpy
0,19,19,6,44,0.432,25,0.568,2,0,1.0,2,4,24,20,12,14,18,0.273,0.318,0.409,17.762,12,riffle_clumpy
0,16,27,3,46,0.348,19,0.413,5,0,1.0,0,3,27,19,8,15,23,0.174,0.326,0.5,17.812,13,riffle_clumpy
0,18,26,5,49,0.367,23,0.469,1,5,0.167,2,3,28,21,11,15,23,0.224,0.306,0.469,17.807,14,riffle_clumpy
0,15,30,2,47,0.319,17,0.362,1,4,0.2,4,2,31,16,6,13,28,0.128,0.277,0.596,17.691,15,riffle_clumpy
0,23,19,3,45,0.511,26,0.578,6,2,0.75,3,1,24,21,14,13,18,0.311,0.289,0.4,17.734,16,riffle_clumpy
0,20,17,6,43,0.465,26,0.605,5,1,0.833,1,4,25,18,13,10,20,0.302,0.233,0.465,17.76,17,riffle_clumpy
0,22,22,1,45,0.489,23,0.511,1,1,0.5,4,0,29,16,11,12,22,0.244,0.267,0.489,17.759,18,riffle_clumpy
0,24,18,1,43,0.558,25,0.581,2,1,0.667,4,1,25,18,16,11,16,0.372,0.256,0.372,17.761,19,riffle_clumpy
0,16,29,2,47,0.34,18,0.383,2,2,0.5,3,4,27,20,9,17,21,0.191,0.362,0.447,17.792,20,riffle_clumpy
0,20,24,2,46,0.435,22,0.478,3,0,1.0,3,4,23,23,11,15,20,0.239,0.326,0.435,17.767,21,riffle_clumpy
0,18,28,0,46,0.391,18,0.391,4,2,0.667,1,5,25,21,10,15,21,0.217,0.326,0.457,17.777,22,riffle_clumpy
0,18,21,6,45,0.4,24,0.533,1,1,0.5,2,0,30,15,9,15,21,0.2,0.333,0.467,17.773,23,riffle_clumpy
0,25,17,5,47,0.532,30,0.638,3,0,1.0,5,2,21,26,12,15,20,0.255,0.319,0.426,17.765,24,riffle_clumpy
0,21,19,4,44,0.477,25,0.568,3,1,0.75,2,1,26,18,12,15,17,0.273,0.341,0.386,17.769,25,riffle_clumpy
0,21,22,2,45,0.467,23,0.511,3,2,0.6,4,2,30,15,11,14,20,0.244,0.311,0.444,17.766,26,riffle_clumpy
0,20,22,2,44,0.455,22,0.5,2,1,0.667,4,2,33,11,9,16,19,0.205,0.364,0.432,17.77,27,riffle_clumpy
0,20,17,10,47,0.426,30,0.638,1,2,0.333,6,2,31,16,11,15,21,0.234,0.319,0.447,17.755,28,riffle_clumpy
0,17,26,1,44,0.386,18,0.409,2,1,0.667,1,1,24,20,13,15,16,0.295,0.341,0.364,17.768,29,riffle_clumpy
0,20,23,2,45,0.444,22,0.489,2,1,0.667,3,2,25,20,13,13,19,0.289,0.289,0.422,17.758,30,riffle_clumpy
0,14,28,5,47,0.298,19,0.404,3,3,0.5,1,2,33,14,9,15,23,0.191,0.319,0.489,17.775,31,riffle_clumpy
0,23,23,2,48,0.479,25,0.521,4,2,0.667,1,2,32,16,9,20,19,0.188,0.417,0.396,17.766,32,riffle_clumpy
0,23,21,2,46,0.5,25,0.543,5,0,1.0,2,1,28,18,15,10,21,0.326,0.217,0.457,17.773,33,riffle_clumpy
0,18,23,7,48,0.375,25,0.521,2,2,0.5,1,1,22,26,14,17,17,0.292,0.354,0.354,17.78,34,riffle_clumpy
0,16,24,4,44,0.364,20,0.455,1,4,0.2,1,4,22,22,11,17,16,0.25,0.386,0.364,17.792,35,riffle_clumpy
0,19,21,5,45,0.422,24,0.533,3,5,0.375,1,2,27,18,5,16,24,0.111,0.356,0.533,17.79,36,riffle_clumpy
0,18,22,4,44,0.409,22,0.5,1,3,0.25,2,1,25,19,8,18,18,0.182,0.409,0.409,17.804,37,riffle_clumpy
0,29,17,1,47,0.617,30,0.638,6,1,0.857,3,3,27,20,13,15,19,0.277,0.319,0.404,17.792,38,riffle_clumpy
0,21,18,5,44,0.477,26,0.591,3,1,0.75,2,2,28,16,14,13,17,0.318,0.295,0.386,17.788,39,riffle_clumpy
0,17,24,5,46,0.37,22,0.478,2,0,1.0,1,4,31,15,10,13,23,0.217,0.283,0.5,17.795,40,riffle_clumpy
0,20,20,4,44,0.455,24,0.545,3,2,0.6,0,2,28,16,14,9,21,0.318,0.205,0.477,17.795,41,riffle_clumpy
0,18,24,3,45,0.4,21,0.467,6,2,0.75,0,1,28,17,9,17,19,0.2,0.378,0.422,17.797,42,riffle_clumpy
0,19,23,4,46,0.413,23,0.5,2,3,0.4,4,0,25,21,10,16,20,0.217,0.348,0.435,17.779,43,riffle_clumpy
0,27,17,4,48,0.562,31,0.646,6,2,0.75,2,3,31,17,17,15,16,0.354,0.312,0.333,17.772,44,riffle_clumpy
0,20,21,4,45,0.444,24,0.533,0,4,0.0,3,3,26,19,10,11,24,0.222,0.244,0.533,17.768,45,riffle_clumpy
0,15,26,5,46,0.326,20,0.435,3,0,1.0,1,4,32,14,6,16,24,0.13,0.348,0.522,17.774,46,riffle_clumpy
0,19,23,3,45,0.422,22,0.489,1,2,0.333,1,2,31,14,7,17,21,0.156,0.378,0.467,17.764,47,riffle_clumpy
0,13,31,4,48,0.271,17,0.354,3,7,0.3,2,2,28,20,6,22,20,0.125,0.458,0.417,17.761,48,riffle_clumpy
0,23,18,3,44,0.523,26,0.591,2,3,0.4,1,2,23,21,9,16,19,0.205,0.364,0.432,17.761,49,riffle_clumpy
0,22,21,3,46,0.478,25,0.543,5,2,0.714,3,2,28,18,10,15,21,0.217,0.326,0.457,17.762,50,riffle_clumpy
0,26,17,2,45,0.578,28,0.622,0,2,0.0,3,1,28,17,15,12,18,0.333,0.267,0.4,17.754,51,riffle_clumpy
0,19,24,1,44,0.432,20,0.455,3,2,0.6,0,2,28,16,11,15,18,0.25,0.341,0.409,17.757,52,riffle_clumpy
0,20,21,3,44,0.455,23,0.523,3,6,0.333,1,0,27,17,9,18,17,0.205,0.409,0.386,17.754,53,riffle_clumpy
0,18,24,3,45,0.4,21,0.467,3,6,0.333,2,3,24,21,6,19,20,0.133,0.422,0.444,17.753,54,riffle_clumpy
0,20,20,3,43,0.465,23,0.535,0,3,0.0,2,1,29,14,12,14,17,0.279,0.326,0.395,17.758,55,riffle_clumpy
0,22,18,6,46,0.478,28,0.609,3,2,0.6,4,0,30,16,9,15,22,0.196,0.326,0.478,17.737,56,riffle_clumpy
0,15,29,3,47,0.319,18,0.383,2,0,1.0,2,4,25,22,10,18,19,0.213,0.383,0.404,17.724,57,riffle_clumpy
0,17,27,1,45,0.378,18,0.4,2,4,0.333,4,4,28,17,6,20,19,0.133,0.444,0.422,17.722,58,riffle_clumpy
0,16,25,6,47,0.34,22,0.468,2,1,0.667,3,0,34,13,7,14,26,0.149,0.298,0.553,17.727,59,riffle_clumpy
0,18,24,4,46,0.391,22,0.478,4,0,1.0,2,1,27,19,6,16,24,0.13,0.348,0.522,17.727,60,riffle_clumpy
0,22,20,3,45,0.489,25,0.556,2,3,0.4,2,1,25,20,14,14,17,0.311,0.311,0.378,17.726,61,riffle_clumpy
0,23,23,0,46,0.5,23,0.5,5,4,0.556,3,2,29,17,12,14,20,0.261,0.304,0.435,17.727,62,riffle_clumpy
0,18,21,5,44,0.409,23,0.523,5,3,0.625,3,3,25,19,13,13,18,0.295,0.295,0.409,17.722,63,riffle_clumpy
0,21,22,2,45,0.467,23,0.511,4,2,0.667,2,6,32,13,11,13,21,0.244,0.289,0.467,17.721,64,riffle_clumpy
0,17,24,4,45,0.378,21,0.467,2,2,0.5,2,2,24,21,9,15,21,0.2,0.333,0.467,17.723,65,riffle_clumpy
0,21,19,5,45,0.467,26,0.578,5,1,0.833,1,2,27,18,11,17,17,0.244,0.378,0.378,17.729,66,riffle_clumpy
0,29,12,3,44,0.659,32,0.727,7,0,1.0,1,0,24,20,19,12,13,0.432,0.273,0.295,17.72,67,riffle_clumpy
0,21,24,1,46,0.457,22,0.478,2,1,0.667,3,3,31,15,9,14,23,0.196,0.304,0.5,17.725,68,riffle_clumpy
0,23,18,5,46,0.5,28,0.609,5,0,1.0,1,2,31,15,11,8,27,0.239,0.174,0.587,17.726,69,riffle_clumpy
0,17,25,2,44,0.386,19,0.432,1,0,1.0,1,2,28,16,8,18,18,0.182,0.409,0.409,17.724,70,riffle_clumpy
0,21,18,4,43,0.488,25,0.581,5,1,0.833,0,3,25,18,16,11,16,0.372,0.256,0.372,17.73,71,riffle_clumpy
0,22,23,2,47,0.468,24,0.511,5,2,0.714,3,4,29,18,11,12,24,0.234,0.255,0.511,17.722,72,riffle_clumpy
0,17,23,4,44,0.386,21,0.477,1,1,0.5,3,4,29,15,10,14,20,0.227,0.318,0.455,17.723,73,riffle_clumpy
0,20,18,8,46,0.435,28,0.609,3,1,0.75,2,3,26,20,13,12,21,0.283,0.261,0.457,17.722,74,riffle_clumpy
0,22,21,4,47,0.468,26,0.553,3,1,0.75,3,2,28,19,12,14,21,0.255,0.298,0.447,17.719,75,riffle_clumpy
0,18,22,5,45,0.4,23,0.511,0,3,0.0,4,3,26,19,9,18,18,0.2,0.4,0.4,17.718,76,riffle_clumpy
0,23,20,1,44,0.523,24,0.545,1,1,0.5,6,1,34,10,12,9,23,0.273,0.205,0.523,17.707,77,riffle_clumpy
0,22,21,5,48,0.458,27,0.562,2,1,0.667,5,1,27,21,10,16,22,0.208,0.333,0.458,17.699,78,riffle_clumpy
0,25,17,3,45,0.556,28,0.622,6,1,0.857,0,2,23,22,14,16,15,0.311,0.356,0.333,17.702,79,riffle_clumpy
0,20,22,7,49,0.408,27,0.551,6,0,1.0,0,4,30,19,14,13,22,0.286,0.265,0.449,17.702,80,riffle_clumpy
0,20,20,6,46,0.435,26,0.565,3,2,0.6,4,2,30,16,9,13,24,0.196,0.283,0.522,17.701,81,riffle_clumpy
0,24,14,5,43,0.558,29,0.674,4,3,0.571,1,2,16,27,15,15,13,0.349,0.349,0.302,17.701,82,riffle_clumpy
0,23,21,2,46,0.5,25,0.543,3,2,0.6,4,2,29,17,12,8,26,0.261,0.174,0.565,17.691,83,riffle_clumpy
0,23,19,4,46,0.5,27,0.587,2,2,0.5,3,2,25,21,10,15,21,0.217,0.326,0.457,17.682,84,riffle_clumpy
0,22,18,4,44,0.5,26,0.591,3,0,1.0,0,1,22,22,12,19,13,0.273,0.432,0.295,17.683,85,riffle_clumpy
0,19,23,3,45,0.422,22,0.489,2,0,1.0,4,1,28,17,8,15,22,0.178,0.333,0.489,17.671,86,riffle_clumpy
0,22,22,2,46,0.478,24,0.522,1,2,0.333,4,2,26,20,10,16,20,0.217,0.348,0.435,17.67,87,riffle_clumpy
0,18,26,1,45,0.4,19,0.422,3,4,0.429,1,3,28,17,11,18,16,0.244,0.4,0.356,17.671,88,riffle_clumpy
0,23,20,2,45,0.511,25,0.556,7,1,0.875,0,2,26,19,13,12,20,0.289,0.267,0.444,17.672,89,riffle_clumpy
0,24,22,1,47,0.511,25,0.532,6,2,0.75,4,4,28,19,11,15,21,0.234,0.319,0.447,17.666,90,riffle_clumpy
0,24,18,5,47,0.511,29,0.617,3,2,0.6,1,2,26,21,11,19,17,0.234,0.404,0.362,17.664,91,riffle_clumpy
0,23,18,4,45,0.511,27,0.6,4,1,0.8,2,2,28,17,14,14,17,0.311,0.311,0.378,17.656,92,riffle_clumpy
0,23,20,4,47,0.489,27,0.574,2,3,0.4,4,2,28,19,10,18,19,0.213,0.383,0.404,17.655,93,riffle_clumpy
0,21,24,1,46,0.457,22,0.478,3,2,0.6,3,1,24,22,10,17,19,0.217,0.37,0.413,17.642,94,riffle_clumpy
0,21,20,4,45,0.467,25,0.556,4,3,0.571,3,2,28,17,10,13,22,0.222,0.289,0.489,17.644,95,riffle_clumpy
0,22,17,4,43,0.512,26,0.605,3,0,1.0,3,3,29,14,12,9,22,0.279,0.209,0.512,17.636,96,riffle_clumpy
0,23,19,2,44,0.523,25,0.568,4,1,0.8,1,3,29,15,12,13,19,0.273,0.295,0.432,17.407,1,riffle_clumpy
0,23,16,5,44,0.523,28,0.636,4,1,0.8,1,1,28,16,15,12,17,0.341,0.273,0.386,17.642,2,riffle_clumpy
0,19,23,3,45,0.422,22,0.489,5,2,0.714,2,2,33,12,6,10,29,0.133,0.222,0.644,17.773,3,riffle_clumpy
0,19,20,6,45,0.422,25,0.556,1,0,1.0,3,2,29,16,8,13,24,0.178,0.289,0.533,17.508,4,riffle_clumpy
0,17,26,2,45,0.378,19,0.422,1,3,0.25,2,1,24,21,8,20,17,0.178,0.444,0.378,17.559,5,riffle_clumpy
0,27,14,6,47,0.574,33,0.702,5,0,1.0,5,1,28,19,12,12,23,0.255,0.255,0.489,17.489,6,riffle_clumpy
0,22,17,7,46,0.478,29,0.63,4,3,0.571,2,2,22,24,14,16,16,0.304,0.348,0.348,17.521,7,riffle_clumpy
0,19,19,7,45,0.422,26,0.578,5,1,0.833,1,3,26,19,14,12,19,0.311,0.267,0.422,17.528,8,riffle_clumpy
0,21,21,2,44,0.477,23,0.523,4,1,0.8,2,1,33,11,11,11,22,0.25,0.25,0.5,17.489,9,riffle_clumpy
0,14,28,3,45,0.311,17,0.378,5,3,0.625,0,1,22,23,7,16,22,0.156,0.356,0.489,17.471,10,riffle_clumpy
0,22,21,3,46,0.478,25,0.543,2,5,0.286,1,0,27,19,14,11,21,0.304,0.239,0.457,17.474,11,riffle_clumpy
0,21,23,3,47,0.447,24,0.511,2,2,0.5,1,2,31,16,13,10,24,0.277,0.213,0.511,17.445,12,riffle_clumpy
0,17,23,3,43,0.395,20,0.465,2,0,1.0,1,3,30,13,13,11,19,0.302,0.256,0.442,17.482,13,riffle_clumpy
0,16,24,5,45,0.356,21,0.467,3,2,0.6,4,4,31,14,7,17,21,0.156,0.378,0.467,17.488,14,riffle_clumpy
0,16,21,8,45,0.356,24,0.533,2,1,0.667,3,0,27,18,8,17,20,0.178,0.378,0.444,17.533,15,riffle_clumpy
0,26,14,5,45,0.578,31,0.689,5,0,1.0,2,2,28,17,16,11,18,0.356,0.244,0.4,17.527,16,riffle_clumpy
0,19,21,3,43,0.442,22,0.512,4,1,0.8,0,2,28,15,9,12,22,0.209,0.279,0.512,17.528,17,riffle_clumpy
0,20,21,4,45,0.444,24,0.533,5,1,0.833,2,3,24,21,13,16,16,0.289,0.356,0.356,17.552,18,riffle_clumpy
0,17,23,5,45,0.378,22,0.489,2,1,0.667,0,1,31,14,6,21,18,0.133,0.467,0.4,17.563,19,riffle_clumpy
0,19,25,3,47,0.404,22,0.468,2,1,0.667,2,3,27,20,14,14,19,0.298,0.298,0.404,17.576,20,riffle_clumpy
0,15,26,4,45,0.333,19,0.422,1,2,0.333,1,0,33,12,7,12,26,0.156,0.267,0.578,17.579,21,riffle_clumpy
0,20,20,4,44,0.455,24,0.545,3,1,0.75,1,1,28,16,12,13,19,0.273,0.295,0.432,17.594,22,riffle_clumpy
0,17,26,2,45,0.378,19,0.422,6,3,0.667,2,5,25,20,11,17,17,0.244,0.378,0.378,17.63,23,riffle_clumpy
0,15,22,8,45,0.333,23,0.511,0,3,0.0,2,2,30,15,5,17,23,0.111,0.378,0.511,17.651,24,riffle_clumpy
0,16,24,5,45,0.356,21,0.467,0,2,0.0,1,4,29,16,12,13,20,0.267,0.289,0.444,17.663,25,riffle_clumpy
0,17,23,4,44,0.386,21,0.477,1,1,0.5,1,2,25,19,8,18,18,0.182,0.409,0.409,17.684,26,riffle_clumpy
0,15,24,4,43,0.349,19,0.442,2,5,0.286,3,1,25,18,5,19,19,0.116,0.442,0.442,17.691,27,riffle_clumpy
0,18,23,4,45,0.4,22,0.489,4,0,1.0,2,4,27,18,10,18,17,0.222,0.4,0.378,17.693,28,riffle_clumpy
0,18,26,3,47,0.383,21,0.447,4,2,0.667,3,4,31,16,11,13,23,0.234,0.277,0.489,17.673,29,riffle_clumpy
0,21,20,3,44,0.477,24,0.545,5,1,0.833,0,1,23,21,14,13,17,0.318,0.295,0.386,17.653,30,riffle_clumpy
0,26,15,4,45,0.578,30,0.667,4,1,0.8,3,1,22,23,16,11,18,0.356,0.244,0.4,17.634,31,riffle_clumpy
0,14,30,3,47,0.298,17,0.362,3,3,0.5,2,5,32,15,11,11,25,0.234,0.234,0.532,17.634,32,riffle_clumpy
0,20,16,6,42,0.476,26,0.619,6,1,0.857,1,2,28,14,10,13,19,0.238,0.31,0.452,17.64,33,riffle_clumpy
0,21,21,8,50,0.42,29,0.58,3,3,0.5,4,3,32,18,10,20,20,0.2,0.4,0.4,17.636,34,riffle_clumpy
0,20,25,1,46,0.435,21,0.457,3,0,1.0,4,2,26,20,11,16,19,0.239,0.348,0.413,17.626,35,riffle_clumpy
0,24,19,0,43,0.558,24,0.558,1,3,0.25,1,1,20,23,17,16,10,0.395,0.372,0.233,17.651,36,riffle_clumpy
0,17,25,3,45,0.378,20,0.444,2,1,0.667,1,5,32,13,11,11,23,0.244,0.244,0.511,17.639,37,riffle_clumpy
0,22,22,5,49,0.449,27,0.551,2,1,0.667,5,0,30,19,8,19,22,0.163,0.388,0.449,17.632,38,riffle_clumpy
0,19,19,5,43,0.442,24,0.558,2,1,0.667,1,1,24,19,11,14,18,0.256,0.326,0.419,17.642,39,riffle_clumpy
0,16,22,5,43,0.372,21,0.488,1,1,0.5,1,1,30,13,5,15,23,0.116,0.349,0.535,17.64,40,riffle_clumpy
0,27,19,3,49,0.551,30,0.612,6,3,0.667,2,1,33,16,14,10,25,0.286,0.204,0.51,17.662,41,riffle_clumpy
0,21,22,6,49,0.429,27,0.551,1,1,0.5,3,3,33,16,10,17,22,0.204,0.347,0.449,17.66,42,riffle_clumpy
0,20,22,4,46,0.435,24,0.522,3,1,0.75,3,0,29,17,7,14,25,0.152,0.304,0.543,17.657,43,riffle_clumpy
0,20,19,6,45,0.444,26,0.578,3,2,0.6,1,4,34,11,8,14,23,0.178,0.311,0.511,17.671,44,riffle_clumpy
0,15,27,5,47,0.319,20,0.426,0,4,0.0,2,1,26,21,8,19,20,0.17,0.404,0.426,17.67,45,riffle_clumpy
0,24,18,5,47,0.511,29,0.617,2,2,0.5,4,3,29,18,13,13,21,0.277,0.277,0.447,17.661,46,riffle_clumpy
0,21,24,1,46,0.457,22,0.478,4,1,0.8,2,1,30,16,7,15,24,0.152,0.326,0.522,17.654,47,riffle_clumpy
0,24,22,3,49,0.49,27,0.551,2,1,0.667,5,4,25,24,11,18,20,0.224,0.367,0.408,17.646,48,riffle_clumpy
0,19,23,5,47,0.404,24,0.511,5,3,0.625,2,2,31,16,11,14,22,0.234,0.298,0.468,17.646,49,riffle_clumpy
0,20,22,3,45,0.444,23,0.511,1,1,0.5,2,5,31,14,8,13,24,0.178,0.289,0.533,17.634,50,riffle_clumpy
0,30,16,3,49,0.612,33,0.673,3,3,0.5,4,1,31,18,11,17,21,0.224,0.347,0.429,17.647,51,riffle_clumpy
0,24,16,4,44,0.545,28,0.636,2,0,1.0,4,0,27,17,12,17,15,0.273,0.386,0.341,17.651,52,riffle_clumpy
0,15,26,5,46,0.326,20,0.435,2,3,0.4,0,5,23,23,12,16,18,0.261,0.348,0.391,17.657,53,riffle_clumpy
0,24,20,3,47,0.511,27,0.574,5,3,0.625,0,2,22,25,15,16,16,0.319,0.34,0.34,17.661,54,riffle_clumpy
0,17,26,1,44,0.386,18,0.409,3,3,0.5,1,1,27,17,12,16,16,0.273,0.364,0.364,17.665,55,riffle_clumpy
0,20,19,6,45,0.444,26,0.578,4,1,0.8,3,3,25,20,10,13,22,0.222,0.289,0.489,17.647,56,riffle_clumpy
0,15,25,4,44,0.341,19,0.432,3,5,0.375,1,3,25,19,11,18,15,0.25,0.409,0.341,17.654,57,riffle_clumpy
0,18,25,3,46,0.391,21,0.457,1,3,0.25,0,2,26,20,9,17,20,0.196,0.37,0.435,17.661,58,riffle_clumpy
0,19,18,7,44,0.432,26,0.591,1,0,1.0,0,1,25,19,8,17,19,0.182,0.386,0.432,17.674,59,riffle_clumpy
0,14,29,3,46,0.304,17,0.37,2,2,0.5,0,4,29,17,5,18,23,0.109,0.391,0.5,17.682,60,riffle_clumpy
0,17,24,5,46,0.37,22,0.478,2,1,0.667,3,7,30,16,6,17,23,0.13,0.37,0.5,17.692,61,riffle_clumpy
0,15,25,6,46,0.326,21,0.457,2,4,0.333,0,4,28,18,11,20,15,0.239,0.435,0.326,17.707,62,riffle_clumpy
0,20,28,2,50,0.4,22,0.44,3,1,0.75,1,2,29,21,9,22,19,0.18,0.44,0.38,17.714,63,riffle_clumpy
0,18,24,1,43,0.419,19,0.442,7,2,0.778,1,2,26,17,13,10,20,0.302,0.233,0.465,17.716,64,riffle_clumpy
0,25,22,1,48,0.521,26,0.542,8,2,0.8,5,1,27,21,10,18,20,0.208,0.375,0.417,17.716,65,riffle_clumpy
0,14,26,5,45,0.311,19,0.422,2,2,0.5,2,2,27,18,9,12,24,0.2,0.267,0.533,17.709,66,riffle_clumpy
0,17,27,2,46,0.37,19,0.413,1,3,0.25,1,3,28,18,7,22,17,0.152,0.478,0.37,17.711,67,riffle_clumpy
0,21,20,6,47,0.447,27,0.574,2,2,0.5,3,2,32,15,12,12,23,0.255,0.255,0.489,17.707,68,riffle_clumpy
0,16,27,2,45,0.356,18,0.4,0,4,0.0,1,4,27,18,9,17,19,0.2,0.378,0.422,17.714,69,riffle_clumpy
0,19,23,2,44,0.432,21,0.477,1,0,1.0,2,3,35,9,7,12,25,0.159,0.273,0.568,17.708,70,riffle_clumpy
0,18,24,3,45,0.4,21,0.467,6,2,0.75,1,2,26,19,12,15,18,0.267,0.333,0.4,17.711,71,riffle_clumpy
0,13,29,4,46,0.283,17,0.37,4,3,0.571,2,2,30,16,9,15,22,0.196,0.326,0.478,17.718,72,riffle_clumpy
0,25,14,3,42,0.595,28,0.667,2,0,1.0,3,1,29,13,16,7,19,0.381,0.167,0.452,17.713,73,riffle_clumpy
0,23,19,5,47,0.489,28,0.596,1,1,0.5,3,1,26,21,11,18,18,0.234,0.383,0.383,17.716,74,riffle_clumpy
0,21,22,5,48,0.438,26,0.542,2,3,0.4,4,3,28,20,12,12,24,0.25,0.25,0.5,17.716,75,riffle_clumpy
0,23,17,6,46,0.5,29,0.63,0,0,0,3,0,29,17,17,9,20,0.37,0.196,0.435,17.709,76,riffle_clumpy
0,16,23,5,44,0.364,21,0.477,5,3,0.625,2,2,30,14,7,15,22,0.159,0.341,0.5,17.707,77,riffle_clumpy
0,20,21,2,43,0.465,22,0.512,1,3,0.25,1,3,24,19,15,15,13,0.349,0.349,0.302,17.713,78,riffle_clumpy
0,12,29,4,45,0.267,16,0.356,2,2,0.5,2,0,36,9,4,14,27,0.089,0.311,0.6,17.704,79,riffle_clumpy
0,20,21,5,46,0.435,25,0.543,4,2,0.667,4,3,27,19,6,20,20,0.13,0.435,0.435,17.705,80,riffle_clumpy
0,19,22,4,45,0.422,23,0.511,4,3,0.571,2,4,27,18,13,16,16,0.289,0.356,0.356,17.697,81,riffle_clumpy
0,21,20,4,45,0.467,25,0.556,3,1,0.75,4,2,27,18,8,13,24,0.178,0.289,0.533,17.697,82,riffle_clumpy
0,21,23,2,46,0.457,23,0.5,3,1,0.75,2,6,31,15,12,13,21,0.261,0.283,0.457,17.695,83,riffle_clumpy
0,19,23,5,47,0.404,24,0.511,2,5,0.286,4,1,26,21,9,17,21,0.191,0.362,0.447,17.684,84,riffle_clumpy
0,18,21,5,44,0.409,23,0.523,2,3,0.4,4,2,23,21,12,15,17,0.273,0.341,0.386,17.68,85,riffle_clumpy
0,21,18,6,45,0.467,27,0.6,2,1,0.667,2,1,30,15,9,12,24,0.2,0.267,0.533,17.683,86,riffle_clumpy
0,13,30,4,47,0.277,17,0.362,0,3,0.0,2,4,26,21,10,14,23,0.213,0.298,0.489,17.679,87,riffle_clumpy
0,19,22,5,46,0.413,24,0.522,1,2,0.333,2,4,25,21,9,16,21,0.196,0.348,0.457,17.675,88,riffle_clumpy
0,20,21,3,44,0.455,23,0.523,3,1,0.75,1,2,26,18,11,18,15,0.25,0.409,0.341,17.681,89,riffle_clumpy
0,17,22,6,45,0.378,23,0.511,7,1,0.875,0,3,31,14,12,10,23,0.267,0.222,0.511,17.683,90,riffle_clumpy
0,25,14,5,44,0.568,30,0.682,3,1,0.75,2,1,28,16,14,15,15,0.318,0.341,0.341,17.683,91,riffle_clumpy
0,19,24,1,44,0.432,20,0.455,2,2,0.5,2,2,29,15,11,12,21,0.25,0.273,0.477,17.687,92,riffle_clumpy
0,18,21,5,44,0.409,23,0.523,2,2,0.5,1,1,26,18,10,18,16,0.227,0.409,0.364,17.692,93,riffle_clumpy
0,20,23,3,46,0.435,23,0.5,4,2,0.667,3,1,30,16,12,16,18,0.261,0.348,0.391,17.699,94,riffle_clumpy
0,22,18,5,45,0.489,27,0.6,4,3,0.571,4,1,25,20,14,15,16,0.311,0.333,0.356,17.7,95,riffle_clumpy
0,17,28,3,48,0.354,20,0.417,0,2,0.0,2,3,26,22,7,21,20,0.146,0.438,0.417,17.7,96,riffle_clumpy
0,24,21,2,47,0.511,26,0.553,2,1,0.667,4,3,31,16,11,16,20,0.234,0.34,0.426,17.871,1,riffle_clumpy
0,23,21,2,46,0.5,25,0.543,2,5,0.286,2,4,30,16,10,14,22,0.217,0.304,0.478,17.754,2,riffle_clumpy
0,21,19,5,45,0.467,26,0.578,3,1,0.75,3,4,24,21,13,13,19,0.289,0.289,0.422,17.471,3,riffle_clumpy
0,18,25,1,44,0.409,19,0.432,6,0,1.0,3,1,29,15,8,14,22,0.182,0.318,0.5,17.371,4,riffle_clumpy
0,21,24,2,47,0.447,23,0.489,3,2,0.6,1,2,33,14,12,11,24,0.255,0.234,0.511,17.473,5,riffle_clumpy
0,19,23,5,47,0.404,24,0.511,0,0,0,3,6,27,20,9,16,22,0.191,0.34,0.468,17.379,6,riffle_clumpy
0,18,27,4,49,0.367,22,0.449,2,8,0.2,1,1,35,14,9,17,23,0.184,0.347,0.469,17.488,7,riffle_clumpy
0,17,27,4,48,0.354,21,0.438,5,2,0.714,2,2,26,22,7,20,21,0.146,0.417,0.438,17.489,8,riffle_clumpy
0,29,13,2,44,0.659,31,0.705,5,0,1.0,2,2,21,23,18,11,15,0.409,0.25,0.341,17.535,9,riffle_clumpy
0,17,23,6,46,0.37,23,0.5,3,1,0.75,2,3,30,16,10,12,24,0.217,0.261,0.522,17.531,10,riffle_clumpy
0,16,27,4,47,0.34,20,0.426,3,4,0.429,2,5,30,17,9,14,24,0.191,0.298,0.511,17.545,11,riffle_clumpy
0,19,19,7,45,0.422,26,0.578,5,2,0.714,2,1,25,20,10,18,17,0.222,0.4,0.378,17.584,12,riffle_clumpy
0,17,29,1,47,0.362,18,0.383,4,1,0.8,2,2,26,21,10,18,19,0.213,0.383,0.404,17.592,13,riffle_clumpy
0,18,21,3,42,0.429,21,0.5,2,2,0.5,2,2,24,18,13,12,17,0.31,0.286,0.405,17.618,14,riffle_clumpy
0,15,26,5,46,0.326,20,0.435,2,4,0.333,0,0,23,23,9,21,16,0.196,0.457,0.348,17.656,15,riffle_clumpy
0,21,17,7,45,0.467,28,0.622,3,1,0.75,3,1,25,20,10,17,18,0.222,0.378,0.4,17.676,16,riffle_clumpy
0,22,18,5,45,0.489,27,0.6,2,2,0.5,2,1,28,17,10,14,21,0.222,0.311,0.467,17.646,17,riffle_clumpy
0,15,24,5,44,0.341,20,0.455,3,0,1.0,2,5,27,17,11,12,21,0.25,0.273,0.477,17.593,18,riffle_clumpy
0,20,21,4,45,0.444,24,0.533,2,1,0.667,2,1,28,17,10,17,18,0.222,0.378,0.4,17.604,19,riffle_clumpy
0,24,20,3,47,0.511,27,0.574,4,2,0.667,4,2,28,19,11,18,18,0.234,0.383,0.383,17.587,20,riffle_clumpy
0,16,27,5,48,0.333,21,0.438,3,3,0.5,1,2,27,21,12,17,19,0.25,0.354,0.396,17.609,21,riffle_clumpy
0,20,23,4,47,0.426,24,0.511,2,2,0.5,2,1,24,23,11,18,18,0.234,0.383,0.383,17.603,22,riffle_clumpy
0,25,17,2,44,0.568,27,0.614,6,1,0.857,3,1,30,14,16,9,19,0.364,0.205,0.432,17.603,23,riffle_clumpy
0,17,23,6,46,0.37,23,0.5,5,4,0.556,1,3,24,22,8,18,20,0.174,0.391,0.435,17.591,24,riffle_clumpy
0,20,22,4,46,0.435,24,0.522,3,3,0.5,2,0,24,22,10,19,17,0.217,0.413,0.37,17.61,25,riffle_clumpy
0,22,21,3,46,0.478,25,0.543,3,1,0.75,3,0,26,20,13,16,17,0.283,0.348,0.37,17.604,26,riffle_clumpy
0,27,19,1,47,0.574,28,0.596,5,1,0.833,2,1,22,25,15,12,20,0.319,0.255,0.426,17.597,27,riffle_clumpy
0,18,29,1,48,0.375,19,0.396,4,4,0.5,2,3,30,18,12,14,22,0.25,0.292,0.458,17.619,28,riffle_clumpy
0,17,21,4,42,0.405,21,0.5,4,4,0.5,2,1,29,13,10,11,21,0.238,0.262,0.5,17.632,29,riffle_clumpy
0,24,22,1,47,0.511,25,0.532,5,3,0.625,5,0,28,19,13,13,21,0.277,0.277,0.447,17.612,30,riffle_clumpy
0,20,23,4,47,0.426,24,0.511,7,1,0.875,3,5,27,20,16,11,20,0.34,0.234,0.426,17.6,31,riffle_clumpy
0,21,19,6,46,0.457,27,0.587,4,1,0.8,2,3,32,14,12,13,21,0.261,0.283,0.457,17.616,32,riffle_clumpy
0,18,22,7,47,0.383,25,0.532,3,5,0.375,1,3,30,17,11,9,27,0.234,0.191,0.574,17.626,33,riffle_clumpy
0,18,25,1,44,0.409,19,0.432,1,1,0.5,1,3,24,20,14,14,16,0.318,0.318,0.364,17.637,34,riffle_clumpy
0,19,22,4,45,0.422,23,0.511,1,1,0.5,6,2,30,15,9,13,23,0.2,0.289,0.511,17.644,35,riffle_clumpy
0,19,26,1,46,0.413,20,0.435,4,2,0.667,1,4,30,16,8,14,24,0.174,0.304,0.522,17.65,36,riffle_clumpy
0,20,20,6,46,0.435,26,0.565,3,5,0.375,2,4,29,17,10,17,19,0.217,0.37,0.413,17.672,37,riffle_clumpy
0,16,21,8,45,0.356,24,0.533,4,0,1.0,3,3,27,18,8,16,21,0.178,0.356,0.467,17.665,38,riffle_clumpy
0,23,17,5,45,0.511,28,0.622,4,1,0.8,1,2,27,18,13,15,17,0.289,0.333,0.378,17.669,39,riffle_clumpy
0,14,21,9,44,0.318,23,0.523,2,3,0.4,2,1,30,14,9,12,23,0.205,0.273,0.523,17.675,40,riffle_clumpy
0,19,21,5,45,0.422,24,0.533,2,0,1.0,1,2,24,21,8,16,21,0.178,0.356,0.467,17.66,41,riffle_clumpy
0,15,25,5,45,0.333,20,0.444,3,4,0.429,0,5,28,17,9,14,22,0.2,0.311,0.489,17.685,42,riffle_clumpy
0,15,21,6,42,0.357,21,0.5,3,4,0.429,1,0,19,23,7,21,14,0.167,0.5,0.333,17.694,43,riffle_clumpy
0,17,23,3,43,0.395,20,0.465,2,3,0.4,0,2,27,16,5,19,19,0.116,0.442,0.442,17.707,44,riffle_clumpy
0,22,21,2,45,0.489,24,0.533,2,2,0.5,2,0,24,21,13,16,16,0.289,0.356,0.356,17.703,45,riffle_clumpy
0,19,23,4,46,0.413,23,0.5,2,4,0.333,2,1,28,18,9,18,19,0.196,0.391,0.413,17.716,46,riffle_clumpy
0,21,20,5,46,0.457,26,0.565,2,2,0.5,1,3,34,12,16,8,22,0.348,0.174,0.478,17.705,47,riffle_clumpy
0,21,23,3,47,0.447,24,0.511,3,0,1.0,2,2,25,22,12,16,19,0.255,0.34,0.404,17.71,48,riffle_clumpy
0,22,24,0,46,0.478,22,0.478,6,4,0.6,2,1,27,19,11,13,22,0.239,0.283,0.478,17.692,49,riffle_clumpy
0,25,17,6,48,0.521,31,0.646,3,1,0.75,2,2,29,19,13,11,24,0.271,0.229,0.5,17.698,50,riffle_clumpy
0,28,13,5,46,0.609,33,0.717,4,1,0.8,2,2,31,15,15,11,20,0.326,0.239,0.435,17.702,51,riffle_clumpy
0,18,27,4,49,0.367,22,0.449,1,4,0.2,4,2,27,22,8,18,23,0.163,0.367,0.469,17.704,52,riffle_clumpy
0,22,21,5,48,0.458,27,0.562,2,1,0.667,2,3,34,14,11,13,24,0.229,0.271,0.5,17.698,53,riffle_clumpy
0,16,21,7,44,0.364,23,0.523,1,3,0.25,1,0,25,19,11,17,16,0.25,0.386,0.364,17.702,54,riffle_clumpy
0,21,21,3,45,0.467,24,0.533,3,0,1.0,1,4,28,17,9,12,24,0.2,0.267,0.533,17.696,55,riffle_clumpy
0,20,21,3,44,0.455,23,0.523,5,1,0.833,3,3,22,22,10,15,19,0.227,0.341,0.432,17.696,56,riffle_clumpy
0,24,19,3,46,0.522,27,0.587,5,2,0.714,5,3,31,15,12,14,20,0.261,0.304,0.435,17.689,57,riffle_clumpy
0,19,23,1,43,0.442,20,0.465,3,0,1.0,1,2,31,12,10,12,21,0.233,0.279,0.488,17.69,58,riffle_clumpy
0,23,19,6,48,0.479,29,0.604,3,2,0.6,4,3,28,20,14,15,19,0.292,0.312,0.396,17.69,59,riffle_clumpy
0,22,20,3,45,0.489,25,0.556,2,5,0.286,2,4,26,19,13,14,18,0.289,0.311,0.4,17.685,60,riffle_clumpy
0,20,21,5,46,0.435,25,0.543,3,3,0.5,3,2,27,19,9,16,21,0.196,0.348,0.457,17.685,61,riffle_clumpy
0,22,20,3,45,0.489,25,0.556,5,1,0.833,2,3,29,16,14,14,17,0.311,0.311,0.378,17.696,62,riffle_clumpy
0,18,22,4,44,0.409,22,0.5,4,2,0.667,0,3,27,17,8,17,19,0.182,0.386,0.432,17.702,63,riffle_clumpy
0,13,24,6,43,0.302,19,0.442,0,4,0.0,2,0,28,15,7,16,20,0.163,0.372,0.465,17.717,64,riffle_clumpy
0,17,24,4,45,0.378,21,0.467,2,3,0.4,1,1,26,19,9,18,18,0.2,0.4,0.4,17.727,65,riffle_clumpy
0,22,19,4,45,0.489,26,0.578,0,0,0,1,1,33,12,11,16,18,0.244,0.356,0.4,17.724,66,riffle_clumpy
0,22,20,4,46,0.478,26,0.565,4,2,0.667,1,0,27,19,14,16,16,0.304,0.348,0.348,17.728,67,riffle_clumpy
0,23,17,3,43,0.535,26,0.605,8,3,0.727,3,1,27,16,14,11,18,0.326,0.256,0.419,17.731,68,riffle_clumpy
0,17,22,5,44,0.386,22,0.5,1,3,0.25,2,2,25,19,11,17,16,0.25,0.386,0.364,17.73,69,riffle_clumpy
0,18,24,2,44,0.409,20,0.455,0,3,0.0,3,2,30,14,6,15,23,0.136,0.341,0.523,17.728,70,riffle_clumpy
0,16,21,8,45,0.356,24,0.533,4,1,0.8,1,3,26,19,10,14,21,0.222,0.311,0.467,17.727,71,riffle_clumpy
0,21,19,4,44,0.477,25,0.568,6,4,0.6,3,0,27,17,14,10,20,0.318,0.227,0.455,17.727,72,riffle_clumpy
0,21,21,5,47,0.447,26,0.553,2,1,0.667,1,2,34,13,11,14,22,0.234,0.298,0.468,17.734,73,riffle_clumpy
0,19,21,6,46,0.413,25,0.543,2,1,0.667,2,1,32,14,6,15,25,0.13,0.326,0.543,17.729,74,riffle_clumpy
0,18,23,4,45,0.4,22,0.489,4,4,0.5,2,2,31,14,8,14,23,0.178,0.311,0.511,17.725,75,riffle_clumpy
0,22,14,7,43,0.512,29,0.674,3,1,0.75,0,1,24,19,15,14,14,0.349,0.326,0.326,17.731,76,riffle_clumpy
0,19,21,5,45,0.422,24,0.533,4,5,0.444,3,3,29,16,10,13,22,0.222,0.289,0.489,17.725,77,riffle_clumpy
0,18,24,3,45,0.4,21,0.467,2,0,1.0,3,1,28,17,9,13,23,0.2,0.289,0.511,17.718,78,riffle_clumpy
0,21,21,1,43,0.488,22,0.512,3,3,0.5,1,2,27,16,13,12,18,0.302,0.279,0.419,17.719,79,riffle_clumpy
0,17,22,6,45,0.378,23,0.511,2,1,0.667,1,3,27,18,10,12,23,0.222,0.267,0.511,17.722,80,riffle_clumpy
0,15,22,7,44,0.341,22,0.5,4,2,0.667,1,1,32,12,8,16,20,0.182,0.364,0.455,17.735,81,riffle_clumpy
0,20,25,3,48,0.417,23,0.479,1,2,0.333,3,2,32,16,10,13,25,0.208,0.271,0.521,17.721,82,riffle_clumpy
0,24,23,1,48,0.5,25,0.521,3,4,0.429,1,2,28,20,15,13,20,0.312,0.271,0.417,17.728,83,riffle_clumpy
0,18,22,4,44,0.409,22,0.5,2,3,0.4,1,2,27,17,10,17,17,0.227,0.386,0.386,17.732,84,riffle_clumpy
0,27,13,4,44,0.614,31,0.705,4,0,1.0,2,0,25,19,18,8,18,0.409,0.182,0.409,17.733,85,riffle_clumpy
0,22,20,4,46,0.478,26,0.565,4,3,0.571,1,1,25,21,13,18,15,0.283,0.391,0.326,17.734,86,riffle_clumpy
0,23,19,3,45,0.511,26,0.578,1,2,0.333,2,0,27,18,11,16,18,0.244,0.356,0.4,17.727,87,riffle_clumpy
0,27,18,5,50,0.54,32,0.64,1,0,1.0,2,4,28,22,13,10,27,0.26,0.2,0.54,17.719,88,riffle_clumpy
0,18,23,4,45,0.4,22,0.489,1,0,1.0,2,1,28,17,11,12,22,0.244,0.267,0.489,17.72,89,riffle_clumpy
0,20,23,1,44,0.455,21,0.477,3,2,0.6,1,4,28,16,12,12,20,0.273,0.273,0.455,17.727,90,riffle_clumpy
0,15,25,5,45,0.333,20,0.444,2,2,0.5,0,3,30,15,6,15,24,0.133,0.333,0.533,17.726,91,riffle_clumpy
0,14,23,8,45,0.311,22,0.489,3,1,0.75,1,2,23,22,8,18,19,0.178,0.4,0.422,17.729,92,riffle_clumpy
0,20,18,5,43,0.465,25,0.581,2,6,0.25,5,0,24,19,9,15,19,0.209,0.349,0.442,17.732,93,riffle_clumpy
0,11,29,5,45,0.244,16,0.356,1,3,0.25,1,4,35,10,6,14,25,0.133,0.311,0.556,17.738,94,riffle_clumpy
0,16,27,0,43,0.372,16,0.372,4,0,1.0,0,2,30,13,12,13,18,0.279,0.302,0.419,17.743,95,riffle_clumpy
0,22,19,4,45,0.489,26,0.578,8,0,1.0,1,1,31,14,11,13,21,0.244,0.289,0.467,17.741,96,riffle_clumpy
0,23,22,4,49,0.469,27,0.551,3,3,0.5,1,2,35,14,9,20,20,0.184,0.408,0.408,18.303,1,riffle_clumpy
0,15,24,7,46,0.326,22,0.478,2,1,0.667,0,3,31,15,13,13,20,0.283,0.283,0.435,17.877,2,riffle_clumpy
0,28,13,2,43,0.651,30,0.698,2,1,0.667,3,1,21,22,15,13,15,0.349,0.302,0.349,17.707,3,riffle_clumpy
0,16,25,3,44,0.364,19,0.432,2,1,0.667,2,3,29,15,6,17,21,0.136,0.386,0.477,17.732,4,riffle_clumpy
0,26,21,4,51,0.51,30,0.588,3,5,0.375,2,2,25,26,14,22,15,0.275,0.431,0.294,17.764,5,riffle_clumpy
0,19,23,1,43,0.442,20,0.465,4,2,0.667,3,0,27,16,11,9,23,0.256,0.209,0.535,17.688,6,riffle_clumpy
0,19,26,1,46,0.413,20,0.435,3,4,0.429,1,3,34,12,9,12,25,0.196,0.261,0.543,17.688,7,riffle_clumpy
0,22,21,2,45,0.489,24,0.533,6,2,0.75,1,1,23,22,13,13,19,0.289,0.289,0.422,17.677,8,riffle_clumpy
0,20,22,6,48,0.417,26,0.542,3,3,0.5,2,4,31,17,10,17,21,0.208,0.354,0.438,17.698,9,riffle_clumpy
0,15,26,3,44,0.341,18,0.409,2,1,0.667,0,1,24,20,10,19,15,0.227,0.432,0.341,17.696,10,riffle_clumpy
0,21,21,5,47,0.447,26,0.553,3,3,0.5,2,3,27,20,11,18,18,0.234,0.383,0.383,17.684,11,riffle_clumpy
0,16,24,4,44,0.364,20,0.455,5,4,0.556,0,2,28,16,13,15,16,0.295,0.341,0.364,17.715,12,riffle_clumpy
0,16,26,3,45,0.356,19,0.422,2,3,0.4,2,3,26,19,4,23,18,0.089,0.511,0.4,17.726,13,riffle_clumpy
0,18,23,4,45,0.4,22,0.489,0,2,0.0,3,4,27,18,12,12,21,0.267,0.267,0.467,17.76,14,riffle_clumpy
0,15,26,3,44,0.341,18,0.409,1,2,0.333,1,4,32,12,12,9,23,0.273,0.205,0.523,17.749,15,riffle_clumpy
0,17,25,2,44,0.386,19,0.432,1,2,0.333,1,0,27,17,11,16,17,0.25,0.364,0.386,17.742,16,riffle_clumpy
0,13,28,6,47,0.277,19,0.404,2,3,0.4,2,3,30,17,6,13,28,0.128,0.277,0.596,17.766,17,riffle_clumpy
0,23,23,3,49,0.469,26,0.531,1,1,0.5,5,1,34,15,11,13,25,0.224,0.265,0.51,17.728,18,riffle_clumpy
0,21,21,5,47,0.447,26,0.553,1,1,0.5,1,3,27,20,13,14,20,0.277,0.298,0.426,17.718,19,riffle_clumpy
0,17,25,2,44,0.386,19,0.432,1,1,0.5,1,2,28,16,10,13,21,0.227,0.295,0.477,17.72,20,riffle_clumpy
0,23,17,5,45,0.511,28,0.622,3,2,0.6,1,3,30,15,13,13,19,0.289,0.289,0.422,17.741,21,riffle_clumpy
0,22,20,4,46,0.478,26,0.565,1,2,0.333,3,0,27,19,10,20,16,0.217,0.435,0.348,17.776,22,riffle_clumpy
0,21,21,6,48,0.438,27,0.562,3,5,0.375,2,1,29,19,12,18,18,0.25,0.375,0.375,17.777,23,riffle_clumpy
0,18,26,1,45,0.4,19,0.422,2,3,0.4,2,3,22,23,12,17,16,0.267,0.378,0.356,17.804,24,riffle_clumpy
0,22,22,3,47,0.468,25,0.532,2,0,1.0,4,3,33,14,8,14,25,0.17,0.298,0.532,17.767,25,riffle_clumpy
0,22,20,2,44,0.5,24,0.545,2,1,0.667,2,0,27,17,14,11,19,0.318,0.25,0.432,17.715,26,riffle_clumpy
0,20,24,2,46,0.435,22,0.478,2,2,0.5,2,1,25,21,13,13,20,0.283,0.283,0.435,17.701,27,riffle_clumpy
0,25,21,2,48,0.521,27,0.562,6,4,0.6,6,1,24,24,11,15,22,0.229,0.312,0.458,17.689,28,riffle_clumpy
0,24,20,3,47,0.511,27,0.574,4,3,0.571,2,1,30,17,14,12,21,0.298,0.255,0.447,17.662,29,riffle_clumpy
0,17,26,4,47,0.362,21,0.447,3,2,0.6,2,2,24,23,12,15,20,0.255,0.319,0.426,17.667,30,riffle_clumpy
0,19,21,6,46,0.413,25,0.543,1,1,0.5,3,2,28,18,8,15,23,0.174,0.326,0.5,17.656,31,riffle_clumpy
0,20,25,2,47,0.426,22,0.468,3,3,0.5,2,1,31,16,12,11,24,0.255,0.234,0.511,17.629,32,riffle_clumpy
0,19,21,4,44,0.432,23,0.523,1,3,0.25,2,1,30,14,9,17,18,0.205,0.386,0.409,17.622,33,riffle_clumpy
0,15,27,3,45,0.333,18,0.4,2,3,0.4,4,2,32,13,9,16,20,0.2,0.356,0.444,17.611,34,riffle_clumpy
0,18,24,2,44,0.409,20,0.455,2,5,0.286,3,2,22,22,7,16,21,0.159,0.364,0.477,17.605,35,riffle_clumpy
0,20,22,6,48,0.417,26,0.542,0,1,0.0,2,0,26,22,11,18,19,0.229,0.375,0.396,17.617,36,riffle_clumpy
0,25,18,3,46,0.543,28,0.609,5,2,0.714,4,1,28,18,15,11,20,0.326,0.239,0.435,17.609,37,riffle_clumpy
0,31,11,4,46,0.674,35,0.761,5,0,1.0,6,1,28,18,18,9,19,0.391,0.196,0.413,17.612,38,riffle_clumpy
0,18,24,5,47,0.383,23,0.489,2,5,0.286,1,4,25,22,12,15,20,0.255,0.319,0.426,17.623,39,riffle_clumpy
0,15,25,5,45,0.333,20,0.444,1,4,0.2,0,2,29,16,5,18,22,0.111,0.4,0.489,17.653,40,riffle_clumpy
0,21,22,2,45,0.467,23,0.511,3,1,0.75,1,1,25,20,13,10,22,0.289,0.222,0.489,17.643,41,riffle_clumpy
0,21,21,3,45,0.467,24,0.533,3,3,0.5,1,2,30,15,10,16,19,0.222,0.356,0.422,17.648,42,riffle_clumpy
0,26,17,2,45,0.578,28,0.622,5,1,0.833,2,1,28,17,17,8,20,0.378,0.178,0.444,17.646,43,riffle_clumpy
0,24,19,5,48,0.5,29,0.604,3,3,0.5,2,2,30,18,11,16,21,0.229,0.333,0.438,17.646,44,riffle_clumpy
0,17,28,3,48,0.354,20,0.417,2,7,0.222,2,5,31,17,8,14,26,0.167,0.292,0.542,17.649,45,riffle_clumpy
0,18,26,0,44,0.409,18,0.409,1,4,0.2,1,1,28,16,11,15,18,0.25,0.341,0.409,17.646,46,riffle_clumpy
0,19,20,7,46,0.413,26,0.565,1,0,1.0,1,1,24,22,10,18,18,0.217,0.391,0.391,17.657,47,riffle_clumpy
0,15,26,4,45,0.333,19,0.422,3,2,0.6,0,5,27,18,13,9,23,0.289,0.2,0.511,17.649,48,riffle_clumpy
0,20,23,4,47,0.426,24,0.511,2,6,0.25,2,0,25,22,12,13,22,0.255,0.277,0.468,17.637,49,riffle_clumpy
0,25,18,4,47,0.532,29,0.617,5,1,0.833,5,0,27,20,15,16,16,0.319,0.34,0.34,17.629,50,riffle_clumpy
0,19,22,4,45,0.422,23,0.511,4,5,0.444,2,0,24,21,9,16,20,0.2,0.356,0.444,17.625,51,riffle_clumpy
0,13,25,7,45,0.289,20,0.444,0,2,0.0,2,2,33,12,7,15,23,0.156,0.333,0.511,17.604,52,riffle_clumpy
0,19,22,4,45,0.422,23,0.511,3,1,0.75,0,1,29,16,8,16,21,0.178,0.356,0.467,17.606,53,riffle_clumpy
0,32,16,5,53,0.604,37,0.698,9,3,0.75,1,1,27,26,21,18,14,0.396,0.34,0.264,17.611,54,riffle_clumpy
0,18,24,2,44,0.409,20,0.455,8,5,0.615,1,0,26,18,14,9,21,0.318,0.205,0.477,17.608,55,riffle_clumpy
0,21,20,2,43,0.488,23,0.535,3,1,0.75,2,3,28,15,13,13,17,0.302,0.302,0.395,17.6,56,riffle_clumpy
0,11,33,2,46,0.239,13,0.283,2,0,1.0,2,4,30,16,7,18,21,0.152,0.391,0.457,17.617,57,riffle_clumpy
0,25,17,5,47,0.532,30,0.638,2,0,1.0,2,0,29,18,16,12,19,0.34,0.255,0.404,17.613,58,riffle_clumpy
0,23,18,6,47,0.489,29,0.617,0,1,0.0,2,1,37,10,16,8,23,0.34,0.17,0.489,17.617,59,riffle_clumpy
0,22,20,2,44,0.5,24,0.545,2,2,0.5,3,0,29,15,11,12,21,0.25,0.273,0.477,17.611,60,riffle_clumpy
0,21,21,5,47,0.447,26,0.553,5,4,0.556,1,1,30,17,11,12,24,0.234,0.255,0.511,17.6,61,riffle_clumpy
0,28,13,4,45,0.622,32,0.711,2,2,0.5,3,0,31,14,15,10,20,0.333,0.222,0.444,17.59,62,riffle_clumpy
0,19,22,4,45,0.422,23,0.511,4,2,0.667,2,2,28,17,17,11,17,0.378,0.244,0.378,17.583,63,riffle_clumpy
0,19,22,3,44,0.432,22,0.5,6,0,1.0,2,2,32,12,12,10,22,0.273,0.227,0.5,17.575,64,riffle_clumpy
0,17,26,3,46,0.37,20,0.435,3,4,0.429,1,2,28,18,13,13,20,0.283,0.283,0.435,17.589,65,riffle_clumpy
0,25,21,2,48,0.521,27,0.562,5,1,0.833,2,4,27,21,12,17,19,0.25,0.354,0.396,17.603,66,riffle_clumpy
0,20,22,2,44,0.455,22,0.5,4,0,1.0,4,2,30,14,11,10,23,0.25,0.227,0.523,17.595,67,riffle_clumpy
0,13,25,8,46,0.283,21,0.457,5,3,0.625,1,4,30,16,9,13,24,0.196,0.283,0.522,17.599,68,riffle_clumpy
0,18,24,4,46,0.391,22,0.478,3,3,0.5,2,5,31,15,11,9,26,0.239,0.196,0.565,17.605,69,riffle_clumpy
0,15,26,7,48,0.312,22,0.458,4,3,0.571,1,2,28,20,10,17,21,0.208,0.354,0.438,17.618,70,riffle_clumpy
0,14,27,3,44,0.318,17,0.386,2,3,0.4,1,2,27,17,9,14,21,0.205,0.318,0.477,17.622,71,riffle_clumpy
0,13,29,4,46,0.283,17,0.37,0,3,0.0,1,5,29,17,7,16,23,0.152,0.348,0.5,17.623,72,riffle_clumpy
0,15,24,6,45,0.333,21,0.467,0,2,0.0,1,3,26,19,11,14,20,0.244,0.311,0.444,17.636,73,riffle_clumpy
0,25,19,3,47,0.532,28,0.596,2,3,0.4,5,2,30,17,16,11,20,0.34,0.234,0.426,17.628,74,riffle_clumpy
0,21,19,4,44,0.477,25,0.568,1,3,0.25,4,1,27,17,10,12,22,0.227,0.273,0.5,17.632,75,riffle_clumpy
0,21,23,1,45,0.467,22,0.489,4,2,0.667,1,3,28,17,9,15,21,0.2,0.333,0.467,17.63,76,riffle_clumpy
0,27,16,4,47,0.574,31,0.66,4,0,1.0,4,2,26,21,11,14,22,0.234,0.298,0.468,17.626,77,riffle_clumpy
0,17,24,5,46,0.37,22,0.478,4,3,0.571,2,2,28,18,9,18,19,0.196,0.391,0.413,17.635,78,riffle_clumpy
0,19,22,3,44,0.432,22,0.5,3,2,0.6,3,1,23,21,12,13,19,0.273,0.295,0.432,17.643,79,riffle_clumpy
0,18,24,5,47,0.383,23,0.489,3,8,0.273,1,1,28,19,9,17,21,0.191,0.362,0.447,17.65,80,riffle_clumpy
0,17,26,4,47,0.362,21,0.447,5,2,0.714,3,4,24,23,12,16,19,0.255,0.34,0.404,17.653,81,riffle_clumpy
0,19,19,6,44,0.432,25,0.568,4,1,0.8,3,0,22,22,12,12,20,0.273,0.273,0.455,17.653,82,riffle_clumpy
0,21,21,3,45,0.467,24,0.533,2,2,0.5,1,1,25,20,12,16,17,0.267,0.356,0.378,17.661,83,riffle_clumpy
0,13,29,5,47,0.277,18,0.383,1,2,0.333,0,0,30,17,8,16,23,0.17,0.34,0.489,17.668,84,riffle_clumpy
0,23,18,7,48,0.479,30,0.625,1,0,1.0,3,3,29,19,15,16,17,0.312,0.333,0.354,17.667,85,riffle_clumpy
0,17,26,2,45,0.378,19,0.422,3,2,0.6,1,4,33,12,8,14,23,0.178,0.311,0.511,17.669,86,riffle_clumpy
0,27,19,3,49,0.551,30,0.612,7,2,0.778,4,0,36,13,11,13,25,0.224,0.265,0.51,17.664,87,riffle_clumpy
0,24,20,1,45,0.533,25,0.556,5,2,0.714,3,1,26,19,11,16,18,0.244,0.356,0.4,17.669,88,riffle_clumpy
0,24,16,5,45,0.533,29,0.644,3,1,0.75,1,1,27,18,15,10,20,0.333,0.222,0.444,17.667,89,riffle_clumpy
0,18,24,3,45,0.4,21,0.467,0,2,0.0,1,0,33,12,9,19,17,0.2,0.422,0.378,17.669,90,riffle_clumpy
0,26,17,3,46,0.565,29,0.63,2,5,0.286,1,1,30,16,19,8,19,0.413,0.174,0.413,17.666,91,riffle_clumpy
0,22,20,4,46,0.478,26,0.565,4,4,0.5,2,1,26,20,12,14,20,0.261,0.304,0.435,17.672,92,riffle_clumpy
0,18,24,4,46,0.391,22,0.478,7,3,0.7,3,1,32,14,6,17,23,0.13,0.37,0.5,17.67,93,riffle_clumpy
0,20,26,1,47,0.426,21,0.447,3,6,0.333,2,3,23,24,13,18,16,0.277,0.383,0.34,17.665,94,riffle_clumpy
0,23,18,6,47,0.489,29,0.617,2,0,1.0,5,2,30,17,11,15,21,0.234,0.319,0.447,17.666,95,riffle_clumpy
0,29,17,3,49,0.592,32,0.653,5,1,0.833,3,1,25,24,19,17,13,0.388,0.347,0.265,17.666,96,riffle_clumpy
0,18,21,6,45,0.4,24,0.533,1,4,0.2,1,1,28,17,11,17,17,0.244,0.378,0.378,18.533,1,riffle_clumpy
0,23,15,7,45,0.511,30,0.667,1,2,0.333,1,2,27,18,13,13,19,0.289,0.289,0.422,18.31,2,riffle_clumpy
0,22,20,4,46,0.478,26,0.565,6,2,0.75,4,4,29,17,9,12,25,0.196,0.261,0.543,18.045,3,riffle_clumpy
0,21,19,5,45,0.467,26,0.578,3,0,1.0,3,2,28,17,12,18,15,0.267,0.4,0.333,17.94,4,riffle_clumpy
0,23,17,6,46,0.5,29,0.63,2,2,0.5,1,1,27,19,16,8,22,0.348,0.174,0.478,17.819,5,riffle_clumpy
0,15,27,3,45,0.333,18,0.4,3,3,0.5,1,6,32,13,11,8,26,0.244,0.178,0.578,17.819,6,riffle_clumpy
0,18,22,6,46,0.391,24,0.522,0,2,0.0,4,5,33,13,10,15,21,0.217,0.326,0.457,17.807,7,riffle_clumpy
0,20,21,4,45,0.444,24,0.533,4,5,0.444,3,2,23,22,8,22,15,0.178,0.489,0.333,17.809,8,riffle_clumpy
0,21,19,5,45,0.467,26,0.578,2,2,0.5,1,2,31,14,14,11,20,0.311,0.244,0.444,17.887,9,riffle_clumpy
0,23,20,4,47,0.489,27,0.574,3,2,0.6,3,3,27,20,11,13,23,0.234,0.277,0.489,17.892,10,riffle_clumpy
0,22,22,3,47,0.468,25,0.532,5,2,0.714,3,3,31,16,13,10,24,0.277,0.213,0.511,17.892,11,riffle_clumpy
0,21,20,3,44,0.477,24,0.545,3,3,0.5,4,2,33,11,7,13,24,0.159,0.295,0.545,17.948,12,riffle_clumpy
0,18,22,6,46,0.391,24,0.522,3,2,0.6,3,3,34,12,8,11,27,0.174,0.239,0.587,17.839,13,riffle_clumpy
0,21,25,2,48,0.438,23,0.479,0,1,0.0,2,3,23,25,14,14,20,0.292,0.292,0.417,17.846,14,riffle_clumpy
0,16,24,4,44,0.364,20,0.455,3,2,0.6,2,3,32,12,8,9,27,0.182,0.205,0.614,17.875,15,riffle_clumpy
0,20,21,2,43,0.465,22,0.512,2,1,0.667,4,1,25,18,9,18,16,0.209,0.419,0.372,17.816,16,riffle_clumpy
0,19,19,6,44,0.432,25,0.568,4,2,0.667,0,1,28,16,15,11,18,0.341,0.25,0.409,17.827,17,riffle_clumpy
0,14,24,5,43,0.326,19,0.442,2,5,0.286,0,2,27,16,8,18,17,0.186,0.419,0.395,17.821,18,riffle_clumpy
0,15,25,4,44,0.341,19,0.432,2,0,1.0,4,0,32,12,7,16,21,0.159,0.364,0.477,17.796,19,riffle_clumpy
0,23,16,6,45,0.511,29,0.644,2,3,0.4,0,1,24,21,14,17,14,0.311,0.378,0.311,17.783,20,riffle_clumpy
0,24,16,5,45,0.533,29,0.644,3,4,0.429,4,0,32,13,11,13,21,0.244,0.289,0.467,17.79,21,riffle_clumpy
0,24,19,1,44,0.545,25,0.568,4,0,1.0,4,2,29,15,16,7,21,0.364,0.159,0.477,17.797,22,riffle_clumpy
0,14,28,4,46,0.304,18,0.391,1,4,0.2,0,2,22,24,11,20,15,0.239,0.435,0.326,17.81,23,riffle_clumpy
0,18,19,7,44,0.409,25,0.568,4,1,0.8,4,2,32,12,7,15,22,0.159,0.341,0.5,17.829,24,riffle_clumpy
0,17,26,6,49,0.347,23,0.469,3,6,0.333,3,2,25,24,8,17,24,0.163,0.347,0.49,17.839,25,riffle_clumpy
0,17,25,1,43,0.395,18,0.419,5,1,0.833,2,2,27,16,11,10,22,0.256,0.233,0.512,17.831,26,riffle_clumpy
0,25,16,3,44,0.568,28,0.636,2,0,1.0,5,0,22,22,10,17,17,0.227,0.386,0.386,17.795,27,riffle_clumpy
0,15,25,4,44,0.341,19,0.432,0,2,0.0,3,1,31,13,9,12,23,0.205,0.273,0.523,17.765,28,riffle_clumpy
0,22,20,3,45,0.489,25,0.556,5,3,0.625,4,2,22,23,14,12,19,0.311,0.267,0.422,17.764,29,riffle_clumpy
0,23,21,4,48,0.479,27,0.562,2,1,0.667,2,5,35,13,13,10,25,0.271,0.208,0.521,17.741,30,riffle_clumpy
0,25,16,6,47,0.532,31,0.66,6,5,0.545,2,2,31,16,12,18,17,0.255,0.383,0.362,17.732,31,riffle_clumpy
0,22,18,3,43,0.512,25,0.581,4,0,1.0,0,0,23,20,13,18,12,0.302,0.419,0.279,17.748,32,riffle_clumpy
0,16,29,2,47,0.34,18,0.383,5,2,0.714,2,3,31,16,7,18,22,0.149,0.383,0.468,17.755,33,riffle_clumpy
0,23,17,4,44,0.523,27,0.614,5,3,0.625,2,1,28,16,13,12,19,0.295,0.273,0.432,17.769,34,riffle_clumpy
0,16,24,5,45,0.356,21,0.467,4,2,0.667,3,2,29,16,7,15,23,0.156,0.333,0.511,17.756,35,riffle_clumpy
0,19,21,5,45,0.422,24,0.533,3,3,0.5,1,4,28,17,9,18,18,0.2,0.4,0.4,17.768,36,riffle_clumpy
0,17,20,7,44,0.386,24,0.545,4,2,0.667,1,4,27,17,7,19,18,0.159,0.432,0.409,17.765,37,riffle_clumpy
0,15,26,5,46,0.326,20,0.435,2,1,0.667,0,3,37,9,7,15,24,0.152,0.326,0.522,17.764,38,riffle_clumpy
0,24,19,2,45,0.533,26,0.578,3,1,0.75,3,0,25,20,11,16,18,0.244,0.356,0.4,17.757,39,riffle_clumpy
0,20,25,2,47,0.426,22,0.468,3,4,0.429,3,4,29,18,11,16,20,0.234,0.34,0.426,17.75,40,riffle_clumpy
0,21,20,4,45,0.467,25,0.556,1,1,0.5,1,2,33,12,10,10,25,0.222,0.222,0.556,17.735,41,riffle_clumpy
0,24,20,2,46,0.522,26,0.565,6,2,0.75,3,1,22,24,13,15,18,0.283,0.326,0.391,17.732,42,riffle_clumpy
0,18,24,5,47,0.383,23,0.489,0,6,0.0,3,1,26,21,12,19,16,0.255,0.404,0.34,17.732,43,riffle_clumpy
0,20,22,4,46,0.435,24,0.522,1,3,0.25,3,0,25,21,10,13,23,0.217,0.283,0.5,17.735,44,riffle_clumpy
0,22,26,2,50,0.44,24,0.48,3,2,0.6,2,4,27,23,14,18,18,0.28,0.36,0.36,17.736,45,riffle_clumpy
0,18,23,9,50,0.36,27,0.54,3,3,0.5,1,2,23,27,13,20,17,0.26,0.4,0.34,17.737,46,riffle_clumpy
0,21,18,5,44,0.477,26,0.591,3,0,1.0,3,3,24,20,13,14,17,0.295,0.318,0.386,17.743,47,riffle_clumpy
0,18,21,5,44,0.409,23,0.523,1,1,0.5,0,3,27,17,13,12,19,0.295,0.273,0.432,17.746,48,riffle_clumpy
0,18,24,3,45,0.4,21,0.467,5,0,1.0,2,2,26,19,8,17,20,0.178,0.378,0.444,17.75,49,riffle_clumpy
0,22,19,4,45,0.489,26,0.578,3,2,0.6,0,3,26,19,16,13,16,0.356,0.289,0.356,17.755,50,riffle_clumpy
0,18,25,6,49,0.367,24,0.49,7,4,0.636,1,3,24,25,13,17,19,0.265,0.347,0.388,17.752,51,riffle_clumpy
0,18,25,2,45,0.4,20,0.444,2,3,0.4,1,6,33,12,7,13,25,0.156,0.289,0.556,17.746,52,riffle_clumpy
0,21,20,4,45,0.467,25,0.556,2,1,0.667,3,0,24,21,12,16,17,0.267,0.356,0.378,17.738,53,riffle_clumpy
0,23,19,2,44,0.523,25,0.568,4,1,0.8,2,2,27,17,9,10,25,0.205,0.227,0.568,17.745,54,riffle_clumpy
0,16,26,2,44,0.364,18,0.409,4,2,0.667,1,2,25,19,9,14,21,0.205,0.318,0.477,17.752,55,riffle_clumpy
0,21,22,2,45,0.467,23,0.511,6,2,0.75,5,2,28,17,10,12,23,0.222,0.267,0.511,17.728,56,riffle_clumpy
0,21,20,4,45,0.467,25,0.556,2,4,0.333,4,0,26,19,10,17,18,0.222,0.378,0.4,17.719,57,riffle_clumpy
0,23,16,5,44,0.523,28,0.636,4,1,0.8,1,5,30,14,15,13,16,0.341,0.295,0.364,17.717,58,riffle_clumpy
0,25,18,1,44,0.568,26,0.591,3,0,1.0,1,1,24,20,9,18,17,0.205,0.409,0.386,17.728,59,riffle_clumpy
0,25,19,4,48,0.521,29,0.604,3,1,0.75,1,2,27,21,10,19,19,0.208,0.396,0.396,17.726,60,riffle_clumpy
0,27,13,5,45,0.6,32,0.711,4,1,0.8,2,1,25,20,10,19,16,0.222,0.422,0.356,17.726,61,riffle_clumpy
0,14,26,5,45,0.311,19,0.422,1,1,0.5,2,3,28,17,8,14,23,0.178,0.311,0.511,17.727,62,riffle_clumpy
0,21,23,4,48,0.438,25,0.521,2,3,0.4,3,3,29,19,7,19,22,0.146,0.396,0.458,17.735,63,riffle_clumpy
0,23,19,2,44,0.523,25,0.568,3,0,1.0,2,1,28,16,11,16,17,0.25,0.364,0.386,17.732,64,riffle_clumpy
0,17,25,6,48,0.354,23,0.479,5,3,0.625,3,4,31,17,11,14,23,0.229,0.292,0.479,17.736,65,riffle_clumpy
0,20,17,7,44,0.455,27,0.614,2,2,0.5,1,2,30,14,10,13,21,0.227,0.295,0.477,17.736,66,riffle_clumpy
0,16,26,4,46,0.348,20,0.435,0,1,0.0,2,1,30,16,4,18,24,0.087,0.391,0.522,17.743,67,riffle_clumpy
0,21,19,4,44,0.477,25,0.568,3,1,0.75,4,2,24,20,9,16,19,0.205,0.364,0.432,17.741,68,riffle_clumpy
0,19,18,9,46,0.413,28,0.609,2,2,0.5,2,2,32,14,12,14,20,0.261,0.304,0.435,17.744,69,riffle_clumpy
0,23,17,6,46,0.5,29,0.63,4,4,0.5,1,4,30,16,14,10,22,0.304,0.217,0.478,17.741,70,riffle_clumpy
0,20,20,3,43,0.465,23,0.535,3,2,0.6,2,2,27,16,11,15,17,0.256,0.349,0.395,17.746,71,riffle_clumpy
0,16,26,3,45,0.356,19,0.422,3,5,0.375,2,1,27,18,7,15,23,0.156,0.333,0.511,17.75,72,riffle_clumpy
0,23,16,4,43,0.535,27,0.628,3,3,0.5,1,0,29,14,10,9,24,0.233,0.209,0.558,17.754,73,riffle_clumpy
0,22,20,3,45,0.489,25,0.556,3,4,0.429,1,2,26,19,15,16,14,0.333,0.356,0.311,17.753,74,riffle_clumpy
0,20,22,4,46,0.435,24,0.522,9,0,1.0,2,1,23,23,11,16,19,0.239,0.348,0.413,17.746,75,riffle_clumpy
0,20,21,4,45,0.444,24,0.533,3,2,0.6,3,2,31,14,10,11,24,0.222,0.244,0.533,17.739,76,riffle_clumpy
0,26,17,3,46,0.565,29,0.63,2,2,0.5,4,1,25,21,10,18,18,0.217,0.391,0.391,17.738,77,riffle_clumpy
0,15,24,5,44,0.341,20,0.455,1,3,0.25,2,3,23,21,10,16,18,0.227,0.364,0.409,17.739,78,riffle_clumpy
0,20,27,1,48,0.417,21,0.438,1,3,0.25,3,2,20,28,11,19,18,0.229,0.396,0.375,17.742,79,riffle_clumpy
0,22,24,1,47,0.468,23,0.489,2,2,0.5,2,5,27,20,11,14,22,0.234,0.298,0.468,17.739,80,riffle_clumpy
0,20,19,5,44,0.455,25,0.568,2,2,0.5,4,1,29,15,13,13,18,0.295,0.295,0.409,17.729,81,riffle_clumpy
0,20,19,6,45,0.444,26,0.578,3,3,0.5,3,4,27,18,10,13,22,0.222,0.289,0.489,17.733,82,riffle_clumpy
0,19,21,5,45,0.422,24,0.533,7,0,1.0,2,0,28,17,10,14,21,0.222,0.311,0.467,17.74,83,riffle_clumpy
0,19,27,2,48,0.396,21,0.438,2,3,0.4,3,4,31,17,10,16,22,0.208,0.333,0.458,17.743,84,riffle_clumpy
0,25,16,4,45,0.556,29,0.644,2,1,0.667,2,0,31,14,11,12,22,0.244,0.267,0.489,17.745,85,riffle_clumpy
0,14,26,4,44,0.318,18,0.409,2,3,0.4,1,5,29,15,7,15,22,0.159,0.341,0.5,17.748,86,riffle_clumpy
0,21,26,0,47,0.447,21,0.447,1,1,0.5,3,3,29,18,5,19,23,0.106,0.404,0.489,17.748,87,riffle_clumpy
0,20,21,3,44,0.455,23,0.523,2,2,0.5,3,2,31,13,10,12,22,0.227,0.273,0.5,17.756,88,riffle_clumpy
0,21,18,6,45,0.467,27,0.6,3,2,0.6,4,1,28,17,11,14,20,0.244,0.311,0.444,17.754,89,riffle_clumpy
0,20,23,2,45,0.444,22,0.489,4,3,0.571,1,1,26,19,11,19,15,0.244,0.422,0.333,17.753,90,riffle_clumpy
0,20,23,5,48,0.417,25,0.521,4,2,0.667,4,3,32,16,8,16,24,0.167,0.333,0.5,17.755,91,riffle_clumpy
0,17,23,5,45,0.378,22,0.489,4,3,0.571,1,1,22,23,10,17,18,0.222,0.378,0.4,17.757,92,riffle_clumpy
0,16,27,2,45,0.356,18,0.4,0,3,0.0,0,4,26,19,13,13,19,0.289,0.289,0.422,17.767,93,riffle_clumpy
0,26,16,3,45,0.578,29,0.644,5,3,0.625,1,2,25,20,14,13,18,0.311,0.289,0.4,17.769,94,riffle_clumpy
0,20,21,4,45,0.444,24,0.533,5,4,0.556,3,5,30,15,11,11,23,0.244,0.244,0.511,17.769,95,riffle_clumpy
0,20,22,5,47,0.426,25,0.532,3,5,0.375,2,3,28,19,10,16,21,0.213,0.34,0.447,17.771,96,riffle_clumpy
0,18,22,6,46,0.391,24,0.522,1,1,0.5,2,0,30,16,9,16,21,0.196,0.348,0.457,18.152,1,riffle_clumpy
0,16,29,3,48,0.333,19,0.396,0,3,0.0,2,1,33,15,8,16,24,0.167,0.333,0.5,18.045,2,riffle_clumpy
0,19,22,6,47,0.404,25,0.532,4,2,0.667,2,4,30,17,13,12,22,0.277,0.255,0.468,17.957,3,riffle_clumpy
0,19,25,3,47,0.404,22,0.468,4,5,0.444,3,0,30,17,8,19,20,0.17,0.404,0.426,18.0,4,riffle_clumpy
0,16,25,5,46,0.348,21,0.457,1,3,0.25,2,4,28,18,8,16,22,0.174,0.348,0.478,17.994,5,riffle_clumpy
0,18,20,5,43,0.419,23,0.535,2,2,0.5,1,3,23,20,10,15,18,0.233,0.349,0.419,17.871,6,riffle_clumpy
0,16,26,3,45,0.356,19,0.422,1,3,0.25,5,3,28,17,7,14,24,0.156,0.311,0.533,17.766,7,riffle_clumpy
0,18,25,1,44,0.409,19,0.432,5,3,0.625,2,6,28,16,10,13,21,0.227,0.295,0.477,17.718,8,riffle_clumpy
0,22,20,2,44,0.5,24,0.545,2,2,0.5,1,6,31,13,13,12,19,0.295,0.273,0.432,17.757,9,riffle_clumpy
0,21,23,2,46,0.457,23,0.5,2,0,1.0,1,3,26,20,13,10,23,0.283,0.217,0.5,17.719,10,riffle_clumpy
0,21,23,2,46,0.457,23,0.5,2,3,0.4,1,1,25,21,11,18,17,0.239,0.391,0.37,17.74,11,riffle_clumpy
0,22,19,6,47,0.468,28,0.596,1,2,0.333,3,1,27,20,11,14,22,0.234,0.298,0.468,17.699,12,riffle_clumpy
0,23,19,3,45,0.511,26,0.578,3,1,0.75,2,1,25,20,13,10,22,0.289,0.222,0.489,17.596,13,riffle_clumpy
0,22,19,6,47,0.468,28,0.596,1,3,0.25,4,1,22,25,12,18,17,0.255,0.383,0.362,17.612,14,riffle_clumpy
0,23,18,4,45,0.511,27,0.6,3,1,0.75,3,3,29,16,11,13,21,0.244,0.289,0.467,17.591,15,riffle_clumpy
0,23,15,7,45,0.511,30,0.667,2,1,0.667,1,2,22,23,16,14,15,0.356,0.311,0.333,17.604,16,riffle_clumpy
0,20,19,5,44,0.455,25,0.568,5,3,0.625,1,2,24,20,13,13,18,0.295,0.295,0.409,17.62,17,riffle_clumpy
0,19,22,4,45,0.422,23,0.511,4,3,0.571,1,3,24,21,13,16,16,0.289,0.356,0.356,17.629,18,riffle_clumpy
0,23,17,3,43,0.535,26,0.605,4,3,0.571,1,1,28,15,11,13,19,0.256,0.302,0.442,17.609,19,riffle_clumpy
0,15,27,5,47,0.319,20,0.426,1,4,0.2,0,3,34,13,9,16,22,0.191,0.34,0.468,17.611,20,riffle_clumpy
0,21,26,4,51,0.412,25,0.49,4,6,0.4,3,2,26,25,11,20,20,0.216,0.392,0.392,17.632,21,riffle_clumpy
0,20,20,6,46,0.435,26,0.565,4,2,0.667,3,2,26,20,10,12,24,0.217,0.261,0.522,17.63,22,riffle_clumpy
0,20,26,1,47,0.426,21,0.447,4,2,0.667,3,4,24,23,9,19,19,0.191,0.404,0.404,17.617,23,riffle_clumpy
0,23,19,3,45,0.511,26,0.578,5,1,0.833,2,0,23,22,12,13,20,0.267,0.289,0.444,17.613,24,riffle_clumpy
0,18,24,1,43,0.419,19,0.442,3,2,0.6,1,1,27,16,10,13,20,0.233,0.302,0.465,17.642,25,riffle_clumpy
0,19,21,3,43,0.442,22,0.512,1,3,0.25,1,3,27,16,16,11,16,0.372,0.256,0.372,17.651,26,riffle_clumpy
0,21,21,4,46,0.457,25,0.543,4,3,0.571,5,0,29,17,10,14,22,0.217,0.304,0.478,17.657,27,riffle_clumpy
0,22,17,6,45,0.489,28,0.622,3,2,0.6,4,1,26,19,11,14,20,0.244,0.311,0.444,17.631,28,riffle_clumpy
0,23,17,3,43,0.535,26,0.605,2,2,0.5,0,1,29,14,15,8,20,0.349,0.186,0.465,17.626,29,riffle_clumpy
0,24,17,2,43,0.558,26,0.605,4,0,1.0,0,1,26,17,13,12,18,0.302,0.279,0.419,17.636,30,riffle_clumpy
0,23,18,3,44,0.523,26,0.591,4,3,0.571,1,4,28,16,13,11,20,0.295,0.25,0.455,17.657,31,riffle_clumpy
0,24,17,3,44,0.545,27,0.614,2,0,1.0,2,3,27,17,14,12,18,0.318,0.273,0.409,17.658,32,riffle_clumpy
0,17,26,3,46,0.37,20,0.435,1,2,0.333,0,3,30,16,11,12,23,0.239,0.261,0.5,17.65,33,riffle_clumpy
0,20,19,5,44,0.455,25,0.568,0,2,0.0,2,1,23,21,13,15,16,0.295,0.341,0.364,17.665,34,riffle_clumpy
0,17,18,8,43,0.395,25,0.581,3,1,0.75,1,1,26,17,10,16,17,0.233,0.372,0.395,17.69,35,riffle_clumpy
0,22,19,3,44,0.5,25,0.568,2,2,0.5,3,0,23,21,12,10,22,0.273,0.227,0.5,17.676,36,riffle_clumpy
0,26,17,2,45,0.578,28,0.622,5,2,0.714,4,2,23,22,17,9,19,0.378,0.2,0.422,17.664,37,riffle_clumpy
0,18,26,3,47,0.383,21,0.447,2,9,0.182,3,1,26,21,8,21,18,0.17,0.447,0.383,17.675,38,riffle_clumpy
0,16,29,3,48,0.333,19,0.396,1,3,0.25,2,3,23,25,7,18,23,0.146,0.375,0.479,17.671,39,riffle_clumpy
0,16,27,2,45,0.356,18,0.4,1,2,0.333,2,4,31,14,10,12,23,0.222,0.267,0.511,17.662,40,riffle_clumpy
0,17,25,3,45,0.378,20,0.444,3,0,1.0,0,1,30,15,9,17,19,0.2,0.378,0.422,17.666,41,riffle_clumpy
0,23,19,1,43,0.535,24,0.558,4,2,0.667,1,2,24,19,15,12,16,0.349,0.279,0.372,17.66,42,riffle_clumpy
0,22,20,3,45,0.489,25,0.556,4,5,0.444,4,1,29,16,9,14,22,0.2,0.311,0.489,17.642,43,riffle_clumpy
0,22,22,1,45,0.489,23,0.511,4,1,0.8,0,2,29,16,15,12,18,0.333,0.267,0.4,17.648,44,riffle_clumpy
0,22,22,1,45,0.489,23,0.511,3,4,0.429,3,1,27,18,11,15,19,0.244,0.333,0.422,17.653,45,riffle_clumpy
0,19,24,1,44,0.432,20,0.455,5,2,0.714,3,3,30,14,11,12,21,0.25,0.273,0.477,17.646,46,riffle_clumpy
0,14,26,4,44,0.318,18,0.409,1,0,1.0,2,4,31,13,7,14,23,0.159,0.318,0.523,17.654,47,riffle_clumpy
0,21,21,1,43,0.488,22,0.512,6,3,0.667,0,3,32,11,12,9,22,0.279,0.209,0.512,17.663,48,riffle_clumpy
0,19,22,3,44,0.432,22,0.5,3,2,0.6,3,3,31,13,11,11,22,0.25,0.25,0.5,17.675,49,riffle_clumpy
0,22,23,2,47,0.468,24,0.511,7,2,0.778,4,3,22,25,12,17,18,0.255,0.362,0.383,17.685,50,riffle_clumpy
0,15,26,3,44,0.341,18,0.409,1,2,0.333,2,2,25,19,7,18,19,0.159,0.409,0.432,17.677,51,riffle_clumpy
0,13,27,6,46,0.283,19,0.413,2,1,0.667,1,3,26,20,5,21,20,0.109,0.457,0.435,17.68,52,riffle_clumpy
0,20,21,5,46,0.435,25,0.543,4,0,1.0,2,2,24,22,12,15,19,0.261,0.326,0.413,17.687,53,riffle_clumpy
0,15,23,5,43,0.349,20,0.465,0,4,0.0,1,1,28,15,8,12,23,0.186,0.279,0.535,17.697,54,riffle_clumpy
0,17,23,5,45,0.378,22,0.489,3,4,0.429,3,0,25,20,8,15,22,0.178,0.333,0.489,17.697,55,riffle_clumpy
0,21,19,1,41,0.512,22,0.537,5,1,0.833,0,0,26,15,12,11,18,0.293,0.268,0.439,17.704,56,riffle_clumpy
0,24,20,1,45,0.533,25,0.556,7,2,0.778,0,2,22,23,13,13,19,0.289,0.289,0.422,17.708,57,riffle_clumpy
0,19,23,4,46,0.413,23,0.5,2,2,0.5,3,0,29,17,7,17,22,0.152,0.37,0.478,17.703,58,riffle_clumpy
0,17,22,5,44,0.386,22,0.5,2,3,0.4,2,1,23,21,13,15,16,0.295,0.341,0.364,17.718,59,riffle_clumpy
0,24,23,1,48,0.5,25,0.521,8,1,0.889,5,3,32,16,16,12,20,0.333,0.25,0.417,17.716,60,riffle_clumpy
0,22,17,6,45,0.489,28,0.622,4,0,1.0,1,3,26,19,15,11,19,0.333,0.244,0.422,17.72,61,riffle_clumpy
0,23,22,2,47,0.489,25,0.532,2,1,0.667,1,1,28,19,10,17,20,0.213,0.362,0.426,17.712,62,riffle_clumpy
0,29,13,3,45,0.644,32,0.711,5,0,1.0,5,1,28,17,12,9,24,0.267,0.2,0.533,17.697,63,riffle_clumpy
0,16,22,5,43,0.372,21,0.488,4,5,0.444,1,0,24,19,9,18,16,0.209,0.419,0.372,17.699,64,riffle_clumpy
0,20,22,5,47,0.426,25,0.532,3,2,0.6,0,1,28,19,12,15,20,0.255,0.319,0.426,17.705,65,riffle_clumpy
0,21,25,1,47,0.447,22,0.468,3,2,0.6,2,1,26,21,11,15,21,0.234,0.319,0.447,17.712,66,riffle_clumpy
0,22,22,2,46,0.478,24,0.522,1,3,0.25,1,1,29,17,13,13,20,0.283,0.283,0.435,17.714,67,riffle_clumpy
0,15,28,3,46,0.326,18,0.391,4,2,0.667,2,3,26,20,6,18,22,0.13,0.391,0.478,17.718,68,riffle_clumpy
0,15,26,3,44,0.341,18,0.409,2,2,0.5,1,2,28,16,12,11,21,0.273,0.25,0.477,17.729,69,riffle_clumpy
0,20,20,5,45,0.444,25,0.556,3,3,0.5,0,1,31,14,10,14,21,0.222,0.311,0.467,17.727,70,riffle_clumpy
0,16,22,5,43,0.372,21,0.488,4,3,0.571,2,4,27,16,12,13,18,0.279,0.302,0.419,17.724,71,riffle_clumpy
0,23,18,3,44,0.523,26,0.591,4,2,0.667,3,0,27,17,13,11,20,0.295,0.25,0.455,17.722,72,riffle_clumpy
0,24,19,3,46,0.522,27,0.587,7,2,0.778,2,2,24,22,15,14,17,0.326,0.304,0.37,17.722,73,riffle_clumpy
0,26,15,4,45,0.578,30,0.667,2,1,0.667,3,2,22,23,15,16,14,0.333,0.356,0.311,17.717,74,riffle_clumpy
0,17,22,8,47,0.362,25,0.532,1,3,0.25,4,1,26,21,6,21,20,0.128,0.447,0.426,17.719,75,riffle_clumpy
0,19,25,5,49,0.388,24,0.49,1,2,0.333,4,4,28,21,10,15,24,0.204,0.306,0.49,17.721,76,riffle_clumpy
0,16,23,6,45,0.356,22,0.489,0,2,0.0,5,5,29,16,10,13,22,0.222,0.289,0.489,17.723,77,riffle_clumpy
0,24,20,4,48,0.5,28,0.583,3,2,0.6,6,3,28,20,8,16,24,0.167,0.333,0.5,17.717,78,riffle_clumpy
0,19,24,2,45,0.422,21,0.467,3,0,1.0,0,2,30,15,11,15,19,0.244,0.333,0.422,17.72,79,riffle_clumpy
0,26,19,4,49,0.531,30,0.612,4,1,0.8,5,0,23,26,14,13,22,0.286,0.265,0.449,17.706,80,riffle_clumpy
0,16,27,5,48,0.333,21,0.438,2,0,1.0,1,2,33,15,12,14,22,0.25,0.292,0.458,17.687,81,riffle_clumpy
0,25,21,1,47,0.532,26,0.553,6,0,1.0,2,2,23,24,21,14,12,0.447,0.298,0.255,17.694,82,riffle_clumpy
0,20,23,6,49,0.408,26,0.531,2,4,0.333,2,1,25,24,8,22,19,0.163,0.449,0.388,17.692,83,riffle_clumpy
0,17,25,3,45,0.378,20,0.444,4,3,0.571,1,1,24,21,9,15,21,0.2,0.333,0.467,17.691,84,riffle_clumpy
0,19,27,0,46,0.413,19,0.413,1,4,0.2,3,4,32,14,8,12,26,0.174,0.261,0.565,17.697,85,riffle_clumpy
0,14,29,2,45,0.311,16,0.356,1,3,0.25,2,1,29,16,7,12,26,0.156,0.267,0.578,17.694,86,riffle_clumpy
0,18,27,2,47,0.383,20,0.426,2,2,0.5,3,2,21,26,10,21,16,0.213,0.447,0.34,17.695,87,riffle_clumpy
0,16,25,4,45,0.356,20,0.444,1,3,0.25,3,1,31,14,12,11,22,0.267,0.244,0.489,17.68,88,riffle_clumpy
0,20,24,3,47,0.426,23,0.489,2,3,0.4,4,3,24,23,14,16,17,0.298,0.34,0.362,17.679,89,riffle_clumpy
0,20,24,4,48,0.417,24,0.5,2,6,0.25,0,1,25,23,11,22,15,0.229,0.458,0.312,17.683,90,riffle_clumpy
0,17,23,6,46,0.37,23,0.5,2,2,0.5,2,3,27,19,12,14,20,0.261,0.304,0.435,17.678,91,riffle_clumpy
0,24,18,1,43,0.558,25,0.581,4,2,0.667,1,3,31,12,11,12,20,0.256,0.279,0.465,17.678,92,riffle_clumpy
0,23,20,2,45,0.511,25,0.556,2,2,0.5,2,0,22,23,15,12,18,0.333,0.267,0.4,17.686,93,riffle_clumpy
0,19,21,5,45,0.422,24,0.533,3,3,0.5,5,2,31,14,9,9,27,0.2,0.2,0.6,17.679,94,riffle_clumpy
0,21,15,8,44,0.477,29,0.659,5,4,0.556,2,1,22,22,12,19,13,0.273,0.432,0.295,17.683,95,riffle_clumpy
0,21,26,1,48,0.438,22,0.458,1,2,0.333,3,1,29,19,10,13,25,0.208,0.271,0.521,17.671,96,riffle_clumpy
0,18,23,4,45,0.4,22,0.489,2,6,0.25,2,2,26,19,9,15,21,0.2,0.333,0.467,18.452,1,riffle_clumpy
0,22,21,4,47,0.468,26,0.553,7,3,0.7,3,1,28,19,15,10,22,0.319,0.213,0.468,18.333,2,riffle_clumpy
0,24,20,4,48,0.5,28,0.583,7,3,0.7,2,3,24,24,14,17,17,0.292,0.354,0.354,18.19,3,riffle_clumpy
0,27,16,4,47,0.574,31,0.66,5,1,0.833,4,0,24,23,15,18,14,0.319,0.383,0.298,18.145,4,riffle_clumpy
0,16,27,4,47,0.34,20,0.426,2,1,0.667,4,6,28,19,3,17,27,0.064,0.362,0.574,17.839,5,riffle_clumpy
0,21,23,3,47,0.447,24,0.511,2,1,0.667,1,1,29,18,11,18,18,0.234,0.383,0.383,17.882,6,riffle_clumpy
0,30,14,5,49,0.612,35,0.714,4,1,0.8,3,2,27,22,14,13,22,0.286,0.265,0.449,17.848,7,riffle_clumpy
0,16,25,4,45,0.356,20,0.444,1,3,0.25,1,3,34,11,8,9,28,0.178,0.2,0.622,17.76,8,riffle_clumpy
0,18,22,6,46,0.391,24,0.522,1,3,0.25,2,1,25,21,11,18,17,0.239,0.391,0.37,17.693,9,riffle_clumpy
0,20,25,1,46,0.435,21,0.457,1,2,0.333,3,2,28,18,8,14,24,0.174,0.304,0.522,17.608,10,riffle_clumpy
0,15,23,8,46,0.326,23,0.5,2,3,0.4,0,6,32,14,10,13,23,0.217,0.283,0.5,17.602,11,riffle_clumpy
0,23,19,2,44,0.523,25,0.568,2,1,0.667,2,1,24,20,13,18,13,0.295,0.409,0.295,17.643,12,riffle_clumpy
0,20,21,3,44,0.455,23,0.523,4,1,0.8,2,2,28,16,11,10,23,0.25,0.227,0.523,17.629,13,riffle_clumpy
0,19,21,5,45,0.422,24,0.533,1,2,0.333,2,2,25,20,10,15,20,0.222,0.333,0.444,17.68,14,riffle_clumpy
0,23,20,4,47,0.489,27,0.574,3,3,0.5,1,1,34,13,10,14,23,0.213,0.298,0.489,17.693,15,riffle_clumpy
0,23,21,3,47,0.489,26,0.553,2,2,0.5,0,6,28,19,13,15,19,0.277,0.319,0.404,17.708,16,riffle_clumpy
0,18,21,6,45,0.4,24,0.533,5,0,1.0,0,3,27,18,10,17,18,0.222,0.378,0.4,17.699,17,riffle_clumpy
0,23,20,6,49,0.469,29,0.592,4,3,0.571,1,0,31,18,10,16,23,0.204,0.327,0.469,17.715,18,riffle_clumpy
0,21,19,4,44,0.477,25,0.568,1,3,0.25,3,0,32,12,10,12,22,0.227,0.273,0.5,17.725,19,riffle_clumpy
0,22,20,7,49,0.449,29,0.592,4,0,1.0,4,4,27,22,13,14,22,0.265,0.286,0.449,17.715,20,riffle_clumpy
0,17,25,2,44,0.386,19,0.432,3,0,1.0,0,2,32,12,9,14,21,0.205,0.318,0.477,17.733,21,riffle_clumpy
0,17,24,3,44,0.386,20,0.455,5,1,0.833,0,2,27,17,9,15,20,0.205,0.341,0.455,17.745,22,riffle_clumpy
0,16,24,5,45,0.356,21,0.467,1,2,0.333,1,4,30,15,13,13,19,0.289,0.289,0.422,17.748,23,riffle_clumpy
0,19,18,7,44,0.432,26,0.591,4,4,0.5,3,1,21,23,11,19,14,0.25,0.432,0.318,17.764,24,riffle_clumpy
0,25,20,4,49,0.51,29,0.592,2,3,0.4,2,4,30,19,14,14,21,0.286,0.286,0.429,17.78,25,riffle_clumpy
0,30,13,3,46,0.652,33,0.717,4,1,0.8,6,4,25,21,16,7,23,0.348,0.152,0.5,17.756,26,riffle_clumpy
0,13,28,3,44,0.295,16,0.364,2,4,0.333,1,3,27,17,5,17,22,0.114,0.386,0.5,17.761,27,riffle_clumpy
0,17,19,7,43,0.395,24,0.558,4,3,0.571,2,2,30,13,9,10,24,0.209,0.233,0.558,17.761,28,riffle_clumpy
0,26,17,1,44,0.591,27,0.614,4,3,0.571,5,1,34,10,11,10,23,0.25,0.227,0.523,17.764,29,riffle_clumpy
0,21,21,3,45,0.467,24,0.533,6,4,0.6,2,2,28,17,13,14,18,0.289,0.311,0.4,17.771,30,riffle_clumpy
0,19,23,5,47,0.404,24,0.511,5,1,0.833,4,1,29,18,7,17,23,0.149,0.362,0.489,17.775,31,riffle_clumpy
0,20,21,5,46,0.435,25,0.543,3,3,0.5,2,3,31,15,7,14,25,0.152,0.304,0.543,17.751,32,riffle_clumpy
0,23,23,2,48,0.479,25,0.521,3,5,0.375,4,3,28,20,10,16,22,0.208,0.333,0.458,17.748,33,riffle_clumpy
0,24,16,3,43,0.558,27,0.628,7,1,0.875,1,0,28,15,16,7,20,0.372,0.163,0.465,17.76,34,riffle_clumpy
0,17,23,6,46,0.37,23,0.5,4,3,0.571,4,1,26,20,9,12,25,0.196,0.261,0.543,17.722,35,riffle_clumpy
0,20,21,3,44,0.455,23,0.523,4,5,0.444,2,2,28,16,10,10,24,0.227,0.227,0.545,17.713,36,riffle_clumpy
0,22,21,4,47,0.468,26,0.553,2,5,0.286,0,3,31,16,14,15,18,0.298,0.319,0.383,17.727,37,riffle_clumpy
0,18,16,9,43,0.419,27,0.628,2,2,0.5,0,0,29,14,8,19,16,0.186,0.442,0.372,17.735,38,riffle_clumpy
0,17,28,3,48,0.354,20,0.417,2,6,0.25,2,5,27,21,11,14,23,0.229,0.292,0.479,17.724,39,riffle_clumpy
0,15,27,5,47,0.319,20,0.426,3,1,0.75,1,6,35,12,5,13,29,0.106,0.277,0.617,17.74,40,riffle_clumpy
0,16,23,5,44,0.364,21,0.477,1,2,0.333,0,3,32,12,4,17,23,0.091,0.386,0.523,17.738,41,riffle_clumpy
0,24,21,2,47,0.511,26,0.553,3,1,0.75,2,1,23,24,14,15,18,0.298,0.319,0.383,17.748,42,riffle_clumpy
0,20,22,6,48,0.417,26,0.542,5,1,0.833,4,1,27,21,11,15,22,0.229,0.312,0.458,17.738,43,riffle_clumpy
0,22,16,7,45,0.489,29,0.644,2,2,0.5,6,1,27,18,9,13,23,0.2,0.289,0.511,17.718,44,riffle_clumpy
0,17,24,5,46,0.37,22,0.478,2,4,0.333,3,2,28,18,8,13,25,0.174,0.283,0.543,17.707,45,riffle_clumpy
0,22,18,3,43,0.512,25,0.581,2,2,0.5,4,2,26,17,15,11,17,0.349,0.256,0.395,17.708,46,riffle_clumpy
0,17,25,3,45,0.378,20,0.444,4,2,0.667,3,4,34,11,5,16,24,0.111,0.356,0.533,17.702,47,riffle_clumpy
0,17,17,9,43,0.395,26,0.605,3,1,0.75,2,3,26,17,10,11,22,0.233,0.256,0.512,17.7,48,riffle_clumpy
0,22,25,5,52,0.423,27,0.519,1,4,0.2,4,2,30,22,9,19,24,0.173,0.365,0.462,17.7,49,riffle_clumpy
0,21,25,1,47,0.447,22,0.468,8,1,0.889,2,2,25,22,14,12,21,0.298,0.255,0.447,17.697,50,riffle_clumpy
0,24,21,0,45,0.533,24,0.533,3,2,0.6,4,1,21,24,13,13,19,0.289,0.289,0.422,17.661,51,riffle_clumpy
0,20,21,2,43,0.465,22,0.512,1,0,1.0,2,2,27,16,9,14,20,0.209,0.326,0.465,17.67,52,riffle_clumpy
0,28,15,3,46,0.609,31,0.674,4,1,0.8,5,1,22,24,13,9,24,0.283,0.196,0.522,17.646,53,riffle_clumpy
0,24,18,2,44,0.545,26,0.591,5,2,0.714,3,2,27,17,13,13,18,0.295,0.295,0.409,17.637,54,riffle_clumpy
0,17,24,3,44,0.386,20,0.455,1,4,0.2,2,1,27,17,9,17,18,0.205,0.386,0.409,17.634,55,riffle_clumpy
0,17,30,3,50,0.34,20,0.4,5,1,0.833,2,4,30,20,8,22,20,0.16,0.44,0.4,17.645,56,riffle_clumpy
0,24,20,1,45,0.533,25,0.556,3,2,0.6,2,4,34,11,15,9,21,0.333,0.2,0.467,17.639,57,riffle_clumpy
0,23,19,4,46,0.5,27,0.587,0,1,0.0,3,4,26,20,14,11,21,0.304,0.239,0.457,17.635,58,riffle_clumpy
0,23,14,7,44,0.523,30,0.682,1,2,0.333,4,0,32,12,12,9,23,0.273,0.205,0.523,17.622,59,riffle_clumpy
0,20,24,2,46,0.435,22,0.478,6,1,0.857,3,3,27,19,11,14,21,0.239,0.304,0.457,17.632,60,riffle_clumpy
0,18,24,3,45,0.4,21,0.467,2,4,0.333,0,3,30,15,11,11,23,0.244,0.244,0.511,17.637,61,riffle_clumpy
0,29,20,1,50,0.58,30,0.6,6,2,0.75,2,2,30,20,14,14,22,0.28,0.28,0.44,17.634,62,riffle_clumpy
0,21,20,2,43,0.488,23,0.535,1,4,0.2,4,1,29,14,12,9,22,0.279,0.209,0.512,17.646,63,riffle_clumpy
0,14,26,7,47,0.298,21,0.447,4,4,0.5,2,3,32,15,9,13,25,0.191,0.277,0.532,17.65,64,riffle_clumpy
0,15,26,7,48,0.312,22,0.458,3,1,0.75,3,1,31,17,7,17,24,0.146,0.354,0.5,17.644,65,riffle_clumpy
0,13,34,2,49,0.265,15,0.306,1,6,0.143,2,6,34,15,8,12,29,0.163,0.245,0.592,17.637,66,riffle_clumpy
0,19,24,3,46,0.413,22,0.478,3,2,0.6,1,4,23,23,12,13,21,0.261,0.283,0.457,17.637,67,riffle_clumpy
0,26,18,2,46,0.565,28,0.609,1,0,1.0,3,1,25,21,12,20,14,0.261,0.435,0.304,17.641,68,riffle_clumpy
0,21,24,2,47,0.447,23,0.489,2,3,0.4,2,3,29,18,12,14,21,0.255,0.298,0.447,17.652,69,riffle_clumpy
0,18,27,0,45,0.4,18,0.4,3,1,0.75,0,2,27,18,7,18,20,0.156,0.4,0.444,17.653,70,riffle_clumpy
0,24,19,2,45,0.533,26,0.578,4,0,1.0,2,1,25,20,12,15,18,0.267,0.333,0.4,17.653,71,riffle_clumpy
0,27,21,1,49,0.551,28,0.571,4,4,0.5,5,2,30,19,12,17,20,0.245,0.347,0.408,17.646,72,riffle_clumpy
0,22,19,5,46,0.478,27,0.587,7,1,0.875,2,2,29,17,11,14,21,0.239,0.304,0.457,17.646,73,riffle_clumpy
0,18,20,6,44,0.409,24,0.545,3,2,0.6,3,2,31,13,5,14,25,0.114,0.318,0.568,17.641,74,riffle_clumpy
0,16,26,4,46,0.348,20,0.435,3,1,0.75,1,3,27,19,13,13,20,0.283,0.283,0.435,17.643,75,riffle_clumpy
0,21,21,2,44,0.477,23,0.523,1,0,1.0,0,3,32,12,12,12,20,0.273,0.273,0.455,17.647,76,riffle_clumpy
0,21,22,2,45,0.467,23,0.511,6,3,0.667,1,2,29,16,9,13,23,0.2,0.289,0.511,17.641,77,riffle_clumpy
0,12,26,5,43,0.279,17,0.395,2,1,0.667,1,2,24,19,9,17,17,0.209,0.395,0.395,17.649,78,riffle_clumpy
0,16,24,6,46,0.348,22,0.478,1,1,0.5,2,3,31,15,7,11,28,0.152,0.239,0.609,17.642,79,riffle_clumpy
0,23,22,4,49,0.469,27,0.551,3,1,0.75,2,1,28,21,10,16,23,0.204,0.327,0.469,17.64,80,riffle_clumpy
0,22,20,2,44,0.5,24,0.545,3,1,0.75,4,1,26,18,13,12,19,0.295,0.273,0.432,17.639,81,riffle_clumpy
0,18,22,6,46,0.391,24,0.522,3,4,0.429,1,4,25,21,9,14,23,0.196,0.304,0.5,17.638,82,riffle_clumpy
0,18,23,6,47,0.383,24,0.511,2,0,1.0,0,4,22,25,14,14,19,0.298,0.298,0.404,17.639,83,riffle_clumpy
0,18,22,7,47,0.383,25,0.532,5,2,0.714,1,2,26,21,11,17,19,0.234,0.362,0.404,17.643,84,riffle_clumpy
0,19,22,4,45,0.422,23,0.511,0,0,0,0,4,30,15,11,10,24,0.244,0.222,0.533,17.641,85,riffle_clumpy
0,20,20,4,44,0.455,24,0.545,3,2,0.6,3,2,28,16,10,12,22,0.227,0.273,0.5,17.639,86,riffle_clumpy
0,22,24,3,49,0.449,25,0.51,3,2,0.6,1,3,31,18,12,15,22,0.245,0.306,0.449,17.638,87,riffle_clumpy
0,25,19,2,46,0.543,27,0.587,5,1,0.833,4,3,26,20,16,12,18,0.348,0.261,0.391,17.632,88,riffle_clumpy
0,25,17,3,45,0.556,28,0.622,1,1,0.5,1,3,29,16,13,12,20,0.289,0.267,0.444,17.634,89,riffle_clumpy
0,16,26,2,44,0.364,18,0.409,5,3,0.625,1,4,24,20,12,15,17,0.273,0.341,0.386,17.633,90,riffle_clumpy
0,21,21,3,45,0.467,24,0.533,8,1,0.889,2,2,26,19,15,11,19,0.333,0.244,0.422,17.635,91,riffle_clumpy
0,20,23,2,45,0.444,22,0.489,6,5,0.545,2,1,27,18,11,14,20,0.244,0.311,0.444,17.644,92,riffle_clumpy
0,15,23,6,44,0.341,21,0.477,2,1,0.667,1,2,24,20,10,17,17,0.227,0.386,0.386,17.652,93,riffle_clumpy
0,25,16,4,45,0.556,29,0.644,2,3,0.4,2,0,29,16,15,11,19,0.333,0.244,0.422,17.651,94,riffle_clumpy
0,19,20,6,45,0.422,25,0.556,2,2,0.5,1,3,24,21,13,14,18,0.289,0.311,0.4,17.657,95,riffle_clumpy
0,18,25,4,47,0.383,22,0.468,5,4,0.556,2,1,28,19,10,14,23,0.213,0.298,0.489,17.653,96,riffle_clumpy
0,21,19,4,44,0.477,25,0.568,3,1,0.75,1,6,28,16,14,10,20,0.318,0.227,0.455,17.913,1,riffle_clumpy
0,29,17,5,51,0.569,34,0.667,2,3,0.4,3,1,27,24,17,15,19,0.333,0.294,0.373,17.725,2,riffle_clumpy
0,20,24,2,46,0.435,22,0.478,1,3,0.25,4,3,29,17,10,16,20,0.217,0.348,0.435,17.659,3,riffle_clumpy
0,19,24,1,44,0.432,20,0.455,5,2,0.714,1,1,24,20,11,15,18,0.25,0.341,0.409,17.759,4,riffle_clumpy
0,13,27,4,44,0.295,17,0.386,5,1,0.833,1,4,27,17,7,17,20,0.159,0.386,0.455,17.783,5,riffle_clumpy
0,26,20,2,48,0.542,28,0.583,4,3,0.571,1,5,26,22,16,14,18,0.333,0.292,0.375,17.766,6,riffle_clumpy
0,21,24,2,47,0.447,23,0.489,2,2,0.5,5,2,29,18,9,16,22,0.191,0.34,0.468,17.618,7,riffle_clumpy
0,25,20,3,48,0.521,28,0.583,2,3,0.4,2,1,27,21,11,18,19,0.229,0.375,0.396,17.636,8,riffle_clumpy
0,18,29,3,50,0.36,21,0.42,4,4,0.5,0,2,29,21,15,17,18,0.3,0.34,0.36,17.684,9,riffle_clumpy
0,18,21,4,43,0.419,22,0.512,4,3,0.571,3,1,27,16,10,12,21,0.233,0.279,0.488,17.727,10,riffle_clumpy
0,25,20,5,50,0.5,30,0.6,3,5,0.375,6,0,22,28,10,18,22,0.2,0.36,0.44,17.685,11,riffle_clumpy
0,23,21,3,47,0.489,26,0.553,2,0,1.0,3,5,28,19,14,14,19,0.298,0.298,0.404,17.652,12,riffle_clumpy
0,22,17,5,44,0.5,27,0.614,0,2,0.0,3,2,28,16,14,9,21,0.318,0.205,0.477,17.613,13,riffle_clumpy
0,20,24,1,45,0.444,21,0.467,3,3,0.5,1,4,25,20,10,14,21,0.222,0.311,0.467,17.667,14,riffle_clumpy
0,22,24,3,49,0.449,25,0.51,2,1,0.667,1,3,31,18,13,11,25,0.265,0.224,0.51,17.63,15,riffle_clumpy
0,20,21,4,45,0.444,24,0.533,0,2,0.0,3,3,27,18,13,12,20,0.289,0.267,0.444,17.635,16,riffle_clumpy
0,15,24,6,45,0.333,21,0.467,3,1,0.75,0,2,26,19,9,14,22,0.2,0.311,0.489,17.623,17,riffle_clumpy
0,20,22,4,46,0.435,24,0.522,6,1,0.857,0,3,27,19,13,15,18,0.283,0.326,0.391,17.642,18,riffle_clumpy
0,16,26,6,48,0.333,22,0.458,0,3,0.0,1,3,33,15,5,13,30,0.104,0.271,0.625,17.649,19,riffle_clumpy
0,23,17,3,43,0.535,26,0.605,4,4,0.5,2,3,26,17,16,10,17,0.372,0.233,0.395,17.647,20,riffle_clumpy
0,24,15,4,43,0.558,28,0.651,5,0,1.0,2,1,26,17,11,14,18,0.256,0.326,0.419,17.68,21,riffle_clumpy
0,17,24,4,45,0.378,21,0.467,4,2,0.667,1,1,33,12,12,13,20,0.267,0.289,0.444,17.701,22,riffle_clumpy
0,19,21,5,45,0.422,24,0.533,2,5,0.286,1,1,24,21,12,19,14,0.267,0.422,0.311,17.748,23,riffle_clumpy
0,24,21,2,47,0.511,26,0.553,3,2,0.6,3,2,26,21,15,13,19,0.319,0.277,0.404,17.744,24,riffle_clumpy
0,19,20,6,45,0.422,25,0.556,4,3,0.571,1,1,24,21,10,16,19,0.222,0.356,0.422,17.767,25,riffle_clumpy
0,23,18,3,44,0.523,26,0.591,2,2,0.5,2,1,20,24,13,19,12,0.295,0.432,0.273,17.801,26,riffle_clumpy
0,14,25,8,47,0.298,22,0.468,2,3,0.4,2,3,30,17,4,18,25,0.085,0.383,0.532,17.783,27,riffle_clumpy
0,26,17,5,48,0.542,31,0.646,3,4,0.429,4,2,27,21,11,17,20,0.229,0.354,0.417,17.769,28,riffle_clumpy
0,15,26,3,44,0.341,18,0.409,6,2,0.75,2,3,30,14,11,9,24,0.25,0.205,0.545,17.76,29,riffle_clumpy
0,26,22,3,51,0.51,29,0.569,5,2,0.714,2,0,30,21,15,12,24,0.294,0.235,0.471,17.756,30,riffle_clumpy
0,22,18,4,44,0.5,26,0.591,2,2,0.5,3,2,23,21,14,13,17,0.318,0.295,0.386,17.754,31,riffle_clumpy
0,20,16,7,43,0.465,27,0.628,3,2,0.6,3,0,23,20,12,15,16,0.279,0.349,0.372,17.738,32,riffle_clumpy
0,20,23,4,47,0.426,24,0.511,2,2,0.5,3,2,24,23,11,15,21,0.234,0.319,0.447,17.731,33,riffle_clumpy
0,20,19,6,45,0.444,26,0.578,4,1,0.8,2,1,28,17,14,10,21,0.311,0.222,0.467,17.715,34,riffle_clumpy
0,20,19,4,43,0.465,24,0.558,4,1,0.8,0,3,28,15,14,12,17,0.326,0.279,0.395,17.742,35,riffle_clumpy
0,17,25,3,45,0.378,20,0.444,6,0,1.0,4,1,28,17,8,16,21,0.178,0.356,0.467,17.739,36,riffle_clumpy
0,18,22,3,43,0.419,21,0.488,2,3,0.4,0,1,27,16,11,11,21,0.256,0.256,0.488,17.756,37,riffle_clumpy
0,16,27,2,45,0.356,18,0.4,7,2,0.778,2,4,27,18,9,14,22,0.2,0.311,0.489,17.732,38,riffle_clumpy
0,19,21,3,43,0.442,22,0.512,4,3,0.571,0,3,29,14,12,10,21,0.279,0.233,0.488,17.733,39,riffle_clumpy
0,22,17,6,45,0.489,28,0.622,2,1,0.667,0,5,27,18,15,11,19,0.333,0.244,0.422,17.75,40,riffle_clumpy
0,18,22,3,43,0.419,21,0.488,2,1,0.667,2,0,25,18,7,15,21,0.163,0.349,0.488,17.739,41,riffle_clumpy
0,17,26,3,46,0.37,20,0.435,4,6,0.4,3,3,28,18,8,17,21,0.174,0.37,0.457,17.747,42,riffle_clumpy
0,22,20,4,46,0.478,26,0.565,3,1,0.75,2,2,29,17,12,12,22,0.261,0.261,0.478,17.747,43,riffle_clumpy
0,21,16,7,44,0.477,28,0.636,3,1,0.75,2,5,26,18,12,17,15,0.273,0.386,0.341,17.744,44,riffle_clumpy
0,18,19,7,44,0.409,25,0.568,3,1,0.75,2,2,30,14,9,12,23,0.205,0.273,0.523,17.742,45,riffle_clumpy
0,23,18,4,45,0.511,27,0.6,2,0,1.0,2,2,26,19,16,14,15,0.356,0.311,0.333,17.737,46,riffle_clumpy
0,20,21,3,44,0.455,23,0.523,0,2,0.0,0,0,28,16,13,15,16,0.295,0.341,0.364,17.735,47,riffle_clumpy
0,19,19,7,45,0.422,26,0.578,3,1,0.75,2,0,23,22,12,17,16,0.267,0.378,0.356,17.733,48,riffle_clumpy
0,16,21,7,44,0.364,23,0.523,1,3,0.25,3,3,29,15,8,14,22,0.182,0.318,0.5,17.717,49,riffle_clumpy
0,24,18,2,44,0.545,26,0.591,2,1,0.667,2,3,26,18,12,12,20,0.273,0.273,0.455,17.722,50,riffle_clumpy
0,25,18,2,45,0.556,27,0.6,9,3,0.75,4,1,26,19,15,11,19,0.333,0.244,0.422,17.712,51,riffle_clumpy
0,18,20,7,45,0.4,25,0.556,6,2,0.75,2,2,30,15,11,14,20,0.244,0.311,0.444,17.713,52,riffle_clumpy
0,24,18,3,45,0.533,27,0.6,0,1,0.0,4,2,22,23,13,17,15,0.289,0.378,0.333,17.697,53,riffle_clumpy
0,22,25,0,47,0.468,22,0.468,4,5,0.444,2,3,22,25,11,16,20,0.234,0.34,0.426,17.701,54,riffle_clumpy
0,18,22,5,45,0.4,23,0.511,2,2,0.5,1,2,24,21,11,18,16,0.244,0.4,0.356,17.697,55,riffle_clumpy
0,21,19,4,44,0.477,25,0.568,5,3,0.625,0,2,25,19,15,11,18,0.341,0.25,0.409,17.701,56,riffle_clumpy
0,21,20,3,44,0.477,24,0.545,1,3,0.25,2,0,26,18,9,16,19,0.205,0.364,0.432,17.698,57,riffle_clumpy
0,22,17,6,45,0.489,28,0.622,2,1,0.667,3,2,26,19,11,12,22,0.244,0.267,0.489,17.704,58,riffle_clumpy
0,23,23,4,50,0.46,27,0.54,5,4,0.556,4,2,29,21,7,21,22,0.14,0.42,0.44,17.705,59,riffle_clumpy
0,31,14,1,46,0.674,32,0.696,4,2,0.667,3,2,23,23,17,11,18,0.37,0.239,0.391,17.697,60,riffle_clumpy
0,13,26,6,45,0.289,19,0.422,3,4,0.429,0,6,26,19,8,13,24,0.178,0.289,0.533,17.698,61,riffle_clumpy
0,16,20,8,44,0.364,24,0.545,3,1,0.75,4,2,27,17,8,13,23,0.182,0.295,0.523,17.704,62,riffle_clumpy
0,22,23,3,48,0.458,25,0.521,3,3,0.5,0,1,28,20,16,14,18,0.333,0.292,0.375,17.71,63,riffle_clumpy
0,17,25,4,46,0.37,21,0.457,1,3,0.25,1,3,33,13,11,14,21,0.239,0.304,0.457,17.707,64,riffle_clumpy
0,19,24,7,50,0.38,26,0.52,6,2,0.75,3,3,30,20,10,10,30,0.2,0.2,0.6,17.698,65,riffle_clumpy
0,20,19,6,45,0.444,26,0.578,1,1,0.5,5,3,30,15,10,14,21,0.222,0.311,0.467,17.695,66,riffle_clumpy
0,19,23,3,45,0.422,22,0.489,5,1,0.833,3,2,24,21,14,14,17,0.311,0.311,0.378,17.699,67,riffle_clumpy
0,21,21,5,47,0.447,26,0.553,2,3,0.4,3,2,29,18,13,15,19,0.277,0.319,0.404,17.696,68,riffle_clumpy
0,17,23,4,44,0.386,21,0.477,5,4,0.556,2,0,27,17,7,13,24,0.159,0.295,0.545,17.694,69,riffle_clumpy
0,19,22,5,46,0.413,24,0.522,3,5,0.375,2,1,29,17,11,14,21,0.239,0.304,0.457,17.694,70,riffle_clumpy
0,20,20,5,45,0.444,25,0.556,4,0,1.0,2,2,27,18,7,19,19,0.156,0.422,0.422,17.696,71,riffle_clumpy
0,24,17,2,43,0.558,26,0.605,2,4,0.333,2,0,20,23,15,14,14,0.349,0.326,0.326,17.696,72,riffle_clumpy
0,23,21,0,44,0.523,23,0.523,5,2,0.714,2,2,23,21,15,10,19,0.341,0.227,0.432,17.691,73,riffle_clumpy
0,23,19,3,45,0.511,26,0.578,6,2,0.75,1,3,26,19,18,9,18,0.4,0.2,0.4,17.705,74,riffle_clumpy
0,16,28,3,47,0.34,19,0.404,1,1,0.5,3,3,30,17,4,17,26,0.085,0.362,0.553,17.696,75,riffle_clumpy
0,20,22,4,46,0.435,24,0.522,2,3,0.4,2,2,27,19,14,15,17,0.304,0.326,0.37,17.695,76,riffle_clumpy
0,16,27,2,45,0.356,18,0.4,3,2,0.6,3,1,31,14,7,14,24,0.156,0.311,0.533,17.691,77,riffle_clumpy
0,17,25,5,47,0.362,22,0.468,3,4,0.429,2,2,28,19,10,15,22,0.213,0.319,0.468,17.688,78,riffle_clumpy
0,27,17,1,45,0.6,28,0.622,4,2,0.667,2,1,30,15,19,5,21,0.422,0.111,0.467,17.681,79,riffle_clumpy
0,22,20,2,44,0.5,24,0.545,7,3,0.7,1,2,25,19,12,17,15,0.273,0.386,0.341,17.682,80,riffle_clumpy
0,16,23,6,45,0.356,22,0.489,4,3,0.571,2,3,26,19,10,14,21,0.222,0.311,0.467,17.683,81,riffle_clumpy
0,21,24,3,48,0.438,24,0.5,5,1,0.833,4,5,33,15,8,15,25,0.167,0.312,0.521,17.683,82,riffle_clumpy
0,24,22,0,46,0.522,24,0.522,4,2,0.667,0,5,26,20,14,13,19,0.304,0.283,0.413,17.681,83,riffle_clumpy
0,14,28,3,45,0.311,17,0.378,1,1,0.5,1,2,27,18,7,18,20,0.156,0.4,0.444,17.686,84,riffle_clumpy
0,24,20,3,47,0.511,27,0.574,3,1,0.75,1,0,29,18,12,13,22,0.255,0.277,0.468,17.687,85,riffle_clumpy
0,17,25,3,45,0.378,20,0.444,2,2,0.5,3,1,28,17,7,15,23,0.156,0.333,0.511,17.686,86,riffle_clumpy
0,17,23,5,45,0.378,22,0.489,5,3,0.625,1,3,30,15,11,13,21,0.244,0.289,0.467,17.682,87,riffle_clumpy
0,19,25,2,46,0.413,21,0.457,3,2,0.6,1,4,26,20,9,17,20,0.196,0.37,0.435,17.684,88,riffle_clumpy
0,20,20,4,44,0.455,24,0.545,4,2,0.667,0,0,22,22,14,17,13,0.318,0.386,0.295,17.69,89,riffle_clumpy
0,25,19,2,46,0.543,27,0.587,4,2,0.667,5,0,24,22,14,12,20,0.304,0.261,0.435,17.681,90,riffle_clumpy
0,24,19,2,45,0.533,26,0.578,3,4,0.429,2,0,25,20,16,14,15,0.356,0.311,0.333,17.681,91,riffle_clumpy
0,18,23,6,47,0.383,24,0.511,0,2,0.0,4,1,32,15,7,18,22,0.149,0.383,0.468,17.69,92,riffle_clumpy
0,24,18,3,45,0.533,27,0.6,4,3,0.571,5,0,24,21,10,16,19,0.222,0.356,0.422,17.687,93,riffle_clumpy
0,18,26,4,48,0.375,22,0.458,2,3,0.4,2,6,32,16,8,11,29,0.167,0.229,0.604,17.685,94,riffle_clumpy
0,19,16,10,45,0.422,29,0.644,3,0,1.0,1,3,31,14,10,12,23,0.222,0.267,0.511,17.696,95,riffle_clumpy
0,24,20,0,44,0.545,24,0.545,2,0,1.0,2,4,29,15,14,8,22,0.318,0.182,0.5,17.688,96,riffle_clumpy
0,19,21,4,44,0.432,23,0.523,2,1,0.667,2,2,27,17,9,15,20,0.205,0.341,0.455,18.345,1,riffle_clumpy
0,23,15,7,45,0.511,30,0.667,3,1,0.75,2,1,29,16,13,13,19,0.289,0.289,0.422,18.483,2,riffle_clumpy
0,18,22,3,43,0.419,21,0.488,4,1,0.8,0,5,22,21,15,12,16,0.349,0.279,0.372,18.163,3,riffle_clumpy
0,18,23,2,43,0.419,20,0.465,5,3,0.625,2,2,22,21,10,14,19,0.233,0.326,0.442,17.857,4,riffle_clumpy
0,22,21,2,45,0.489,24,0.533,3,2,0.6,3,2,33,12,8,10,27,0.178,0.222,0.6,17.529,5,riffle_clumpy
0,14,28,3,45,0.311,17,0.378,3,2,0.6,0,0,31,14,10,16,19,0.222,0.356,0.422,17.609,6,riffle_clumpy
0,21,19,7,47,0.447,28,0.596,2,3,0.4,2,2,29,18,12,10,25,0.255,0.213,0.532,17.663,7,riffle_clumpy
0,23,18,4,45,0.511,27,0.6,7,1,0.875,3,3,24,21,16,12,17,0.356,0.267,0.378,17.52,8,riffle_clumpy
0,28,13,3,44,0.636,31,0.705,3,2,0.6,2,0,28,16,19,11,14,0.432,0.25,0.318,17.545,9,riffle_clumpy
0,20,22,3,45,0.444,23,0.511,1,0,1.0,2,1,24,21,13,14,18,0.289,0.311,0.4,17.564,10,riffle_clumpy
0,16,23,5,44,0.364,21,0.477,2,1,0.667,1,1,28,16,9,18,17,0.205,0.409,0.386,17.572,11,riffle_clumpy
0,19,18,7,44,0.432,26,0.591,2,1,0.667,0,0,29,15,9,14,21,0.205,0.318,0.477,17.607,12,riffle_clumpy
0,18,25,1,44,0.409,19,0.432,2,3,0.4,1,1,23,21,11,14,19,0.25,0.318,0.432,17.604,13,riffle_clumpy
0,18,24,3,45,0.4,21,0.467,3,4,0.429,1,6,29,16,8,11,26,0.178,0.244,0.578,17.585,14,riffle_clumpy
0,18,24,3,45,0.4,21,0.467,0,2,0.0,2,2,23,22,12,14,19,0.267,0.311,0.422,17.538,15,riffle_clumpy
0,21,21,1,43,0.488,22,0.512,4,2,0.667,1,2,29,14,12,13,18,0.279,0.302,0.419,17.56,16,riffle_clumpy
0,15,26,4,45,0.333,19,0.422,2,3,0.4,1,4,27,18,9,14,22,0.2,0.311,0.489,17.547,17,riffle_clumpy
0,21,22,0,43,0.488,21,0.488,2,2,0.5,1,0,29,14,10,14,19,0.233,0.326,0.442,17.577,18,riffle_clumpy
0,20,21,4,45,0.444,24,0.533,3,4,0.429,2,3,29,16,10,10,25,0.222,0.222,0.556,17.595,19,riffle_clumpy
0,14,26,7,47,0.298,21,0.447,5,4,0.556,0,2,27,20,6,19,22,0.128,0.404,0.468,17.651,20,riffle_clumpy
0,21,19,3,43,0.488,24,0.558,4,2,0.667,0,1,23,20,12,13,18,0.279,0.302,0.419,17.646,21,riffle_clumpy
0,15,23,5,43,0.349,20,0.465,0,1,0.0,1,0,25,18,8,21,14,0.186,0.488,0.326,17.676,22,riffle_clumpy
0,13,22,7,42,0.31,20,0.476,4,4,0.5,1,1,30,12,9,12,21,0.214,0.286,0.5,17.702,23,riffle_clumpy
0,19,21,2,42,0.452,21,0.5,5,1,0.833,1,1,28,14,15,10,17,0.357,0.238,0.405,17.696,24,riffle_clumpy
0,16,27,3,46,0.348,19,0.413,2,1,0.667,1,1,25,21,11,14,21,0.239,0.304,0.457,17.701,25,riffle_clumpy
0,14,25,5,44,0.318,19,0.432,2,4,0.333,1,3,29,15,11,12,21,0.25,0.273,0.477,17.711,26,riffle_clumpy
0,19,20,5,44,0.432,24,0.545,3,4,0.429,1,1,22,22,13,16,15,0.295,0.364,0.341,17.711,27,riffle_clumpy
0,25,17,2,44,0.568,27,0.614,2,0,1.0,2,1,26,18,17,15,12,0.386,0.341,0.273,17.688,28,riffle_clumpy
0,21,21,3,45,0.467,24,0.533,3,4,0.429,3,3,28,17,10,13,22,0.222,0.289,0.489,17.704,29,riffle_clumpy
0,14,27,3,44,0.318,17,0.386,0,4,0.0,1,0,30,14,8,16,20,0.182,0.364,0.455,17.678,30,riffle_clumpy
0,22,20,2,44,0.5,24,0.545,3,0,1.0,2,1,30,14,10,9,25,0.227,0.205,0.568,17.667,31,riffle_clumpy
0,16,27,2,45,0.356,18,0.4,1,4,0.2,1,2,28,17,11,15,19,0.244,0.333,0.422,17.674,32,riffle_clumpy
0,18,25,2,45,0.4,20,0.444,3,2,0.6,2,6,24,21,10,16,19,0.222,0.356,0.422,17.671,33,riffle_clumpy
0,29,12,5,46,0.63,34,0.739,3,1,0.75,2,0,26,20,15,15,16,0.326,0.326,0.348,17.665,34,riffle_clumpy
0,21,25,2,48,0.438,23,0.479,1,3,0.25,0,3,29,19,12,15,21,0.25,0.312,0.438,17.655,35,riffle_clumpy
0,20,24,3,47,0.426,23,0.489,3,6,0.333,3,2,29,18,9,15,23,0.191,0.319,0.489,17.641,36,riffle_clumpy
0,21,19,3,43,0.488,24,0.558,5,0,1.0,0,6,29,14,12,12,19,0.279,0.279,0.442,17.636,37,riffle_clumpy
0,15,26,3,44,0.341,18,0.409,4,2,0.667,0,4,34,10,6,13,25,0.136,0.295,0.568,17.653,38,riffle_clumpy
0,21,18,5,44,0.477,26,0.591,6,1,0.857,1,3,28,16,11,13,20,0.25,0.295,0.455,17.669,39,riffle_clumpy
0,28,15,6,49,0.571,34,0.694,2,0,1.0,1,1,30,19,17,13,19,0.347,0.265,0.388,17.684,40,riffle_clumpy
0,15,28,2,45,0.333,17,0.378,0,5,0.0,0,1,28,17,5,15,25,0.111,0.333,0.556,17.689,41,riffle_clumpy
0,22,21,3,46,0.478,25,0.543,6,0,1.0,2,3,21,25,13,14,19,0.283,0.304,0.413,17.695,42,riffle_clumpy
0,18,27,2,47,0.383,20,0.426,3,4,0.429,0,2,24,23,11,17,19,0.234,0.362,0.404,17.693,43,riffle_clumpy
0,24,21,4,49,0.49,28,0.571,1,0,1.0,0,2,29,20,20,9,20,0.408,0.184,0.408,17.705,44,riffle_clumpy
0,22,16,7,45,0.489,29,0.644,4,2,0.667,3,3,29,16,11,13,21,0.244,0.289,0.467,17.71,45,riffle_clumpy
0,19,26,3,48,0.396,22,0.458,2,3,0.4,3,2,32,16,9,17,22,0.188,0.354,0.458,17.716,46,riffle_clumpy
0,19,23,6,48,0.396,25,0.521,2,3,0.4,4,3,29,19,6,20,22,0.125,0.417,0.458,17.721,47,riffle_clumpy
0,21,22,6,49,0.429,27,0.551,2,2,0.5,2,3,34,15,10,15,24,0.204,0.306,0.49,17.721,48,riffle_clumpy
0,15,30,2,47,0.319,17,0.362,2,5,0.286,1,3,29,18,9,15,23,0.191,0.319,0.489,17.738,49,riffle_clumpy
0,19,20,7,46,0.413,26,0.565,2,4,0.333,5,1,33,13,10,14,22,0.217,0.304,0.478,17.731,50,riffle_clumpy
0,25,16,3,44,0.568,28,0.636,5,0,1.0,2,1,28,16,14,13,17,0.318,0.295,0.386,17.732,51,riffle_clumpy
0,18,22,8,48,0.375,26,0.542,2,2,0.5,0,1,33,15,8,17,23,0.167,0.354,0.479,17.734,52,riffle_clumpy
0,19,22,3,44,0.432,22,0.5,4,2,0.667,2,1,27,17,9,10,25,0.205,0.227,0.568,17.74,53,riffle_clumpy
0,21,25,2,48,0.438,23,0.479,2,3,0.4,3,0,27,21,10,12,26,0.208,0.25,0.542,17.713,54,riffle_clumpy
0,24,20,5,49,0.49,29,0.592,5,3,0.625,3,3,29,20,11,16,22,0.224,0.327,0.449,17.713,55,riffle_clumpy
0,19,25,5,49,0.388,24,0.49,2,1,0.667,1,4,30,19,13,15,21,0.265,0.306,0.429,17.716,56,riffle_clumpy
0,20,22,2,44,0.455,22,0.5,5,2,0.714,1,1,27,17,10,16,18,0.227,0.364,0.409,17.719,57,riffle_clumpy
0,22,18,3,43,0.512,25,0.581,5,1,0.833,1,0,23,20,16,11,16,0.372,0.256,0.372,17.719,58,riffle_clumpy
0,18,25,4,47,0.383,22,0.468,3,3,0.5,1,2,25,22,12,15,20,0.255,0.319,0.426,17.717,59,riffle_clumpy
0,18,22,6,46,0.391,24,0.522,3,1,0.75,1,3,36,10,7,16,23,0.152,0.348,0.5,17.725,60,riffle_clumpy
0,23,19,4,46,0.5,27,0.587,3,2,0.6,4,2,26,20,10,14,22,0.217,0.304,0.478,17.721,61,riffle_clumpy
0,18,23,5,46,0.391,23,0.5,4,3,0.571,3,2,28,18,9,13,24,0.196,0.283,0.522,17.715,62,riffle_clumpy
0,17,22,4,43,0.395,21,0.488,0,2,0.0,1,2,19,24,10,19,14,0.233,0.442,0.326,17.716,63,riffle_clumpy
0,15,25,3,43,0.349,18,0.419,2,2,0.5,1,3,32,11,6,16,21,0.14,0.372,0.488,17.708,64,riffle_clumpy
0,23,22,4,49,0.469,27,0.551,6,5,0.545,3,2,30,19,11,11,27,0.224,0.224,0.551,17.698,65,riffle_clumpy
0,19,20,4,43,0.442,23,0.535,2,0,1.0,2,0,26,17,9,16,18,0.209,0.372,0.419,17.701,66,riffle_clumpy
0,23,18,5,46,0.5,28,0.609,8,1,0.889,4,1,29,17,15,9,22,0.326,0.196,0.478,17.686,67,riffle_clumpy
0,23,21,2,46,0.5,25,0.543,3,3,0.5,1,2,27,19,14,15,17,0.304,0.326,0.37,17.683,68,riffle_clumpy
0,14,30,2,46,0.304,16,0.348,1,4,0.2,2,1,29,17,6,15,25,0.13,0.326,0.543,17.683,69,riffle_clumpy
0,19,24,0,43,0.442,19,0.442,3,2,0.6,1,1,26,17,13,11,19,0.302,0.256,0.442,17.686,70,riffle_clumpy
0,20,24,1,45,0.444,21,0.467,5,0,1.0,1,2,19,26,15,14,16,0.333,0.311,0.356,17.688,71,riffle_clumpy
0,16,26,1,43,0.372,17,0.395,1,5,0.167,0,1,29,14,9,16,18,0.209,0.372,0.419,17.702,72,riffle_clumpy
0,27,19,2,48,0.562,29,0.604,3,1,0.75,1,2,26,22,16,14,18,0.333,0.292,0.375,17.693,73,riffle_clumpy
0,24,18,5,47,0.511,29,0.617,4,5,0.444,4,1,33,14,14,9,24,0.298,0.191,0.511,17.686,74,riffle_clumpy
0,18,23,3,44,0.409,21,0.477,1,2,0.333,3,2,31,13,9,17,18,0.205,0.386,0.409,17.681,75,riffle_clumpy
0,19,23,4,46,0.413,23,0.5,4,2,0.667,2,2,27,19,7,17,22,0.152,0.37,0.478,17.679,76,riffle_clumpy
0,21,19,4,44,0.477,25,0.568,7,2,0.778,1,4,26,18,16,14,14,0.364,0.318,0.318,17.688,77,riffle_clumpy
0,21,23,3,47,0.447,24,0.511,2,3,0.4,5,2,28,19,10,13,24,0.213,0.277,0.511,17.689,78,riffle_clumpy
0,23,21,3,47,0.489,26,0.553,1,3,0.25,3,2,27,20,12,13,22,0.255,0.277,0.468,17.686,79,riffle_clumpy
0,21,21,3,45,0.467,24,0.533,2,0,1.0,0,5,29,16,15,11,19,0.333,0.244,0.422,17.689,80,riffle_clumpy
0,23,20,3,46,0.5,26,0.565,4,3,0.571,1,3,24,22,16,10,20,0.348,0.217,0.435,17.688,81,riffle_clumpy
0,16,23,7,46,0.348,23,0.5,2,3,0.4,1,3,29,17,11,12,23,0.239,0.261,0.5,17.689,82,riffle_clumpy
0,18,25,2,45,0.4,20,0.444,1,2,0.333,3,1,28,17,7,15,23,0.156,0.333,0.511,17.687,83,riffle_clumpy
0,14,28,4,46,0.304,18,0.391,1,2,0.333,1,3,32,14,4,20,22,0.087,0.435,0.478,17.692,84,riffle_clumpy
0,20,21,6,47,0.426,26,0.553,2,0,1.0,2,1,27,20,9,15,23,0.191,0.319,0.489,17.685,85,riffle_clumpy
0,22,17,6,45,0.489,28,0.622,4,0,1.0,1,1,30,15,10,19,16,0.222,0.422,0.356,17.683,86,riffle_clumpy
0,22,20,4,46,0.478,26,0.565,5,2,0.714,3,2,23,23,9,16,21,0.196,0.348,0.457,17.678,87,riffle_clumpy
0,16,26,3,45,0.356,19,0.422,1,5,0.167,1,5,23,22,12,13,20,0.267,0.289,0.444,17.669,88,riffle_clumpy
0,27,18,2,47,0.574,29,0.617,5,3,0.625,2,0,23,24,14,14,19,0.298,0.298,0.404,17.668,89,riffle_clumpy
0,24,20,3,47,0.511,27,0.574,3,0,1.0,1,1,31,16,14,11,22,0.298,0.234,0.468,17.665,90,riffle_clumpy
0,22,22,2,46,0.478,24,0.522,1,2,0.333,3,1,29,17,10,16,20,0.217,0.348,0.435,17.655,91,riffle_clumpy
0,19,22,3,44,0.432,22,0.5,4,3,0.571,0,3,27,17,13,13,18,0.295,0.295,0.409,17.666,92,riffle_clumpy
0,18,22,5,45,0.4,23,0.511,2,2,0.5,1,1,30,15,10,14,21,0.222,0.311,0.467,17.666,93,riffle_clumpy
0,15,24,6,45,0.333,21,0.467,1,0,1.0,4,5,28,17,5,18,22,0.111,0.4,0.489,17.669,94,riffle_clumpy
0,19,21,4,44,0.432,23,0.523,3,2,0.6,2,1,31,13,11,5,28,0.25,0.114,0.636,17.67,95,riffle_clumpy
0,15,23,5,43,0.349,20,0.465,2,0,1.0,1,3,26,17,9,14,20,0.209,0.326,0.465,17.672,96,riffle_clumpy
0,19,18,10,47,0.404,29,0.617,2,3,0.4,1,1,28,19,7,20,20,0.149,0.426,0.426,17.944,1,riffle_clumpy
0,15,26,7,48,0.312,22,0.458,4,2,0.667,3,1,37,11,7,16,25,0.146,0.333,0.521,17.806,2,riffle_clumpy
0,21,21,1,43,0.488,22,0.512,4,3,0.571,3,1,24,19,15,12,16,0.349,0.279,0.372,17.811,3,riffle_clumpy
0,19,21,4,44,0.432,23,0.523,2,1,0.667,1,0,18,26,12,16,16,0.273,0.364,0.364,17.874,4,riffle_clumpy
0,18,25,1,44,0.409,19,0.432,2,4,0.333,1,1,25,19,12,16,16,0.273,0.364,0.364,17.928,5,riffle_clumpy
0,22,27,2,51,0.431,24,0.471,4,3,0.571,1,1,33,18,13,20,18,0.255,0.392,0.353,17.911,6,riffle_clumpy
0,21,22,3,46,0.457,24,0.522,3,2,0.6,1,0,32,14,12,13,21,0.261,0.283,0.457,17.871,7,riffle_clumpy
0,20,20,4,44,0.455,24,0.545,3,0,1.0,2,2,28,16,14,12,18,0.318,0.273,0.409,17.87,8,riffle_clumpy
0,19,20,5,44,0.432,24,0.545,2,1,0.667,0,3,27,17,13,10,21,0.295,0.227,0.477,17.853,9,riffle_clumpy
0,16,24,8,48,0.333,24,0.5,0,2,0.0,4,4,34,14,5,13,30,0.104,0.271,0.625,17.731,10,riffle_clumpy
0,13,27,6,46,0.283,19,0.413,3,1,0.75,0,0,30,16,7,15,24,0.152,0.326,0.522,17.763,11,riffle_clumpy
0,19,19,7,45,0.422,26,0.578,2,1,0.667,3,1,28,17,9,13,23,0.2,0.289,0.511,17.727,12,riffle_clumpy
0,22,17,5,44,0.5,27,0.614,2,2,0.5,0,3,23,21,9,14,21,0.205,0.318,0.477,17.732,13,riffle_clumpy
0,25,15,4,44,0.568,29,0.659,10,0,1.0,2,2,30,14,14,7,23,0.318,0.159,0.523,17.666,14,riffle_clumpy
0,16,23,9,48,0.333,25,0.521,2,1,0.667,3,3,30,18,7,12,29,0.146,0.25,0.604,17.682,15,riffle_clumpy
0,20,23,2,45,0.444,22,0.489,1,5,0.167,4,3,31,14,9,16,20,0.2,0.356,0.444,17.687,16,riffle_clumpy
0,19,21,6,46,0.413,25,0.543,1,2,0.333,2,2,33,13,8,17,21,0.174,0.37,0.457,17.705,17,riffle_clumpy
0,23,17,6,46,0.5,29,0.63,4,0,1.0,2,3,33,13,11,14,21,0.239,0.304,0.457,17.691,18,riffle_clumpy
0,15,23,7,45,0.333,22,0.489,2,2,0.5,3,3,29,16,8,17,20,0.178,0.378,0.444,17.724,19,riffle_clumpy
0,12,28,4,44,0.273,16,0.364,2,0,1.0,3,2,29,15,7,11,26,0.159,0.25,0.591,17.711,20,riffle_clumpy
0,17,27,4,48,0.354,21,0.438,5,2,0.714,1,5,31,17,11,10,27,0.229,0.208,0.562,17.72,21,riffle_clumpy
0,17,23,3,43,0.395,20,0.465,3,3,0.5,1,4,21,22,12,13,18,0.279,0.302,0.419,17.7,22,riffle_clumpy
0,19,21,4,44,0.432,23,0.523,3,0,1.0,1,1,29,15,12,10,22,0.273,0.227,0.5,17.713,23,riffle_clumpy
0,18,22,5,45,0.4,23,0.511,2,2,0.5,2,2,31,14,11,17,17,0.244,0.378,0.378,17.72,24,riffle_clumpy
0,24,16,4,44,0.545,28,0.636,4,0,1.0,5,1,27,17,13,12,19,0.295,0.273,0.432,17.726,25,riffle_clumpy
0,16,29,1,46,0.348,17,0.37,2,5,0.286,0,3,24,22,10,19,17,0.217,0.413,0.37,17.704,26,riffle_clumpy
0,24,21,2,47,0.511,26,0.553,1,3,0.25,5,2,28,19,12,14,21,0.255,0.298,0.447,17.675,27,riffle_clumpy
0,21,23,4,48,0.438,25,0.521,2,3,0.4,2,3,28,20,11,18,19,0.229,0.375,0.396,17.686,28,riffle_clumpy
0,23,24,2,49,0.469,25,0.51,5,2,0.714,4,3,26,23,11,13,25,0.224,0.265,0.51,17.643,29,riffle_clumpy
0,18,23,4,45,0.4,22,0.489,3,1,0.75,2,2,26,19,8,19,18,0.178,0.422,0.4,17.641,30,riffle_clumpy
0,20,22,4,46,0.435,24,0.522,1,2,0.333,3,3,28,18,8,14,24,0.174,0.304,0.522,17.651,31,riffle_clumpy
0,22,22,4,48,0.458,26,0.542,3,5,0.375,4,1,23,25,7,23,18,0.146,0.479,0.375,17.666,32,riffle_clumpy
0,21,23,5,49,0.429,26,0.531,4,0,1.0,4,4,27,22,13,15,21,0.265,0.306,0.429,17.667,33,riffle_clumpy
0,20,20,5,45,0.444,25,0.556,4,1,0.8,4,3,26,19,12,13,20,0.267,0.289,0.444,17.64,34,riffle_clumpy
0,22,20,5,47,0.468,27,0.574,2,2,0.5,5,2,21,26,12,14,21,0.255,0.298,0.447,17.62,35,riffle_clumpy
0,26,19,1,46,0.565,27,0.587,5,1,0.833,4,3,28,18,17,9,20,0.37,0.196,0.435,17.601,36,riffle_clumpy
0,19,19,8,46,0.413,27,0.587,4,2,0.667,1,3,25,21,10,23,13,0.217,0.5,0.283,17.613,37,riffle_clumpy
0,14,24,7,45,0.311,21,0.467,0,3,0.0,2,5,29,16,4,18,23,0.089,0.4,0.511,17.619,38,riffle_clumpy
0,18,19,7,44,0.409,25,0.568,4,2,0.667,1,1,26,18,12,14,18,0.273,0.318,0.409,17.648,39,riffle_clumpy
0,19,16,9,44,0.432,28,0.636,4,2,0.667,0,1,29,15,10,14,20,0.227,0.318,0.455,17.653,40,riffle_clumpy
0,19,27,1,47,0.404,20,0.426,6,1,0.857,2,2,31,16,10,13,24,0.213,0.277,0.511,17.658,41,riffle_clumpy
0,20,23,2,45,0.444,22,0.489,2,1,0.667,4,0,31,14,10,15,20,0.222,0.333,0.444,17.651,42,riffle_clumpy
0,15,27,3,45,0.333,18,0.4,3,1,0.75,2,1,24,21,8,19,18,0.178,0.422,0.4,17.661,43,riffle_clumpy
0,20,23,4,47,0.426,24,0.511,4,1,0.8,2,3,24,23,13,13,21,0.277,0.277,0.447,17.676,44,riffle_clumpy
0,20,22,2,44,0.455,22,0.5,4,4,0.5,2,2,24,20,11,15,18,0.25,0.341,0.409,17.691,45,riffle_clumpy
0,21,23,4,48,0.438,25,0.521,2,2,0.5,2,3,25,23,12,14,22,0.25,0.292,0.458,17.685,46,riffle_clumpy
0,21,21,5,47,0.447,26,0.553,3,1,0.75,4,4,29,18,9,14,24,0.191,0.298,0.511,17.694,47,riffle_clumpy
0,22,20,2,44,0.5,24,0.545,2,3,0.4,3,0,30,14,11,10,23,0.25,0.227,0.523,17.687,48,riffle_clumpy
0,21,16,7,44,0.477,28,0.636,1,0,1.0,4,2,27,17,14,9,21,0.318,0.205,0.477,17.674,49,riffle_clumpy
0,20,24,3,47,0.426,23,0.489,7,2,0.778,1,2,27,20,11,19,17,0.234,0.404,0.362,17.682,50,riffle_clumpy
0,22,23,4,49,0.449,26,0.531,4,4,0.5,0,2,26,23,18,11,20,0.367,0.224,0.408,17.687,51,riffle_clumpy
0,22,17,4,43,0.512,26,0.605,5,0,1.0,1,1,27,16,14,12,17,0.326,0.279,0.395,17.692,52,riffle_clumpy
0,18,27,5,50,0.36,23,0.46,7,1,0.875,2,4,30,20,11,15,24,0.22,0.3,0.48,17.686,53,riffle_clumpy
0,16,21,8,45,0.356,24,0.533,1,3,0.25,1,1,35,10,9,9,27,0.2,0.2,0.6,17.683,54,riffle_clumpy
0,21,20,3,44,0.477,24,0.545,2,3,0.4,1,2,29,15,8,14,22,0.182,0.318,0.5,17.686,55,riffle_clumpy
0,13,29,3,45,0.289,16,0.356,4,0,1.0,3,5,25,20,7,15,23,0.156,0.333,0.511,17.67,56,riffle_clumpy
0,22,20,5,47,0.468,27,0.574,3,1,0.75,3,1,33,14,9,10,28,0.191,0.213,0.596,17.656,57,riffle_clumpy
0,17,21,7,45,0.378,24,0.533,1,1,0.5,2,1,26,19,6,20,19,0.133,0.444,0.422,17.666,58,riffle_clumpy
0,16,23,5,44,0.364,21,0.477,0,3,0.0,2,1,33,11,8,13,23,0.182,0.295,0.523,17.665,59,riffle_clumpy
0,20,22,3,45,0.444,23,0.511,5,4,0.556,2,0,28,17,10,20,15,0.222,0.444,0.333,17.654,60,riffle_clumpy
0,23,18,3,44,0.523,26,0.591,2,2,0.5,2,1,24,20,13,15,16,0.295,0.341,0.364,17.655,61,riffle_clumpy
0,17,23,5,45,0.378,22,0.489,0,4,0.0,1,3,31,14,10,13,22,0.222,0.289,0.489,17.65,62,riffle_clumpy
0,20,21,4,45,0.444,24,0.533,2,2,0.5,4,3,26,19,10,13,22,0.222,0.289,0.489,17.642,63,riffle_clumpy
0,21,16,6,43,0.488,27,0.628,2,1,0.667,0,2,29,14,15,7,21,0.349,0.163,0.488,17.64,64,riffle_clumpy
0,18,22,4,44,0.409,22,0.5,5,3,0.625,1,3,23,21,12,16,16,0.273,0.364,0.364,17.649,65,riffle_clumpy
0,23,19,4,46,0.5,27,0.587,7,1,0.875,1,2,27,19,13,11,22,0.283,0.239,0.478,17.657,66,riffle_clumpy
0,17,24,7,48,0.354,24,0.5,1,8,0.111,0,1,26,22,12,21,15,0.25,0.438,0.312,17.663,67,riffle_clumpy
0,16,19,8,43,0.372,24,0.558,0,2,0.0,1,0,35,8,8,12,23,0.186,0.279,0.535,17.665,68,riffle_clumpy
0,13,28,7,48,0.271,20,0.417,1,3,0.25,4,2,32,16,5,15,28,0.104,0.312,0.583,17.667,69,riffle_clumpy
0,22,22,3,47,0.468,25,0.532,2,1,0.667,2,2,25,22,9,21,17,0.191,0.447,0.362,17.667,70,riffle_clumpy
0,16,27,2,45,0.356,18,0.4,2,7,0.222,0,3,24,21,10,19,16,0.222,0.422,0.356,17.679,71,riffle_clumpy
0,20,21,3,44,0.455,23,0.523,2,0,1.0,3,3,27,17,9,15,20,0.205,0.341,0.455,17.689,72,riffle_clumpy
0,19,20,7,46,0.413,26,0.565,3,6,0.333,1,0,23,23,11,18,17,0.239,0.391,0.37,17.689,73,riffle_clumpy
0,19,23,3,45,0.422,22,0.489,1,0,1.0,2,2,36,9,9,12,24,0.2,0.267,0.533,17.69,74,riffle_clumpy
0,15,25,5,45,0.333,20,0.444,4,2,0.667,0,2,25,20,9,16,20,0.2,0.356,0.444,17.698,75,riffle_clumpy
0,22,20,3,45,0.489,25,0.556,4,1,0.8,2,1,26,19,12,12,21,0.267,0.267,0.467,17.689,76,riffle_clumpy
0,22,20,3,45,0.489,25,0.556,4,2,0.667,2,0,23,22,11,12,22,0.244,0.267,0.489,17.685,77,riffle_clumpy
0,23,20,2,45,0.511,25,0.556,2,3,0.4,1,3,33,12,9,13,23,0.2,0.289,0.511,17.685,78,riffle_clumpy
0,20,20,5,45,0.444,25,0.556,4,1,0.8,2,1,25,20,11,17,17,0.244,0.378,0.378,17.689,79,riffle_clumpy
0,19,21,6,46,0.413,25,0.543,3,0,1.0,0,3,27,19,11,17,18,0.239,0.37,0.391,17.692,80,riffle_clumpy
0,17,24,3,44,0.386,20,0.455,6,1,0.857,0,1,29,15,10,20,14,0.227,0.455,0.318,17.694,81,riffle_clumpy
0,11,32,2,45,0.244,13,0.289,2,2,0.5,1,3,28,17,8,14,23,0.178,0.311,0.511,17.693,82,riffle_clumpy
0,24,20,3,47,0.511,27,0.574,3,0,1.0,3,6,26,21,12,14,21,0.255,0.298,0.447,17.694,83,riffle_clumpy
0,20,24,1,45,0.444,21,0.467,2,3,0.4,4,2,26,19,10,16,19,0.222,0.356,0.422,17.693,84,riffle_clumpy
0,24,14,7,45,0.533,31,0.689,2,2,0.5,3,0,25,20,9,20,16,0.2,0.444,0.356,17.691,85,riffle_clumpy
0,19,20,5,44,0.432,24,0.545,2,1,0.667,1,2,29,15,6,15,23,0.136,0.341,0.523,17.702,86,riffle_clumpy
0,19,21,3,43,0.442,22,0.512,6,2,0.75,1,4,26,17,13,8,22,0.302,0.186,0.512,17.698,87,riffle_clumpy
0,14,30,0,44,0.318,14,0.318,4,2,0.667,0,1,28,16,9,15,20,0.205,0.341,0.455,17.714,88,riffle_clumpy
0,19,20,5,44,0.432,24,0.545,3,3,0.5,1,1,31,13,14,14,16,0.318,0.318,0.364,17.714,89,riffle_clumpy
0,22,21,2,45,0.489,24,0.533,5,1,0.833,4,3,27,18,10,12,23,0.222,0.267,0.511,17.707,90,riffle_clumpy
0,21,21,4,46,0.457,25,0.543,4,0,1.0,2,2,33,13,11,15,20,0.239,0.326,0.435,17.705,91,riffle_clumpy
0,19,21,6,46,0.413,25,0.543,3,2,0.6,2,0,23,23,11,18,17,0.239,0.391,0.37,17.705,92,riffle_clumpy
0,18,24,3,45,0.4,21,0.467,4,1,0.8,1,2,32,13,7,16,22,0.156,0.356,0.489,17.703,93,riffle_clumpy
0,15,27,3,45,0.333,18,0.4,3,2,0.6,2,3,26,19,9,16,20,0.2,0.356,0.444,17.7,94,riffle_clumpy
0,17,23,2,42,0.405,19,0.452,3,3,0.5,1,1,27,15,12,15,15,0.286,0.357,0.357,17.701,95,riffle_clumpy
0,20,21,3,44,0.455,23,0.523,2,3,0.4,0,1,27,17,16,11,17,0.364,0.25,0.386,17.706,96,riffle_clumpy
0,19,17,7,43,0.442,26,0.605,2,3,0.4,2,1,31,12,13,9,21,0.302,0.209,0.488,18.292,1,riffle_clumpy
0,18,22,3,43,0.419,21,0.488,2,3,0.4,2,0,26,17,13,9,21,0.302,0.209,0.488,17.745,2,riffle_clumpy
0,26,16,4,46,0.565,30,0.652,8,1,0.889,6,1,27,19,14,8,24,0.304,0.174,0.522,17.438,3,riffle_clumpy
0,19,23,6,48,0.396,25,0.521,1,4,0.2,3,4,29,19,9,20,19,0.188,0.417,0.396,17.393,4,riffle_clumpy
0,25,17,6,48,0.521,31,0.646,7,5,0.583,2,0,22,26,18,15,15,0.375,0.312,0.312,17.474,5,riffle_clumpy
0,20,19,3,42,0.476,23,0.548,2,2,0.5,2,2,27,15,17,9,16,0.405,0.214,0.381,17.468,6,riffle_clumpy
0,21,23,2,46,0.457,23,0.5,3,1,0.75,2,3,27,19,11,13,22,0.239,0.283,0.478,17.55,7,riffle_clumpy
0,21,18,6,45,0.467,27,0.6,2,3,0.4,2,2,27,18,9,17,19,0.2,0.378,0.422,17.568,8,riffle_clumpy
0,24,15,4,43,0.558,28,0.651,8,0,1.0,2,0,29,14,12,14,17,0.279,0.326,0.395,17.589,9,riffle_clumpy
0,19,23,2,44,0.432,21,0.477,4,0,1.0,2,1,27,17,11,17,16,0.25,0.386,0.364,17.61,10,riffle_clumpy
0,17,23,6,46,0.37,23,0.5,2,1,0.667,2,2,28,18,11,15,20,0.239,0.326,0.435,17.654,11,riffle_clumpy
0,20,24,0,44,0.455,20,0.455,7,0,1.0,2,1,22,22,11,13,20,0.25,0.295,0.455,17.586,12,riffle_clumpy
0,19,23,1,43,0.442,20,0.465,3,1,0.75,0,5,27,16,12,16,15,0.279,0.372,0.349,17.62,13,riffle_clumpy
0,21,21,3,45,0.467,24,0.533,2,3,0.4,2,3,28,17,10,13,22,0.222,0.289,0.489,17.642,14,riffle_clumpy
0,18,24,5,47,0.383,23,0.489,2,0,1.0,4,2,30,17,6,16,25,0.128,0.34,0.532,17.657,15,riffle_clumpy
0,13,25,8,46,0.283,21,0.457,2,2,0.5,1,2,32,14,6,16,24,0.13,0.348,0.522,17.705,16,riffle_clumpy
0,17,22,9,48,0.354,26,0.542,1,1,0.5,2,2,25,23,10,17,21,0.208,0.354,0.438,17.696,17,riffle_clumpy
0,13,24,7,44,0.295,20,0.455,2,4,0.333,2,1,32,12,5,15,24,0.114,0.341,0.545,17.726,18,riffle_clumpy
0,13,28,5,46,0.283,18,0.391,2,3,0.4,1,3,30,16,8,13,25,0.174,0.283,0.543,17.67,19,riffle_clumpy
0,27,13,3,43,0.628,30,0.698,1,1,0.5,4,2,26,17,21,5,17,0.488,0.116,0.395,17.659,20,riffle_clumpy
0,14,27,2,43,0.326,16,0.372,0,6,0.0,2,1,29,14,10,16,17,0.233,0.372,0.395,17.678,21,riffle_clumpy
0,20,24,1,45,0.444,21,0.467,4,4,0.5,3,4,22,23,9,14,22,0.2,0.311,0.489,17.626,22,riffle_clumpy
0,26,19,1,46,0.565,27,0.587,3,4,0.429,5,1,20,26,13,16,17,0.283,0.348,0.37,17.566,23,riffle_clumpy
0,24,16,6,46,0.522,30,0.652,1,1,0.5,4,1,24,22,11,19,16,0.239,0.413,0.348,17.565,24,riffle_clumpy
0,16,23,3,42,0.381,19,0.452,5,3,0.625,3,2,30,12,10,11,21,0.238,0.262,0.5,17.547,25,riffle_clumpy
0,23,21,3,47,0.489,26,0.553,2,2,0.5,6,2,31,16,11,11,25,0.234,0.234,0.532,17.493,26,riffle_clumpy
0,14,30,1,45,0.311,15,0.333,1,4,0.2,1,6,24,21,9,17,19,0.2,0.378,0.422,17.517,27,riffle_clumpy
0,19,22,6,47,0.404,25,0.532,2,2,0.5,4,4,23,24,10,18,19,0.213,0.383,0.404,17.529,28,riffle_clumpy
0,18,26,2,46,0.391,20,0.435,2,0,1.0,3,1,34,12,10,12,24,0.217,0.261,0.522,17.525,29,riffle_clumpy
0,26,22,0,48,0.542,26,0.542,8,0,1.0,2,0,25,23,19,11,18,0.396,0.229,0.375,17.532,30,riffle_clumpy
0,20,21,5,46,0.435,25,0.543,3,1,0.75,2,1,21,25,11,19,16,0.239,0.413,0.348,17.543,31,riffle_clumpy
0,22,17,7,46,0.478,29,0.63,5,2,0.714,4,2,25,21,10,19,17,0.217,0.413,0.37,17.559,32,riffle_clumpy
0,23,23,1,47,0.489,24,0.511,5,0,1.0,1,5,27,20,16,9,22,0.34,0.191,0.468,17.57,33,riffle_clumpy
0,25,18,2,45,0.556,27,0.6,2,2,0.5,4,3,25,20,14,9,22,0.311,0.2,0.489,17.567,34,riffle_clumpy
0,15,26,3,44,0.341,18,0.409,1,5,0.167,1,3,24,20,12,11,21,0.273,0.25,0.477,17.595,35,riffle_clumpy
0,22,24,2,48,0.458,24,0.5,1,4,0.2,2,1,20,28,12,22,14,0.25,0.458,0.292,17.608,36,riffle_clumpy
0,11,32,5,48,0.229,16,0.333,1,8,0.111,0,8,30,18,8,16,24,0.167,0.333,0.5,17.624,37,riffle_clumpy
0,21,19,6,46,0.457,27,0.587,3,3,0.5,2,4,32,14,11,16,19,0.239,0.348,0.413,17.629,38,riffle_clumpy
0,21,16,8,45,0.467,29,0.644,4,3,0.571,3,4,27,18,15,9,21,0.333,0.2,0.467,17.631,39,riffle_clumpy
0,18,22,3,43,0.419,21,0.488,3,3,0.5,1,3,29,14,9,13,21,0.209,0.302,0.488,17.624,40,riffle_clumpy
0,22,18,3,43,0.512,25,0.581,3,3,0.5,2,2,21,22,13,15,15,0.302,0.349,0.349,17.632,41,riffle_clumpy
0,16,25,4,45,0.356,20,0.444,0,5,0.0,0,0,26,19,8,23,14,0.178,0.511,0.311,17.654,42,riffle_clumpy
0,21,21,2,44,0.477,23,0.523,1,2,0.333,1,3,30,14,13,11,20,0.295,0.25,0.455,17.669,43,riffle_clumpy
0,21,18,6,45,0.467,27,0.6,7,2,0.778,2,5,30,15,12,9,24,0.267,0.2,0.533,17.68,44,riffle_clumpy
0,22,17,6,45,0.489,28,0.622,3,3,0.5,4,1,26,19,12,15,18,0.267,0.333,0.4,17.682,45,riffle_clumpy
0,26,18,3,47,0.553,29,0.617,7,3,0.7,2,3,28,19,14,11,22,0.298,0.234,0.468,17.694,46,riffle_clumpy
0,18,22,3,43,0.419,21,0.488,0,7,0.0,1,0,24,19,12,15,16,0.279,0.349,0.372,17.699,47,riffle_clumpy
0,20,23,1,44,0.455,21,0.477,6,3,0.667,2,4,26,18,11,14,19,0.25,0.318,0.432,17.698,48,riffle_clumpy
0,19,26,2,47,0.404,21,0.447,1,4,0.2,5,5,31,16,11,15,21,0.234,0.319,0.447,17.679,49,riffle_clumpy
0,26,19,2,47,0.553,28,0.596,8,0,1.0,4,1,33,14,14,8,25,0.298,0.17,0.532,17.67,50,riffle_clumpy
0,15,25,5,45,0.333,20,0.444,6,4,0.6,2,3,29,16,9,15,21,0.2,0.333,0.467,17.677,51,riffle_clumpy
0,19,24,3,46,0.413,22,0.478,2,0,1.0,0,2,31,15,8,16,22,0.174,0.348,0.478,17.689,52,riffle_clumpy
0,19,19,4,42,0.452,23,0.548,5,1,0.833,0,0,30,12,8,14,20,0.19,0.333,0.476,17.7,53,riffle_clumpy
0,24,14,6,44,0.545,30,0.682,3,2,0.6,1,0,26,18,13,15,16,0.295,0.341,0.364,17.698,54,riffle_clumpy
0,26,12,5,43,0.605,31,0.721,3,0,1.0,6,1,25,18,15,10,18,0.349,0.233,0.419,17.696,55,riffle_clumpy
0,21,19,4,44,0.477,25,0.568,4,3,0.571,1,2,27,17,8,19,17,0.182,0.432,0.386,17.71,56,riffle_clumpy
0,19,18,6,43,0.442,25,0.581,2,1,0.667,1,3,28,15,11,14,18,0.256,0.326,0.419,17.711,57,riffle_clumpy
0,25,21,3,49,0.51,28,0.571,5,1,0.833,2,0,32,17,13,12,24,0.265,0.245,0.49,17.709,58,riffle_clumpy
0,18,25,4,47,0.383,22,0.468,2,1,0.667,5,2,29,18,7,15,25,0.149,0.319,0.532,17.713,59,riffle_clumpy
0,20,19,6,45,0.444,26,0.578,4,0,1.0,2,4,25,20,12,14,19,0.267,0.311,0.422,17.721,60,riffle_clumpy
0,14,27,4,45,0.311,18,0.4,2,2,0.5,1,6,30,15,8,15,22,0.178,0.333,0.489,17.712,61,riffle_clumpy
0,21,21,5,47,0.447,26,0.553,4,1,0.8,1,1,28,19,12,16,19,0.255,0.34,0.404,17.707,62,riffle_clumpy
0,16,26,2,44,0.364,18,0.409,0,2,0.0,1,2,28,16,10,16,18,0.227,0.364,0.409,17.714,63,riffle_clumpy
0,15,23,8,46,0.326,23,0.5,1,8,0.111,3,3,28,18,10,18,18,0.217,0.391,0.391,17.711,64,riffle_clumpy
0,21,22,4,47,0.447,25,0.532,5,1,0.833,0,4,29,18,16,11,20,0.34,0.234,0.426,17.715,65,riffle_clumpy
0,21,22,2,45,0.467,23,0.511,4,4,0.5,2,5,24,21,12,15,18,0.267,0.333,0.4,17.717,66,riffle_clumpy
0,17,25,3,45,0.378,20,0.444,2,1,0.667,2,1,30,15,8,15,22,0.178,0.333,0.489,17.701,67,riffle_clumpy
0,22,21,2,45,0.489,24,0.533,4,2,0.667,2,5,26,19,10,14,21,0.222,0.311,0.467,17.695,68,riffle_clumpy
0,17,21,6,44,0.386,23,0.523,1,4,0.2,1,2,29,15,11,13,20,0.25,0.295,0.455,17.69,69,riffle_clumpy
0,26,21,1,48,0.542,27,0.562,5,1,0.833,3,1,25,23,14,13,21,0.292,0.271,0.438,17.68,70,riffle_clumpy
0,21,15,6,42,0.5,27,0.643,3,3,0.5,1,0,27,15,14,12,16,0.333,0.286,0.381,17.686,71,riffle_clumpy
0,21,21,5,47,0.447,26,0.553,3,1,0.75,4,2,32,15,11,10,26,0.234,0.213,0.553,17.679,72,riffle_clumpy
0,19,23,4,46,0.413,23,0.5,1,5,0.167,6,2,29,17,12,17,17,0.261,0.37,0.37,17.677,73,riffle_clumpy
0,23,24,2,49,0.469,25,0.51,6,2,0.75,2,3,29,20,12,12,25,0.245,0.245,0.51,17.685,74,riffle_clumpy
0,19,19,6,44,0.432,25,0.568,3,2,0.6,1,0,29,15,11,14,19,0.25,0.318,0.432,17.688,75,riffle_clumpy
0,16,30,3,49,0.327,19,0.388,3,1,0.75,2,1,33,16,11,14,24,0.224,0.286,0.49,17.67,76,riffle_clumpy
0,22,18,7,47,0.468,29,0.617,3,3,0.5,3,0,25,22,14,16,17,0.298,0.34,0.362,17.676,77,riffle_clumpy
0,22,18,6,46,0.478,28,0.609,3,1,0.75,3,3,26,20,11,15,20,0.239,0.326,0.435,17.674,78,riffle_clumpy
0,24,19,4,47,0.511,28,0.596,3,2,0.6,2,2,28,19,17,13,17,0.362,0.277,0.362,17.669,79,riffle_clumpy
0,18,22,4,44,0.409,22,0.5,1,4,0.2,3,4,27,17,13,10,21,0.295,0.227,0.477,17.667,80,riffle_clumpy
0,22,20,3,45,0.489,25,0.556,4,0,1.0,0,3,25,20,16,14,15,0.356,0.311,0.333,17.667,81,riffle_clumpy
0,24,23,1,48,0.5,25,0.521,5,5,0.5,3,1,22,26,14,18,16,0.292,0.375,0.333,17.665,82,riffle_clumpy
0,18,22,5,45,0.4,23,0.511,1,0,1.0,2,3,27,18,7,14,24,0.156,0.311,0.533,17.654,83,riffle_clumpy
0,18,26,3,47,0.383,21,0.447,4,4,0.5,1,4,27,20,11,16,20,0.234,0.34,0.426,17.654,84,riffle_clumpy
0,24,18,4,46,0.522,28,0.609,0,3,0.0,3,1,24,22,15,14,17,0.326,0.304,0.37,17.657,85,riffle_clumpy
0,20,25,1,46,0.435,21,0.457,1,3,0.25,1,4,31,15,10,9,27,0.217,0.196,0.587,17.661,86,riffle_clumpy
0,19,27,2,48,0.396,21,0.438,1,3,0.25,1,4,27,21,13,15,20,0.271,0.312,0.417,17.659,87,riffle_clumpy
0,22,19,5,46,0.478,27,0.587,4,0,1.0,2,3,28,18,13,14,19,0.283,0.304,0.413,17.66,88,riffle_clumpy
0,19,22,3,44,0.432,22,0.5,3,3,0.5,3,1,29,15,7,18,19,0.159,0.409,0.432,17.665,89,riffle_clumpy
0,20,20,4,44,0.455,24,0.545,2,6,0.25,2,2,18,26,14,16,14,0.318,0.364,0.318,17.664,90,riffle_clumpy
0,25,15,5,45,0.556,30,0.667,3,0,1.0,3,4,29,16,10,16,19,0.222,0.356,0.422,17.667,91,riffle_clumpy
0,19,26,2,47,0.404,21,0.447,4,0,1.0,5,0,30,17,7,18,22,0.149,0.383,0.468,17.658,92,riffle_clumpy
0,20,24,2,46,0.435,22,0.478,6,3,0.667,2,1,27,19,6,22,18,0.13,0.478,0.391,17.663,93,riffle_clumpy
0,14,25,6,45,0.311,20,0.444,2,5,0.286,1,1,26,19,6,19,20,0.133,0.422,0.444,17.664,94,riffle_clumpy
0,15,27,3,45,0.333,18,0.4,2,3,0.4,1,1,28,17,10,13,22,0.222,0.289,0.489,17.672,95,riffle_clumpy
0,18,24,1,43,0.419,19,0.442,1,3,0.25,1,0,27,16,13,9,21,0.302,0.209,0.488,17.673,96,riffle_clumpy
0,18,25,3,46,0.391,21,0.457,2,2,0.5,3,3,31,15,8,11,27,0.174,0.239,0.587,17.375,1,riffle_clumpy
0,23,19,3,45,0.511,26,0.578,5,0,1.0,1,2,30,15,10,12,23,0.222,0.267,0.511,17.262,2,riffle_clumpy
0,20,21,4,45,0.444,24,0.533,6,2,0.75,4,3,30,15,11,10,24,0.244,0.222,0.533,17.12,3,riffle_clumpy
0,26,20,1,47,0.553,27,0.574,2,1,0.667,0,0,22,25,15,17,15,0.319,0.362,0.319,17.157,4,riffle_clumpy
0,17,24,5,46,0.37,22,0.478,2,1,0.667,2,2,32,14,8,11,27,0.174,0.239,0.587,17.239,5,riffle_clumpy
0,20,20,5,45,0.444,25,0.556,3,0,1.0,2,1,27,18,13,17,15,0.289,0.378,0.333,17.315,6,riffle_clumpy
0,26,17,3,46,0.565,29,0.63,5,0,1.0,3,4,31,15,12,13,21,0.261,0.283,0.457,17.319,7,riffle_clumpy
0,18,25,4,47,0.383,22,0.468,1,4,0.2,1,1,29,18,10,23,14,0.213,0.489,0.298,17.418,8,riffle_clumpy
0,18,18,8,44,0.409,26,0.591,2,4,0.333,3,1,29,15,5,15,24,0.114,0.341,0.545,17.449,9,riffle_clumpy
0,21,17,8,46,0.457,29,0.63,3,5,0.375,5,1,20,26,8,22,16,0.174,0.478,0.348,17.511,10,riffle_clumpy
0,18,24,2,44,0.409,20,0.455,8,0,1.0,0,0,24,20,12,16,16,0.273,0.364,0.364,17.571,11,riffle_clumpy
0,17,27,1,45,0.378,18,0.4,1,3,0.25,3,2,27,18,8,19,18,0.178,0.422,0.4,17.601,12,riffle_clumpy
0,19,22,3,44,0.432,22,0.5,1,0,1.0,4,2,27,17,13,8,23,0.295,0.182,0.523,17.559,13,riffle_clumpy
0,21,22,4,47,0.447,25,0.532,2,3,0.4,2,2,25,22,15,13,19,0.319,0.277,0.404,17.603,14,riffle_clumpy
0,31,14,2,47,0.66,33,0.702,4,0,1.0,2,1,27,20,19,12,16,0.404,0.255,0.34,17.622,15,riffle_clumpy
0,22,20,4,46,0.478,26,0.565,2,3,0.4,3,2,27,19,11,14,21,0.239,0.304,0.457,17.605,16,riffle_clumpy
0,21,18,4,43,0.488,25,0.581,2,2,0.5,2,2,31,12,12,8,23,0.279,0.186,0.535,17.591,17,riffle_clumpy
0,22,18,5,45,0.489,27,0.6,2,5,0.286,3,1,23,22,14,16,15,0.311,0.356,0.333,17.573,18,riffle_clumpy
0,21,21,4,46,0.457,25,0.543,2,2,0.5,1,3,23,23,13,17,16,0.283,0.37,0.348,17.557,19,riffle_clumpy
0,18,21,7,46,0.391,25,0.543,2,1,0.667,5,1,27,19,7,16,23,0.152,0.348,0.5,17.541,20,riffle_clumpy
0,16,24,4,44,0.364,20,0.455,1,3,0.25,2,2,30,14,8,17,19,0.182,0.386,0.432,17.568,21,riffle_clumpy
0,18,26,2,46,0.391,20,0.435,0,2,0.0,4,2,27,19,10,15,21,0.217,0.326,0.457,17.572,22,riffle_clumpy
0,14,26,6,46,0.304,20,0.435,1,1,0.5,1,2,23,23,7,18,21,0.152,0.391,0.457,17.569,23,riffle_clumpy
0,17,26,2,45,0.378,19,0.422,2,3,0.4,2,3,27,18,12,14,19,0.267,0.311,0.422,17.567,24,riffle_clumpy
0,18,25,3,46,0.391,21,0.457,5,2,0.714,2,4,28,18,13,10,23,0.283,0.217,0.5,17.566,25,riffle_clumpy
0,17,28,3,48,0.354,20,0.417,4,3,0.571,1,3,29,19,8,15,25,0.167,0.312,0.521,17.572,26,riffle_clumpy
0,23,19,2,44,0.523,25,0.568,5,2,0.714,4,2,25,19,11,13,20,0.25,0.295,0.455,17.549,27,riffle_clumpy
0,20,22,3,45,0.444,23,0.511,0,2,0.0,2,5,29,16,13,14,18,0.289,0.311,0.4,17.546,28,riffle_clumpy
0,19,27,2,48,0.396,21,0.438,3,5,0.375,4,5,25,23,8,13,27,0.167,0.271,0.562,17.534,29,riffle_clumpy
0,27,18,3,48,0.562,30,0.625,1,4,0.2,4,2,34,14,12,8,28,0.25,0.167,0.583,17.523,30,riffle_clumpy
0,19,21,3,43,0.442,22,0.512,1,2,0.333,2,0,28,15,8,13,22,0.186,0.302,0.512,17.549,31,riffle_clumpy
0,18,21,4,43,0.419,22,0.512,3,0,1.0,4,0,31,12,9,11,23,0.209,0.256,0.535,17.54,32,riffle_clumpy
0,22,22,3,47,0.468,25,0.532,3,1,0.75,4,0,22,25,6,24,17,0.128,0.511,0.362,17.537,33,riffle_clumpy
0,24,20,4,48,0.5,28,0.583,1,5,0.167,6,3,29,19,8,19,21,0.167,0.396,0.438,17.537,34,riffle_clumpy
0,19,22,5,46,0.413,24,0.522,3,2,0.6,0,1,25,21,9,22,15,0.196,0.478,0.326,17.56,35,riffle_clumpy
0,19,23,5,47,0.404,24,0.511,2,1,0.667,1,4,35,12,10,14,23,0.213,0.298,0.489,17.571,36,riffle_clumpy
0,22,18,5,45,0.489,27,0.6,12,3,0.8,2,2,23,22,10,14,21,0.222,0.311,0.467,17.584,37,riffle_clumpy
0,16,27,3,46,0.348,19,0.413,4,3,0.571,2,1,28,18,8,16,22,0.174,0.348,0.478,17.581,38,riffle_clumpy
0,19,21,6,46,0.413,25,0.543,4,2,0.667,2,1,25,21,14,15,17,0.304,0.326,0.37,17.6,39,riffle_clumpy
0,20,20,4,44,0.455,24,0.545,4,1,0.8,2,3,28,16,11,10,23,0.25,0.227,0.523,17.606,40,riffle_clumpy
0,24,16,4,44,0.545,28,0.636,3,3,0.5,3,0,24,20,18,12,14,0.409,0.273,0.318,17.619,41,riffle_clumpy
0,23,21,2,46,0.5,25,0.543,2,0,1.0,2,3,30,16,13,10,23,0.283,0.217,0.5,17.616,42,riffle_clumpy
0,17,22,5,44,0.386,22,0.5,5,2,0.714,1,5,28,16,9,19,16,0.205,0.432,0.364,17.629,43,riffle_clumpy
0,19,23,2,44,0.432,21,0.477,4,0,1.0,3,4,28,16,10,14,20,0.227,0.318,0.455,17.628,44,riffle_clumpy
0,22,19,3,44,0.5,25,0.568,2,3,0.4,0,1,30,14,14,12,18,0.318,0.273,0.409,17.635,45,riffle_clumpy
0,19,24,4,47,0.404,23,0.489,1,0,1.0,2,1,27,20,11,15,21,0.234,0.319,0.447,17.628,46,riffle_clumpy
0,18,20,8,46,0.391,26,0.565,4,1,0.8,1,0,25,21,9,15,22,0.196,0.326,0.478,17.632,47,riffle_clumpy
0,21,22,5,48,0.438,26,0.542,3,2,0.6,1,3,30,18,6,21,21,0.125,0.438,0.438,17.633,48,riffle_clumpy
0,19,20,4,43,0.442,23,0.535,7,2,0.778,2,3,25,18,12,12,19,0.279,0.279,0.442,17.635,49,riffle_clumpy
0,19,23,3,45,0.422,22,0.489,4,3,0.571,3,2,25,20,12,13,20,0.267,0.289,0.444,17.636,50,riffle_clumpy
0,27,17,3,47,0.574,30,0.638,4,1,0.8,1,1,23,24,19,14,14,0.404,0.298,0.298,17.639,51,riffle_clumpy
0,18,21,4,43,0.419,22,0.512,3,1,0.75,2,2,23,20,11,17,15,0.256,0.395,0.349,17.638,52,riffle_clumpy
0,23,20,2,45,0.511,25,0.556,5,0,1.0,2,0,29,16,12,14,19,0.267,0.311,0.422,17.627,53,riffle_clumpy
0,23,20,4,47,0.489,27,0.574,4,3,0.571,1,2,31,16,13,15,19,0.277,0.319,0.404,17.624,54,riffle_clumpy
0,18,21,5,44,0.409,23,0.523,0,3,0.0,0,3,31,13,7,16,21,0.159,0.364,0.477,17.623,55,riffle_clumpy
0,20,23,4,47,0.426,24,0.511,1,3,0.25,3,1,27,20,9,16,22,0.191,0.34,0.468,17.609,56,riffle_clumpy
0,18,27,3,48,0.375,21,0.438,0,2,0.0,2,4,24,24,11,17,20,0.229,0.354,0.417,17.611,57,riffle_clumpy
0,24,15,8,47,0.511,32,0.681,6,0,1.0,2,2,27,20,17,13,17,0.362,0.277,0.362,17.625,58,riffle_clumpy
0,15,26,4,45,0.333,19,0.422,2,2,0.5,4,4,28,17,6,17,22,0.133,0.378,0.489,17.615,59,riffle_clumpy
0,18,24,2,44,0.409,20,0.455,5,3,0.625,1,1,21,23,9,15,20,0.205,0.341,0.455,17.615,60,riffle_clumpy
0,23,17,6,46,0.5,29,0.63,7,3,0.7,1,2,28,18,13,14,19,0.283,0.304,0.413,17.619,61,riffle_clumpy
0,17,24,4,45,0.378,21,0.467,2,5,0.286,3,1,28,17,9,12,24,0.2,0.267,0.533,17.617,62,riffle_clumpy
0,20,20,5,45,0.444,25,0.556,3,0,1.0,3,0,27,18,10,13,22,0.222,0.289,0.489,17.615,63,riffle_clumpy
0,16,22,6,44,0.364,22,0.5,3,2,0.6,3,2,24,20,10,15,19,0.227,0.341,0.432,17.622,64,riffle_clumpy
0,17,26,3,46,0.37,20,0.435,2,1,0.667,2,6,30,16,8,15,23,0.174,0.326,0.5,17.626,65,riffle_clumpy
0,23,21,3,47,0.489,26,0.553,6,3,0.667,4,1,26,21,14,10,23,0.298,0.213,0.489,17.627,66,riffle_clumpy
0,20,27,3,50,0.4,23,0.46,2,1,0.667,2,0,34,16,9,9,32,0.18,0.18,0.64,17.62,67,riffle_clumpy
0,16,23,5,44,0.364,21,0.477,0,1,0.0,1,2,29,15,11,13,20,0.25,0.295,0.455,17.614,68,riffle_clumpy
0,19,18,6,43,0.442,25,0.581,4,1,0.8,3,2,27,16,12,12,19,0.279,0.279,0.442,17.619,69,riffle_clumpy
0,17,25,3,45,0.378,20,0.444,2,2,0.5,2,4,30,15,7,13,25,0.156,0.289,0.556,17.615,70,riffle_clumpy
0,23,21,2,46,0.5,25,0.543,2,1,0.667,4,1,26,20,12,15,19,0.261,0.326,0.413,17.602,71,riffle_clumpy
0,19,25,2,46,0.413,21,0.457,5,1,0.833,2,5,22,24,14,11,21,0.304,0.239,0.457,17.613,72,riffle_clumpy
0,15,27,4,46,0.326,19,0.413,1,3,0.25,2,3,33,13,9,12,25,0.196,0.261,0.543,17.609,73,riffle_clumpy
0,17,26,3,46,0.37,20,0.435,2,4,0.333,0,0,25,21,9,16,21,0.196,0.348,0.457,17.617,74,riffle_clumpy
0,31,14,3,48,0.646,34,0.708,9,1,0.9,3,0,23,25,18,10,20,0.375,0.208,0.417,17.612,75,riffle_clumpy
0,26,15,3,44,0.591,29,0.659,5,0,1.0,6,1,27,17,12,13,19,0.273,0.295,0.432,17.61,76,riffle_clumpy
0,17,20,7,44,0.386,24,0.545,4,4,0.5,1,2,23,21,12,15,17,0.273,0.341,0.386,17.615,77,riffle_clumpy
0,23,20,1,44,0.523,24,0.545,4,0,1.0,2,6,27,17,16,6,22,0.364,0.136,0.5,17.613,78,riffle_clumpy
0,23,19,2,44,0.523,25,0.568,5,2,0.714,1,2,23,21,13,16,15,0.295,0.364,0.341,17.624,79,riffle_clumpy
0,26,13,5,44,0.591,31,0.705,5,2,0.714,5,2,31,13,17,8,19,0.386,0.182,0.432,17.625,80,riffle_clumpy
0,16,28,2,46,0.348,18,0.391,2,2,0.5,1,3,31,15,8,14,24,0.174,0.304,0.522,17.626,81,riffle_clumpy
0,15,29,5,49,0.306,20,0.408,4,5,0.444,3,1,29,20,8,18,23,0.163,0.367,0.469,17.628,82,riffle_clumpy
0,21,17,6,44,0.477,27,0.614,7,3,0.7,3,2,24,20,10,15,19,0.227,0.341,0.432,17.633,83,riffle_clumpy
0,16,26,5,47,0.34,21,0.447,2,4,0.333,1,3,35,12,8,17,22,0.17,0.362,0.468,17.636,84,riffle_clumpy
0,30,16,1,47,0.638,31,0.66,3,1,0.75,5,2,29,18,15,12,20,0.319,0.255,0.426,17.626,85,riffle_clumpy
0,20,23,3,46,0.435,23,0.5,4,1,0.8,1,1,25,21,13,14,19,0.283,0.304,0.413,17.617,86,riffle_clumpy
0,20,21,6,47,0.426,26,0.553,3,2,0.6,3,1,30,17,7,19,21,0.149,0.404,0.447,17.62,87,riffle_clumpy
0,15,24,8,47,0.319,23,0.489,1,2,0.333,2,4,30,17,8,17,22,0.17,0.362,0.468,17.623,88,riffle_clumpy
0,17,26,3,46,0.37,20,0.435,1,2,0.333,1,4,32,14,15,9,22,0.326,0.196,0.478,17.624,89,riffle_clumpy
0,13,27,5,45,0.289,18,0.4,3,3,0.5,3,1,25,20,7,21,17,0.156,0.467,0.378,17.631,90,riffle_clumpy
0,21,19,4,44,0.477,25,0.568,5,1,0.833,2,1,28,16,14,13,17,0.318,0.295,0.386,17.64,91,riffle_clumpy
0,14,23,6,43,0.326,20,0.465,2,2,0.5,4,1,28,15,5,16,22,0.116,0.372,0.512,17.638,92,riffle_clumpy
0,22,19,3,44,0.5,25,0.568,4,2,0.667,4,2,24,20,11,17,16,0.25,0.386,0.364,17.637,93,riffle_clumpy
0,24,14,6,44,0.545,30,0.682,3,1,0.75,4,1,28,16,10,15,19,0.227,0.341,0.432,17.631,94,riffle_clumpy
0,18,22,4,44,0.409,22,0.5,4,2,0.667,3,1,29,15,6,16,22,0.136,0.364,0.5,17.621,95,riffle_clumpy
0,22,18,4,44,0.5,26,0.591,5,0,1.0,1,3,31,13,14,13,17,0.318,0.295,0.386,17.623,96,riffle_clumpy
0,20,16,8,44,0.455,28,0.636,1,2,0.333,1,1,32,12,8,13,23,0.182,0.295,0.523,17.871,1,riffle_clumpy
0,18,26,3,47,0.383,21,0.447,3,5,0.375,2,1,23,24,11,19,17,0.234,0.404,0.362,17.705,2,riffle_clumpy
0,20,27,1,48,0.417,21,0.438,3,3,0.5,0,4,25,23,11,20,17,0.229,0.417,0.354,17.78,3,riffle_clumpy
0,13,21,11,45,0.289,24,0.533,0,3,0.0,2,1,30,15,6,18,21,0.133,0.4,0.467,17.911,4,riffle_clumpy
0,12,26,7,45,0.267,19,0.422,0,2,0.0,0,2,27,18,6,17,22,0.133,0.378,0.489,17.841,5,riffle_clumpy
0,19,22,4,45,0.422,23,0.511,3,4,0.429,1,3,21,24,12,16,17,0.267,0.356,0.378,17.836,6,riffle_clumpy
0,24,18,2,44,0.545,26,0.591,4,0,1.0,2,5,27,17,12,10,22,0.273,0.227,0.5,17.757,7,riffle_clumpy
0,20,20,7,47,0.426,27,0.574,3,0,1.0,2,4,23,24,11,16,20,0.234,0.34,0.426,17.762,8,riffle_clumpy
0,20,20,4,44,0.455,24,0.545,2,0,1.0,4,4,29,15,12,14,18,0.273,0.318,0.409,17.698,9,riffle_clumpy
0,20,21,5,46,0.435,25,0.543,4,1,0.8,2,2,31,15,15,12,19,0.326,0.261,0.413,17.727,10,riffle_clumpy
0,19,22,3,44,0.432,22,0.5,3,0,1.0,0,3,24,20,13,12,19,0.295,0.273,0.432,17.76,11,riffle_clumpy
0,15,25,6,46,0.326,21,0.457,1,2,0.333,1,3,31,15,6,17,23,0.13,0.37,0.5,17.824,12,riffle_clumpy
0,25,16,5,46,0.543,30,0.652,6,2,0.75,0,1,27,19,15,14,17,0.326,0.304,0.37,17.88,13,riffle_clumpy
0,17,26,3,46,0.37,20,0.435,0,1,0.0,1,1,25,21,10,20,16,0.217,0.435,0.348,17.885,14,riffle_clumpy
0,19,22,5,46,0.413,24,0.522,4,2,0.667,3,1,25,21,9,17,20,0.196,0.37,0.435,17.829,15,riffle_clumpy
0,14,26,5,45,0.311,19,0.422,2,5,0.286,5,1,33,12,5,13,27,0.111,0.289,0.6,17.855,16,riffle_clumpy
0,21,20,3,44,0.477,24,0.545,2,1,0.667,2,3,37,7,6,15,23,0.136,0.341,0.523,17.888,17,riffle_clumpy
0,20,23,2,45,0.444,22,0.489,4,3,0.571,3,0,22,23,11,15,19,0.244,0.333,0.422,17.868,18,riffle_clumpy
0,22,22,3,47,0.468,25,0.532,5,3,0.625,4,4,34,13,10,13,24,0.213,0.277,0.511,17.852,19,riffle_clumpy
0,27,14,3,44,0.614,30,0.682,4,2,0.667,4,1,28,16,12,14,18,0.273,0.318,0.409,17.836,20,riffle_clumpy
0,25,19,3,47,0.532,28,0.596,5,0,1.0,2,1,27,20,16,9,22,0.34,0.191,0.468,17.802,21,riffle_clumpy
0,14,24,7,45,0.311,21,0.467,1,2,0.333,0,2,25,20,7,20,18,0.156,0.444,0.4,17.806,22,riffle_clumpy
0,20,21,4,45,0.444,24,0.533,1,4,0.2,2,1,22,23,12,16,17,0.267,0.356,0.378,17.813,23,riffle_clumpy
0,13,26,7,46,0.283,20,0.435,4,3,0.571,1,1,20,26,6,24,16,0.13,0.522,0.348,17.82,24,riffle_clumpy
0,19,20,5,44,0.432,24,0.545,3,3,0.5,3,0,27,17,8,17,19,0.182,0.386,0.432,17.816,25,riffle_clumpy
0,22,24,2,48,0.458,24,0.5,0,1,0.0,2,1,30,18,8,16,24,0.167,0.333,0.5,17.809,26,riffle_clumpy
0,20,21,5,46,0.435,25,0.543,2,1,0.667,3,1,26,20,10,19,17,0.217,0.413,0.37,17.819,27,riffle_clumpy
0,15,24,6,45,0.333,21,0.467,1,1,0.5,1,2,25,20,9,17,19,0.2,0.378,0.422,17.8,28,riffle_clumpy
0,22,23,3,48,0.458,25,0.521,4,5,0.444,2,3,25,23,11,18,19,0.229,0.375,0.396,17.786,29,riffle_clumpy
0,18,26,2,46,0.391,20,0.435,3,3,0.5,5,2,20,26,9,18,19,0.196,0.391,0.413,17.776,30,riffle_clumpy
0,15,25,3,43,0.349,18,0.419,2,2,0.5,0,1,32,11,8,12,23,0.186,0.279,0.535,17.76,31,riffle_clumpy
0,15,23,7,45,0.333,22,0.489,0,2,0.0,3,1,30,15,5,12,28,0.111,0.267,0.622,17.737,32,riffle_clumpy
0,20,20,4,44,0.455,24,0.545,3,2,0.6,2,0,28,16,9,15,20,0.205,0.341,0.455,17.742,33,riffle_clumpy
0,19,21,5,45,0.422,24,0.533,0,1,0.0,3,3,32,13,10,14,21,0.222,0.311,0.467,17.734,34,riffle_clumpy
0,19,18,6,43,0.442,25,0.581,4,0,1.0,0,1,26,17,11,11,21,0.256,0.256,0.488,17.721,35,riffle_clumpy
0,23,19,4,46,0.5,27,0.587,2,3,0.4,3,2,24,22,16,15,15,0.348,0.326,0.326,17.715,36,riffle_clumpy
0,23,21,3,47,0.489,26,0.553,5,1,0.833,3,4,33,14,11,11,25,0.234,0.234,0.532,17.7,37,riffle_clumpy
0,16,26,2,44,0.364,18,0.409,1,3,0.25,0,2,25,19,9,16,19,0.205,0.364,0.432,17.708,38,riffle_clumpy
0,19,24,6,49,0.388,25,0.51,6,2,0.75,2,5,32,17,10,16,23,0.204,0.327,0.469,17.72,39,riffle_clumpy
0,21,21,3,45,0.467,24,0.533,4,1,0.8,2,2,24,21,13,14,18,0.289,0.311,0.4,17.709,40,riffle_clumpy
0,16,27,2,45,0.356,18,0.4,1,2,0.333,2,1,31,14,8,17,20,0.178,0.378,0.444,17.696,41,riffle_clumpy
0,19,27,0,46,0.413,19,0.413,2,4,0.333,0,1,27,19,12,13,21,0.261,0.283,0.457,17.698,42,riffle_clumpy
0,16,25,7,48,0.333,23,0.479,3,2,0.6,1,2,34,14,5,17,26,0.104,0.354,0.542,17.698,43,riffle_clumpy
0,29,14,4,47,0.617,33,0.702,6,1,0.857,2,0,26,21,14,13,20,0.298,0.277,0.426,17.687,44,riffle_clumpy
0,27,14,3,44,0.614,30,0.682,3,1,0.75,2,1,23,21,13,14,17,0.295,0.318,0.386,17.673,45,riffle_clumpy
0,24,18,4,46,0.522,28,0.609,3,0,1.0,5,0,30,16,11,16,19,0.239,0.348,0.413,17.665,46,riffle_clumpy
0,24,17,6,47,0.511,30,0.638,5,0,1.0,0,1,27,20,19,11,17,0.404,0.234,0.362,17.674,47,riffle_clumpy
0,19,21,4,44,0.432,23,0.523,2,2,0.5,1,2,24,20,15,13,16,0.341,0.295,0.364,17.681,48,riffle_clumpy
0,20,21,5,46,0.435,25,0.543,3,3,0.5,2,4,32,14,12,9,25,0.261,0.196,0.543,17.673,49,riffle_clumpy
0,20,23,2,45,0.444,22,0.489,3,3,0.5,2,1,24,21,10,14,21,0.222,0.311,0.467,17.681,50,riffle_clumpy
0,16,29,4,49,0.327,20,0.408,1,3,0.25,3,3,30,19,6,18,25,0.122,0.367,0.51,17.668,51,riffle_clumpy
0,26,20,0,46,0.565,26,0.565,5,3,0.625,4,3,27,19,17,13,16,0.37,0.283,0.348,17.663,52,riffle_clumpy
0,23,23,3,49,0.469,26,0.531,3,5,0.375,4,2,25,24,10,18,21,0.204,0.367,0.429,17.656,53,riffle_clumpy
0,18,25,3,46,0.391,21,0.457,2,2,0.5,4,2,24,22,10,19,17,0.217,0.413,0.37,17.645,54,riffle_clumpy
0,17,26,2,45,0.378,19,0.422,1,4,0.2,3,3,23,22,9,17,19,0.2,0.378,0.422,17.641,55,riffle_clumpy
0,21,18,6,45,0.467,27,0.6,5,1,0.833,2,2,16,29,13,12,20,0.289,0.267,0.444,17.636,56,riffle_clumpy
0,28,18,1,47,0.596,29,0.617,5,2,0.714,0,0,29,18,13,17,17,0.277,0.362,0.362,17.647,57,riffle_clumpy
0,24,16,4,44,0.545,28,0.636,3,2,0.6,2,1,25,19,16,15,13,0.364,0.341,0.295,17.651,58,riffle_clumpy
0,16,23,5,44,0.364,21,0.477,3,3,0.5,1,1,30,14,8,16,20,0.182,0.364,0.455,17.65,59,riffle_clumpy
0,18,22,5,45,0.4,23,0.511,3,1,0.75,3,1,24,21,7,17,21,0.156,0.378,0.467,17.655,60,riffle_clumpy
0,19,21,5,45,0.422,24,0.533,3,0,1.0,1,2,21,24,11,18,16,0.244,0.4,0.356,17.655,61,riffle_clumpy
0,19,23,3,45,0.422,22,0.489,0,3,0.0,0,3,31,14,15,11,19,0.333,0.244,0.422,17.664,62,riffle_clumpy
0,18,26,3,47,0.383,21,0.447,1,5,0.167,0,1,29,18,9,16,22,0.191,0.34,0.468,17.671,63,riffle_clumpy
0,21,20,4,45,0.467,25,0.556,3,3,0.5,2,2,23,22,11,18,16,0.244,0.4,0.356,17.68,64,riffle_clumpy
0,21,20,3,44,0.477,24,0.545,3,1,0.75,1,1,24,20,10,19,15,0.227,0.432,0.341,17.684,65,riffle_clumpy
0,26,17,2,45,0.578,28,0.622,3,1,0.75,3,2,27,18,17,9,19,0.378,0.2,0.422,17.675,66,riffle_clumpy
0,17,23,7,47,0.362,24,0.511,1,3,0.25,1,2,29,18,8,11,28,0.17,0.234,0.596,17.676,67,riffle_clumpy
0,28,16,3,47,0.596,31,0.66,1,0,1.0,1,1,24,23,16,13,18,0.34,0.277,0.383,17.674,68,riffle_clumpy
0,15,28,2,45,0.333,17,0.378,3,2,0.6,0,4,26,19,8,16,21,0.178,0.356,0.467,17.665,69,riffle_clumpy
0,27,14,4,45,0.6,31,0.689,4,1,0.8,4,1,29,16,12,12,21,0.267,0.267,0.467,17.662,70,riffle_clumpy
0,19,19,7,45,0.422,26,0.578,2,2,0.5,1,0,29,16,14,13,18,0.311,0.289,0.4,17.667,71,riffle_clumpy
0,18,22,4,44,0.409,22,0.5,4,4,0.5,2,1,24,20,12,13,19,0.273,0.295,0.432,17.674,72,riffle_clumpy
0,16,23,6,45,0.356,22,0.489,2,2,0.5,2,2,25,20,7,18,20,0.156,0.4,0.444,17.673,73,riffle_clumpy
0,19,23,6,48,0.396,25,0.521,2,0,1.0,1,3,30,18,14,15,19,0.292,0.312,0.396,17.678,74,riffle_clumpy
0,17,24,5,46,0.37,22,0.478,5,1,0.833,2,4,29,17,9,10,27,0.196,0.217,0.587,17.668,75,riffle_clumpy
0,18,26,2,46,0.391,20,0.435,2,1,0.667,2,2,33,13,11,8,27,0.239,0.174,0.587,17.668,76,riffle_clumpy
0,21,21,3,45,0.467,24,0.533,1,2,0.333,3,1,26,19,12,14,19,0.267,0.311,0.422,17.664,77,riffle_clumpy
0,20,25,3,48,0.417,23,0.479,1,2,0.333,0,1,31,17,14,12,22,0.292,0.25,0.458,17.662,78,riffle_clumpy
0,27,20,3,50,0.54,30,0.6,2,4,0.333,1,3,28,22,15,18,17,0.3,0.36,0.34,17.662,79,riffle_clumpy
0,16,22,6,44,0.364,22,0.5,1,1,0.5,3,1,30,14,9,11,24,0.205,0.25,0.545,17.664,80,riffle_clumpy
0,23,20,2,45,0.511,25,0.556,4,0,1.0,2,3,25,20,9,15,21,0.2,0.333,0.467,17.66,81,riffle_clumpy
0,19,24,3,46,0.413,22,0.478,2,0,1.0,2,3,26,20,11,13,22,0.239,0.283,0.478,17.655,82,riffle_clumpy
0,12,27,5,44,0.273,17,0.386,1,2,0.333,0,3,29,15,9,16,19,0.205,0.364,0.432,17.67,83,riffle_clumpy
0,18,22,3,43,0.419,21,0.488,3,0,1.0,1,3,22,21,11,13,19,0.256,0.302,0.442,17.668,84,riffle_clumpy
0,18,23,3,44,0.409,21,0.477,2,0,1.0,3,2,32,12,4,16,24,0.091,0.364,0.545,17.664,85,riffle_clumpy
0,15,23,8,46,0.326,23,0.5,2,2,0.5,2,2,32,14,10,18,18,0.217,0.391,0.391,17.675,86,riffle_clumpy
0,21,23,1,45,0.467,22,0.489,1,1,0.5,2,3,24,21,17,11,17,0.378,0.244,0.378,17.668,87,riffle_clumpy
0,19,20,5,44,0.432,24,0.545,4,3,0.571,2,2,21,23,12,17,15,0.273,0.386,0.341,17.673,88,riffle_clumpy
0,20,22,2,44,0.455,22,0.5,2,1,0.667,0,1,31,13,13,12,19,0.295,0.273,0.432,17.678,89,riffle_clumpy
0,22,21,2,45,0.489,24,0.533,6,1,0.857,2,3,30,15,10,15,20,0.222,0.333,0.444,17.68,90,riffle_clumpy
0,28,16,1,45,0.622,29,0.644,5,3,0.625,2,1,26,19,16,15,14,0.356,0.333,0.311,17.674,91,riffle_clumpy
0,17,25,2,44,0.386,19,0.432,2,2,0.5,2,2,33,11,10,12,22,0.227,0.273,0.5,17.673,92,riffle_clumpy
0,27,21,3,51,0.529,30,0.588,6,3,0.667,3,1,27,24,14,18,19,0.275,0.353,0.373,17.667,93,riffle_clumpy
0,21,23,2,46,0.457,23,0.5,6,2,0.75,2,3,29,17,11,13,22,0.239,0.283,0.478,17.658,94,riffle_clumpy
0,21,19,6,46,0.457,27,0.587,5,4,0.556,2,1,23,23,15,15,16,0.326,0.326,0.348,17.653,95,riffle_clumpy
0,17,23,4,44,0.386,21,0.477,3,1,0.75,1,1,25,19,12,15,17,0.273,0.341,0.386,17.649,96,riffle_clumpy