index,player_win,player_loss,push,total_hands,win_pct,win_push,win_push_pct,doubles_won,doubles_lost,doubles_won_pct,player_bj,dealer_bj,dealer_high_card,dealer_low_card,dealer_bust,dealer_draw,dealer_stand,dealer_bust_pct,dealer_draw_pct,dealer_stand_pct,dealer_avg_hand,num_of_shuffles,shuffle_method
0,16,23,5,44,0.364,21,0.477,2,2,0.5,2,3,27,17,10,13,21,0.227,0.295,0.477,17.7,1,python
0,20,20,5,45,0.444,25,0.556,1,2,0.333,2,0,32,13,12,15,18,0.267,0.333,0.4,17.828,2,python
0,25,16,3,44,0.568,28,0.636,2,0,1.0,0,2,31,13,11,14,19,0.25,0.318,0.432,17.759,3,python
0,13,22,10,45,0.289,23,0.511,2,2,0.5,1,5,26,19,9,19,17,0.2,0.422,0.378,17.922,4,python
0,17,25,4,46,0.37,21,0.457,1,0,1.0,2,3,29,17,9,14,23,0.196,0.304,0.5,18.076,5,python
0,16,25,4,45,0.356,20,0.444,1,1,0.5,2,3,32,13,6,16,23,0.133,0.356,0.511,18.0,6,python
0,18,26,5,49,0.367,23,0.469,6,1,0.857,1,2,32,17,6,20,23,0.122,0.408,0.469,17.99,7,python
0,17,24,4,45,0.378,21,0.467,1,3,0.25,2,3,32,13,7,13,25,0.156,0.289,0.556,17.975,8,python
0,18,25,4,47,0.383,22,0.468,2,2,0.5,2,1,27,20,8,14,25,0.17,0.298,0.532,17.877,9,python
0,13,27,4,44,0.295,17,0.386,2,3,0.4,1,1,35,9,6,9,29,0.136,0.205,0.659,17.885,10,python
0,17,21,5,43,0.395,22,0.512,0,1,0.0,2,0,24,19,10,13,20,0.233,0.302,0.465,17.88,11,python
0,19,25,3,47,0.404,22,0.468,4,3,0.571,2,3,25,22,11,17,19,0.234,0.362,0.404,17.86,12,python
0,21,18,6,45,0.467,27,0.6,6,4,0.6,1,1,24,21,12,14,19,0.267,0.311,0.422,17.832,13,python
0,17,28,2,47,0.362,19,0.404,4,1,0.8,1,3,30,17,11,13,23,0.234,0.277,0.489,17.842,14,python
0,15,26,3,44,0.341,18,0.409,7,4,0.636,2,3,25,19,9,12,23,0.205,0.273,0.523,17.774,15,python
0,18,24,2,44,0.409,20,0.455,3,6,0.333,2,4,30,14,11,15,18,0.25,0.341,0.409,17.737,16,python
0,21,19,5,45,0.467,26,0.578,4,2,0.667,1,3,24,21,12,15,18,0.267,0.333,0.4,17.733,17,python
0,18,21,6,45,0.4,24,0.533,1,4,0.2,1,0,25,20,11,18,16,0.244,0.4,0.356,17.746,18,python
0,19,21,4,44,0.432,23,0.523,3,1,0.75,1,1,24,20,10,20,14,0.227,0.455,0.318,17.768,19,python
0,17,17,7,41,0.415,24,0.585,6,1,0.857,0,1,23,18,11,16,14,0.268,0.39,0.341,17.794,20,python
0,20,25,4,49,0.408,24,0.49,7,6,0.538,1,2,29,20,6,25,18,0.122,0.51,0.367,17.801,21,python
0,21,23,2,46,0.457,23,0.5,5,3,0.625,4,2,16,30,15,15,16,0.326,0.326,0.348,17.777,22,python
0,17,23,5,45,0.378,22,0.489,2,4,0.333,3,2,30,15,12,11,22,0.267,0.244,0.489,17.776,23,python
0,21,21,1,43,0.488,22,0.512,1,1,0.5,4,2,23,20,12,13,18,0.279,0.302,0.419,17.731,24,python
0,19,25,3,47,0.404,22,0.468,3,4,0.429,1,3,33,14,9,13,25,0.191,0.277,0.532,17.741,25,python
0,17,23,5,45,0.378,22,0.489,1,2,0.333,3,5,31,14,5,16,24,0.111,0.356,0.533,17.74,26,python
0,19,23,2,44,0.432,21,0.477,2,4,0.333,1,0,32,12,9,16,19,0.205,0.364,0.432,17.767,27,python
0,20,21,2,43,0.465,22,0.512,4,2,0.667,0,2,27,16,15,8,20,0.349,0.186,0.465,17.794,28,python
0,15,29,2,46,0.326,17,0.37,3,5,0.375,0,3,27,19,8,19,19,0.174,0.413,0.413,17.797,29,python
0,16,23,6,45,0.356,22,0.489,4,1,0.8,0,4,31,14,8,16,21,0.178,0.356,0.467,17.806,30,python
0,18,23,3,44,0.409,21,0.477,3,1,0.75,2,3,27,17,9,12,23,0.205,0.273,0.523,17.808,31,python
0,20,19,3,42,0.476,23,0.548,1,2,0.333,2,1,25,17,10,16,16,0.238,0.381,0.381,17.798,32,python
0,21,16,7,44,0.477,28,0.636,4,2,0.667,0,4,29,15,13,12,19,0.295,0.273,0.432,17.809,33,python
0,19,22,4,45,0.422,23,0.511,4,3,0.571,1,1,28,17,7,16,22,0.156,0.356,0.489,17.808,34,python
0,21,20,3,44,0.477,24,0.545,4,1,0.8,0,1,26,18,12,13,19,0.273,0.295,0.432,17.803,35,python
0,15,28,3,46,0.326,18,0.391,7,3,0.7,0,2,33,13,10,14,22,0.217,0.304,0.478,17.813,36,python
0,26,14,7,47,0.553,33,0.702,3,2,0.6,1,1,31,16,16,17,14,0.34,0.362,0.298,17.82,37,python
0,16,25,5,46,0.348,21,0.457,4,1,0.8,1,4,32,14,8,12,26,0.174,0.261,0.565,17.809,38,python
0,20,20,4,44,0.455,24,0.545,1,0,1.0,2,1,27,17,10,15,19,0.227,0.341,0.432,17.809,39,python
0,18,21,6,45,0.4,24,0.533,5,5,0.5,2,2,31,14,9,11,25,0.2,0.244,0.556,17.798,40,python
0,18,23,3,44,0.409,21,0.477,4,4,0.5,2,2,26,18,9,12,23,0.205,0.273,0.523,17.776,41,python
0,22,21,5,48,0.458,27,0.562,4,0,1.0,3,2,26,22,14,12,22,0.292,0.25,0.458,17.758,42,python
0,20,20,4,44,0.455,24,0.545,3,4,0.429,3,1,25,19,11,13,20,0.25,0.295,0.455,17.747,43,python
0,23,22,1,46,0.5,24,0.522,3,3,0.5,1,4,30,16,12,13,21,0.261,0.283,0.457,17.759,44,python
0,25,17,3,45,0.556,28,0.622,2,2,0.5,3,2,29,16,15,10,20,0.333,0.222,0.444,17.75,45,python
0,18,19,7,44,0.409,25,0.568,6,2,0.75,2,2,30,14,6,18,20,0.136,0.409,0.455,17.772,46,python
0,21,19,6,46,0.457,27,0.587,4,2,0.667,2,0,31,15,9,16,21,0.196,0.348,0.457,17.767,47,python
0,18,20,6,44,0.409,24,0.545,2,1,0.667,1,2,31,13,4,19,21,0.091,0.432,0.477,17.78,48,python
0,19,27,1,47,0.404,20,0.426,3,0,1.0,5,4,27,20,6,13,28,0.128,0.277,0.596,17.763,49,python
0,18,24,2,44,0.409,20,0.455,4,1,0.8,2,0,25,19,9,13,22,0.205,0.295,0.5,17.758,50,python
0,18,21,6,45,0.4,24,0.533,0,1,0.0,2,2,29,16,12,13,20,0.267,0.289,0.444,17.749,51,python
0,17,22,5,44,0.386,22,0.5,4,3,0.571,2,0,27,17,9,12,23,0.205,0.273,0.523,17.746,52,python
0,14,29,3,46,0.304,17,0.37,2,1,0.667,2,2,25,21,9,20,17,0.196,0.435,0.37,17.757,53,python
0,21,23,3,47,0.447,24,0.511,4,2,0.667,3,0,33,14,10,13,24,0.213,0.277,0.511,17.754,54,python
0,20,16,9,45,0.444,29,0.644,4,1,0.8,1,1,34,11,13,11,21,0.289,0.244,0.467,17.763,55,python
0,23,21,3,47,0.489,26,0.553,3,1,0.75,1,2,26,21,12,14,21,0.255,0.298,0.447,17.764,56,python
0,22,20,7,49,0.449,29,0.592,3,3,0.5,2,1,24,25,10,20,19,0.204,0.408,0.388,17.767,57,python
0,23,20,3,46,0.5,26,0.565,4,0,1.0,0,1,22,24,14,14,18,0.304,0.304,0.391,17.775,58,python
0,23,11,9,43,0.535,32,0.744,0,0,0,1,0,29,14,11,14,18,0.256,0.326,0.419,17.773,59,python
0,20,23,1,44,0.455,21,0.477,3,1,0.75,2,4,31,13,13,12,19,0.295,0.273,0.432,17.779,60,python
0,18,24,3,45,0.4,21,0.467,1,2,0.333,2,4,30,15,12,12,21,0.267,0.267,0.467,17.783,61,python
0,26,21,1,48,0.542,27,0.562,2,2,0.5,7,1,25,23,10,17,21,0.208,0.354,0.438,17.766,62,python
0,27,14,3,44,0.614,30,0.682,9,1,0.9,3,2,27,17,15,6,23,0.341,0.136,0.523,17.743,63,python
0,19,24,3,46,0.413,22,0.478,1,4,0.2,4,4,34,12,9,12,25,0.196,0.261,0.543,17.743,64,python
0,20,22,4,46,0.435,24,0.522,0,1,0.0,1,2,27,19,12,12,22,0.261,0.261,0.478,17.749,65,python
0,19,21,6,46,0.413,25,0.543,4,4,0.5,2,2,29,17,16,10,20,0.348,0.217,0.435,17.746,66,python
0,20,22,6,48,0.417,26,0.542,2,0,1.0,3,1,28,20,13,17,18,0.271,0.354,0.375,17.742,67,python
0,15,24,5,44,0.341,20,0.455,1,2,0.333,1,1,26,18,10,13,21,0.227,0.295,0.477,17.747,68,python
0,18,23,4,45,0.4,22,0.489,2,2,0.5,3,2,29,16,12,12,21,0.267,0.267,0.467,17.752,69,python
0,14,25,6,45,0.311,20,0.444,5,0,1.0,1,1,29,16,9,14,22,0.2,0.311,0.489,17.749,70,python
0,24,20,2,46,0.522,26,0.565,1,1,0.5,4,1,24,22,13,18,15,0.283,0.391,0.326,17.743,71,python
0,16,26,3,45,0.356,19,0.422,3,4,0.429,3,1,27,18,8,15,22,0.178,0.333,0.489,17.745,72,python
0,17,24,5,46,0.37,22,0.478,2,3,0.4,1,4,29,17,11,9,26,0.239,0.196,0.565,17.738,73,python
0,20,23,2,45,0.444,22,0.489,1,1,0.5,1,0,28,17,10,16,19,0.222,0.356,0.422,17.731,74,python
0,19,23,2,44,0.432,21,0.477,5,2,0.714,2,3,33,11,10,12,22,0.227,0.273,0.5,17.728,75,python
0,19,20,6,45,0.422,25,0.556,2,1,0.667,4,1,29,16,11,13,21,0.244,0.289,0.467,17.737,76,python
0,21,17,5,43,0.488,26,0.605,4,2,0.667,2,1,26,17,8,19,16,0.186,0.442,0.372,17.748,77,python
0,17,25,3,45,0.378,20,0.444,2,2,0.5,2,3,30,15,6,14,25,0.133,0.311,0.556,17.745,78,python
0,19,23,2,44,0.432,21,0.477,5,2,0.714,1,2,34,10,10,9,25,0.227,0.205,0.568,17.737,79,python
0,21,23,2,46,0.457,23,0.5,3,3,0.5,2,1,22,24,11,16,19,0.239,0.348,0.413,17.736,80,python
0,22,17,6,45,0.489,28,0.622,1,0,1.0,2,1,29,16,13,12,20,0.289,0.267,0.444,17.736,81,python
0,14,21,8,43,0.326,22,0.512,4,0,1.0,0,1,30,13,10,13,20,0.233,0.302,0.465,17.737,82,python
0,22,18,4,44,0.5,26,0.591,0,0,0,4,3,30,14,11,15,18,0.25,0.341,0.409,17.735,83,python
0,24,19,2,45,0.533,26,0.578,9,1,0.9,3,2,25,20,14,9,22,0.311,0.2,0.489,17.738,84,python
0,16,26,5,47,0.34,21,0.447,4,2,0.667,1,2,25,22,7,18,22,0.149,0.383,0.468,17.736,85,python
0,22,18,4,44,0.5,26,0.591,3,2,0.6,0,3,29,15,10,15,19,0.227,0.341,0.432,17.736,86,python
0,19,22,7,48,0.396,26,0.542,3,0,1.0,1,2,28,20,8,15,25,0.167,0.312,0.521,17.736,87,python
0,17,30,1,48,0.354,18,0.375,1,3,0.25,2,1,26,22,9,18,21,0.188,0.375,0.438,17.725,88,python
0,19,22,2,43,0.442,21,0.488,4,4,0.5,2,2,28,15,9,13,21,0.209,0.302,0.488,17.721,89,python
0,18,26,3,47,0.383,21,0.447,1,1,0.5,3,4,30,17,8,9,30,0.17,0.191,0.638,17.703,90,python
0,26,18,6,50,0.52,32,0.64,1,1,0.5,2,0,28,22,17,13,20,0.34,0.26,0.4,17.701,91,python
0,23,19,3,45,0.511,26,0.578,3,2,0.6,4,2,27,18,11,13,21,0.244,0.289,0.467,17.69,92,python
0,21,21,2,44,0.477,23,0.523,4,6,0.4,0,0,25,19,14,13,17,0.318,0.295,0.386,17.695,93,python
0,20,23,4,47,0.426,24,0.511,1,1,0.5,2,4,33,14,10,13,24,0.213,0.277,0.511,17.697,94,python
0,22,20,4,46,0.478,26,0.565,4,1,0.8,2,1,24,22,14,16,16,0.304,0.348,0.348,17.697,95,python
0,23,21,1,45,0.511,24,0.533,3,3,0.5,3,1,23,22,12,13,20,0.267,0.289,0.444,17.696,96,python
0,19,21,7,47,0.404,26,0.553,4,0,1.0,2,3,32,15,9,12,26,0.191,0.255,0.553,17.364,1,python
0,21,23,1,45,0.467,22,0.489,3,2,0.6,3,2,26,19,10,15,20,0.222,0.333,0.444,17.625,2,python
0,22,19,5,46,0.478,27,0.587,3,3,0.5,3,1,24,22,15,16,15,0.326,0.348,0.326,17.633,3,python
0,19,24,2,45,0.422,21,0.467,3,2,0.6,2,1,32,13,9,11,25,0.2,0.244,0.556,17.68,4,python
0,18,23,6,47,0.383,24,0.511,3,2,0.6,1,2,31,16,9,16,22,0.191,0.34,0.468,17.626,5,python
0,19,23,4,46,0.413,23,0.5,2,2,0.5,2,3,23,23,13,12,21,0.283,0.261,0.457,17.607,6,python
0,22,21,4,47,0.468,26,0.553,3,3,0.5,1,2,26,21,12,16,19,0.255,0.34,0.404,17.62,7,python
0,18,24,3,45,0.4,21,0.467,3,4,0.429,0,4,30,15,12,13,20,0.267,0.289,0.444,17.725,8,python
0,10,34,3,47,0.213,13,0.277,2,3,0.4,1,3,28,19,6,17,24,0.128,0.362,0.511,17.667,9,python
0,21,19,5,45,0.467,26,0.578,2,3,0.4,2,3,27,18,15,9,21,0.333,0.2,0.467,17.719,10,python
0,20,20,7,47,0.426,27,0.574,4,1,0.8,4,0,26,21,12,13,22,0.255,0.277,0.468,17.778,11,python
0,16,28,2,46,0.348,18,0.391,4,0,1.0,3,4,28,18,6,17,23,0.13,0.37,0.5,17.781,12,python
0,23,17,6,46,0.5,29,0.63,3,1,0.75,4,2,22,24,12,17,17,0.261,0.37,0.37,17.791,13,python
0,17,22,6,45,0.378,23,0.511,4,1,0.8,4,1,29,16,5,14,26,0.111,0.311,0.578,17.809,14,python
0,23,17,5,45,0.511,28,0.622,2,4,0.333,3,4,30,15,15,10,20,0.333,0.222,0.444,17.816,15,python
0,19,19,5,43,0.442,24,0.558,4,0,1.0,0,1,27,16,15,11,17,0.349,0.256,0.395,17.842,16,python
0,23,18,3,44,0.523,26,0.591,4,1,0.8,2,0,28,16,9,17,18,0.205,0.386,0.409,17.862,17,python
0,29,11,5,45,0.644,34,0.756,3,2,0.6,3,1,24,21,16,13,16,0.356,0.289,0.356,17.856,18,python
0,18,24,4,46,0.391,22,0.478,2,1,0.667,1,2,27,19,11,16,19,0.239,0.348,0.413,17.85,19,python
0,30,12,5,47,0.638,35,0.745,2,1,0.667,4,1,28,19,15,12,20,0.319,0.255,0.426,17.83,20,python
0,25,18,1,44,0.568,26,0.591,4,2,0.667,2,1,29,15,15,15,14,0.341,0.341,0.318,17.823,21,python
0,15,22,6,43,0.349,21,0.488,3,2,0.6,2,2,23,20,8,16,19,0.186,0.372,0.442,17.819,22,python
0,23,15,6,44,0.523,29,0.659,5,0,1.0,0,1,23,21,16,12,16,0.364,0.273,0.364,17.836,23,python
0,22,20,4,46,0.478,26,0.565,5,1,0.833,3,2,28,18,8,18,20,0.174,0.391,0.435,17.852,24,python
0,25,17,3,45,0.556,28,0.622,3,1,0.75,1,0,27,18,12,10,23,0.267,0.222,0.511,17.831,25,python
0,26,16,2,44,0.591,28,0.636,5,0,1.0,4,2,21,23,18,8,18,0.409,0.182,0.409,17.824,26,python
0,19,21,5,45,0.422,24,0.533,4,3,0.571,2,2,19,26,9,17,19,0.2,0.378,0.422,17.834,27,python
0,19,22,4,45,0.422,23,0.511,4,3,0.571,3,2,32,13,10,9,26,0.222,0.2,0.578,17.824,28,python
0,22,16,6,44,0.5,28,0.636,4,1,0.8,3,3,26,18,14,11,19,0.318,0.25,0.432,17.803,29,python
0,15,22,8,45,0.333,23,0.511,5,2,0.714,2,1,23,22,8,16,21,0.178,0.356,0.467,17.772,30,python
0,20,20,5,45,0.444,25,0.556,5,4,0.556,3,3,27,18,9,18,18,0.2,0.4,0.4,17.769,31,python
0,14,26,4,44,0.318,18,0.409,3,2,0.6,0,4,26,18,13,17,14,0.295,0.386,0.318,17.789,32,python
0,14,27,7,48,0.292,21,0.438,1,2,0.333,2,1,30,18,5,20,23,0.104,0.417,0.479,17.803,33,python
0,15,27,3,45,0.333,18,0.4,2,1,0.667,1,5,31,14,8,14,23,0.178,0.311,0.511,17.798,34,python
0,26,14,6,46,0.565,32,0.696,5,4,0.556,3,2,31,15,13,12,21,0.283,0.261,0.457,17.819,35,python
0,23,20,0,43,0.535,23,0.535,2,2,0.5,1,2,22,21,15,15,13,0.349,0.349,0.302,17.811,36,python
0,12,27,5,44,0.273,17,0.386,2,3,0.4,1,3,32,12,8,12,24,0.182,0.273,0.545,17.811,37,python
0,16,25,5,46,0.348,21,0.457,6,2,0.75,1,1,28,18,10,15,21,0.217,0.326,0.457,17.813,38,python
0,20,23,3,46,0.435,23,0.5,4,4,0.5,1,3,30,16,8,15,23,0.174,0.326,0.5,17.83,39,python
0,18,22,6,46,0.391,24,0.522,4,3,0.571,3,1,28,18,8,13,25,0.174,0.283,0.543,17.818,40,python
0,22,16,6,44,0.5,28,0.636,3,1,0.75,2,2,25,19,12,18,14,0.273,0.409,0.318,17.836,41,python
0,26,16,1,43,0.605,27,0.628,3,4,0.429,3,2,27,16,13,16,14,0.302,0.372,0.326,17.835,42,python
0,21,21,2,44,0.477,23,0.523,1,3,0.25,3,2,28,16,7,20,17,0.159,0.455,0.386,17.835,43,python
0,25,18,3,46,0.543,28,0.609,3,4,0.429,2,3,26,20,16,10,20,0.348,0.217,0.435,17.826,44,python
0,22,22,3,47,0.468,25,0.532,4,2,0.667,5,2,27,20,9,16,22,0.191,0.34,0.468,17.819,45,python
0,19,26,1,46,0.413,20,0.435,4,1,0.8,3,3,26,20,8,15,23,0.174,0.326,0.5,17.814,46,python
0,18,24,4,46,0.391,22,0.478,2,1,0.667,5,2,28,18,10,13,23,0.217,0.283,0.5,17.813,47,python
0,18,26,3,47,0.383,21,0.447,1,5,0.167,2,4,33,14,10,11,26,0.213,0.234,0.553,17.812,48,python
0,21,24,3,48,0.438,24,0.5,1,2,0.333,2,0,28,20,13,15,20,0.271,0.312,0.417,17.815,49,python
0,20,18,7,45,0.444,27,0.6,3,2,0.6,3,2,23,22,10,18,17,0.222,0.4,0.378,17.807,50,python
0,26,17,2,45,0.578,28,0.622,6,1,0.857,2,2,25,20,12,12,21,0.267,0.267,0.467,17.804,51,python
0,14,26,6,46,0.304,20,0.435,1,3,0.25,1,3,32,14,11,10,25,0.239,0.217,0.543,17.8,52,python
0,19,22,4,45,0.422,23,0.511,0,1,0.0,2,2,34,11,7,11,27,0.156,0.244,0.6,17.799,53,python
0,15,25,4,44,0.341,19,0.432,0,3,0.0,0,2,32,12,10,16,18,0.227,0.364,0.409,17.802,54,python
0,26,14,4,44,0.591,30,0.682,4,1,0.8,3,0,27,17,12,12,20,0.273,0.273,0.455,17.797,55,python
0,24,21,4,49,0.49,28,0.571,5,0,1.0,1,5,32,17,16,7,26,0.327,0.143,0.531,17.798,56,python
0,19,25,2,46,0.413,21,0.457,1,3,0.25,5,1,26,20,9,14,23,0.196,0.304,0.5,17.783,57,python
0,15,26,3,44,0.341,18,0.409,1,0,1.0,2,2,30,14,11,7,26,0.25,0.159,0.591,17.768,58,python
0,23,21,1,45,0.511,24,0.533,3,1,0.75,3,2,28,17,11,13,21,0.244,0.289,0.467,17.776,59,python
0,17,25,2,44,0.386,19,0.432,2,1,0.667,2,5,32,12,9,9,26,0.205,0.205,0.591,17.763,60,python
0,15,23,7,45,0.333,22,0.489,2,2,0.5,1,3,26,19,10,15,20,0.222,0.333,0.444,17.767,61,python
0,18,22,5,45,0.4,23,0.511,3,4,0.429,1,2,22,23,11,15,19,0.244,0.333,0.422,17.77,62,python
0,16,25,4,45,0.356,20,0.444,2,1,0.667,2,4,36,9,6,12,27,0.133,0.267,0.6,17.773,63,python
0,17,23,5,45,0.378,22,0.489,6,3,0.667,0,2,31,14,12,14,19,0.267,0.311,0.422,17.788,64,python
0,18,24,4,46,0.391,22,0.478,3,2,0.6,2,3,29,17,7,15,24,0.152,0.326,0.522,17.788,65,python
0,27,17,3,47,0.574,30,0.638,1,1,0.5,4,0,28,19,15,12,20,0.319,0.255,0.426,17.775,66,python
0,18,23,4,45,0.4,22,0.489,4,2,0.667,2,0,25,20,9,14,22,0.2,0.311,0.489,17.78,67,python
0,17,26,2,45,0.378,19,0.422,3,1,0.75,1,1,35,10,12,12,21,0.267,0.267,0.467,17.775,68,python
0,20,22,2,44,0.455,22,0.5,3,0,1.0,1,2,31,13,10,12,22,0.227,0.273,0.5,17.787,69,python
0,23,19,5,47,0.489,28,0.596,7,1,0.875,2,6,28,19,14,13,20,0.298,0.277,0.426,17.788,70,python
0,21,22,4,47,0.447,25,0.532,1,3,0.25,1,1,21,26,14,17,16,0.298,0.362,0.34,17.793,71,python
0,21,26,6,53,0.396,27,0.509,6,2,0.75,4,1,29,24,6,23,24,0.113,0.434,0.453,17.792,72,python
0,22,18,5,45,0.489,27,0.6,2,0,1.0,1,2,27,18,12,11,22,0.267,0.244,0.489,17.789,73,python
0,20,19,5,44,0.455,25,0.568,3,0,1.0,3,3,30,14,11,12,21,0.25,0.273,0.477,17.795,74,python
0,22,21,6,49,0.449,28,0.571,5,6,0.455,2,3,26,23,16,12,21,0.327,0.245,0.429,17.793,75,python
0,18,22,5,45,0.4,23,0.511,3,0,1.0,0,3,30,15,10,11,24,0.222,0.244,0.533,17.784,76,python
0,19,26,2,47,0.404,21,0.447,4,3,0.571,4,3,33,14,10,10,27,0.213,0.213,0.574,17.77,77,python
0,20,23,5,48,0.417,25,0.521,3,0,1.0,1,1,25,23,14,17,17,0.292,0.354,0.354,17.774,78,python
0,22,21,3,46,0.478,25,0.543,2,3,0.4,7,2,26,20,8,15,23,0.174,0.326,0.5,17.766,79,python
0,17,22,7,46,0.37,24,0.522,2,2,0.5,0,3,25,21,9,16,21,0.196,0.348,0.457,17.77,80,python
0,14,29,2,45,0.311,16,0.356,3,0,1.0,1,5,24,21,9,15,21,0.2,0.333,0.467,17.769,81,python
0,23,20,5,48,0.479,28,0.583,3,2,0.6,3,1,29,19,8,20,20,0.167,0.417,0.417,17.765,82,python
0,17,24,3,44,0.386,20,0.455,2,3,0.4,5,3,29,15,9,11,24,0.205,0.25,0.545,17.749,83,python
0,17,26,4,47,0.362,21,0.447,2,2,0.5,4,2,28,19,12,10,25,0.255,0.213,0.532,17.754,84,python
0,21,25,1,47,0.447,22,0.468,2,3,0.4,2,3,26,21,10,13,24,0.213,0.277,0.511,17.752,85,python
0,20,21,5,46,0.435,25,0.543,4,2,0.667,3,1,30,16,6,15,25,0.13,0.326,0.543,17.749,86,python
0,22,15,8,45,0.489,30,0.667,3,2,0.6,2,3,31,14,12,12,21,0.267,0.267,0.467,17.754,87,python
0,22,16,6,44,0.5,28,0.636,4,2,0.667,3,2,25,19,15,8,21,0.341,0.182,0.477,17.75,88,python
0,24,20,2,46,0.522,26,0.565,3,0,1.0,1,1,28,18,11,18,17,0.239,0.391,0.37,17.746,89,python
0,23,16,6,45,0.511,29,0.644,5,0,1.0,3,1,27,18,10,17,18,0.222,0.378,0.4,17.74,90,python
0,22,22,2,46,0.478,24,0.522,4,1,0.8,1,2,33,13,14,14,18,0.304,0.304,0.391,17.739,91,python
0,21,22,2,45,0.467,23,0.511,1,3,0.25,1,2,28,17,14,13,18,0.311,0.289,0.4,17.746,92,python
0,19,20,5,44,0.432,24,0.545,1,1,0.5,1,4,26,18,10,12,22,0.227,0.273,0.5,17.737,93,python
0,20,24,2,46,0.435,22,0.478,0,3,0.0,3,5,25,21,14,13,19,0.304,0.283,0.413,17.735,94,python
0,18,22,4,44,0.409,22,0.5,3,2,0.6,1,4,33,11,8,15,21,0.182,0.341,0.477,17.74,95,python
0,18,21,5,44,0.409,23,0.523,3,2,0.6,3,5,25,19,7,15,22,0.159,0.341,0.5,17.74,96,python
0,24,20,2,46,0.522,26,0.565,5,2,0.714,3,4,23,23,14,13,19,0.304,0.283,0.413,17.741,1,python
0,23,20,3,46,0.5,26,0.565,1,0,1.0,5,3,29,17,11,10,25,0.239,0.217,0.543,16.732,2,python
0,24,18,4,46,0.522,28,0.609,6,3,0.667,2,1,32,14,17,12,17,0.37,0.261,0.37,17.156,3,python
0,21,20,3,44,0.477,24,0.545,4,3,0.571,3,0,17,27,9,21,14,0.205,0.477,0.318,17.509,4,python
0,17,22,7,46,0.37,24,0.522,4,1,0.8,2,0,28,18,12,21,13,0.261,0.457,0.283,17.609,5,python
0,17,23,5,45,0.378,22,0.489,4,4,0.5,1,0,26,19,10,18,17,0.222,0.4,0.378,17.528,6,python
0,19,24,2,45,0.422,21,0.467,7,4,0.636,2,3,30,15,6,10,29,0.133,0.222,0.644,17.513,7,python
0,25,21,1,47,0.532,26,0.553,1,1,0.5,2,2,34,13,9,12,26,0.191,0.255,0.553,17.502,8,python
0,22,20,4,46,0.478,26,0.565,3,2,0.6,4,2,29,17,10,13,23,0.217,0.283,0.5,17.58,9,python
0,17,22,6,45,0.378,23,0.511,0,1,0.0,1,2,28,17,8,17,20,0.178,0.378,0.444,17.67,10,python
0,16,18,9,43,0.372,25,0.581,4,3,0.571,3,2,25,18,10,11,22,0.233,0.256,0.512,17.661,11,python
0,23,20,6,49,0.469,29,0.592,3,2,0.6,5,1,31,18,10,16,23,0.204,0.327,0.469,17.562,12,python
0,20,23,2,45,0.444,22,0.489,3,2,0.6,1,3,29,16,9,12,24,0.2,0.267,0.533,17.558,13,python
0,25,17,3,45,0.556,28,0.622,4,1,0.8,5,1,25,20,14,13,18,0.311,0.289,0.4,17.56,14,python
0,21,21,3,45,0.467,24,0.533,3,2,0.6,1,2,30,15,10,15,20,0.222,0.333,0.444,17.597,15,python
0,24,23,1,48,0.5,25,0.521,2,1,0.667,4,0,27,21,10,13,25,0.208,0.271,0.521,17.574,16,python
0,16,23,5,44,0.364,21,0.477,4,1,0.8,0,4,27,17,12,12,20,0.273,0.273,0.455,17.57,17,python
0,22,19,1,42,0.524,23,0.548,2,1,0.667,4,1,28,14,10,18,14,0.238,0.429,0.333,17.578,18,python
0,22,24,0,46,0.478,22,0.478,1,1,0.5,2,3,28,18,13,15,18,0.283,0.326,0.391,17.613,19,python
0,25,19,1,45,0.556,26,0.578,9,1,0.9,2,1,27,18,12,14,19,0.267,0.311,0.422,17.631,20,python
0,21,20,3,44,0.477,24,0.545,2,1,0.667,0,2,31,13,11,11,22,0.25,0.25,0.5,17.631,21,python
0,21,21,5,47,0.447,26,0.553,3,5,0.375,2,1,30,17,13,14,20,0.277,0.298,0.426,17.637,22,python
0,24,21,2,47,0.511,26,0.553,3,1,0.75,2,2,30,17,13,13,21,0.277,0.277,0.447,17.638,23,python
0,16,25,3,44,0.364,19,0.432,2,6,0.25,0,4,28,16,9,13,22,0.205,0.295,0.5,17.658,24,python
0,24,17,7,48,0.5,31,0.646,3,3,0.5,3,3,26,22,11,14,23,0.229,0.292,0.479,17.658,25,python
0,24,21,2,47,0.511,26,0.553,1,2,0.333,5,1,20,27,10,19,18,0.213,0.404,0.383,17.625,26,python
0,23,20,3,46,0.5,26,0.565,4,1,0.8,2,4,29,17,12,16,18,0.261,0.348,0.391,17.646,27,python
0,25,18,3,46,0.543,28,0.609,3,3,0.5,3,3,27,19,18,11,17,0.391,0.239,0.37,17.634,28,python
0,18,23,4,45,0.4,22,0.489,5,2,0.714,2,2,28,17,14,11,20,0.311,0.244,0.444,17.654,29,python
0,25,22,2,49,0.51,27,0.551,2,1,0.667,5,1,24,25,12,17,20,0.245,0.347,0.408,17.626,30,python
0,19,22,2,43,0.442,21,0.488,4,3,0.571,1,0,21,22,11,12,20,0.256,0.279,0.465,17.628,31,python
0,18,21,6,45,0.4,24,0.533,4,1,0.8,1,2,25,20,9,19,17,0.2,0.422,0.378,17.64,32,python
0,23,21,4,48,0.479,27,0.562,1,2,0.333,4,0,20,28,14,15,19,0.292,0.312,0.396,17.646,33,python
0,22,22,2,46,0.478,24,0.522,3,1,0.75,3,3,28,18,11,14,21,0.239,0.304,0.457,17.627,34,python
0,23,22,4,49,0.469,27,0.551,2,6,0.25,3,2,29,20,9,14,26,0.184,0.286,0.531,17.627,35,python
0,23,19,2,44,0.523,25,0.568,1,2,0.333,4,1,23,21,10,14,20,0.227,0.318,0.455,17.591,36,python
0,20,24,2,46,0.435,22,0.478,2,3,0.4,1,3,28,18,14,13,19,0.304,0.283,0.413,17.615,37,python
0,25,21,2,48,0.521,27,0.562,5,3,0.625,1,1,27,21,14,13,21,0.292,0.271,0.438,17.611,38,python
0,17,21,7,45,0.378,24,0.533,3,1,0.75,1,2,33,12,6,16,23,0.133,0.356,0.511,17.613,39,python
0,20,23,3,46,0.435,23,0.5,4,1,0.8,4,3,31,15,8,15,23,0.174,0.326,0.5,17.599,40,python
0,24,21,5,50,0.48,29,0.58,4,0,1.0,3,1,27,23,15,14,21,0.3,0.28,0.42,17.597,41,python
0,17,26,1,44,0.386,18,0.409,2,2,0.5,0,2,35,9,5,14,25,0.114,0.318,0.568,17.6,42,python
0,24,18,2,44,0.545,26,0.591,2,4,0.333,2,2,24,20,14,12,18,0.318,0.273,0.409,17.602,43,python
0,24,20,3,47,0.511,27,0.574,7,7,0.5,0,3,29,18,10,11,26,0.213,0.234,0.553,17.609,44,python
0,25,14,5,44,0.568,30,0.682,7,2,0.778,1,2,26,18,13,12,19,0.295,0.273,0.432,17.596,45,python
0,17,23,6,46,0.37,23,0.5,2,1,0.667,1,3,30,16,13,11,22,0.283,0.239,0.478,17.599,46,python
0,23,20,2,45,0.511,25,0.556,5,3,0.625,2,3,23,22,18,11,16,0.4,0.244,0.356,17.61,47,python
0,16,22,5,43,0.372,21,0.488,2,1,0.667,1,0,26,17,9,15,19,0.209,0.349,0.442,17.598,48,python
0,19,23,2,44,0.432,21,0.477,2,3,0.4,3,2,31,13,10,13,21,0.227,0.295,0.477,17.609,49,python
0,21,20,4,45,0.467,25,0.556,3,1,0.75,3,3,31,14,11,11,23,0.244,0.244,0.511,17.596,50,python
0,19,25,3,47,0.404,22,0.468,1,3,0.25,2,2,25,22,14,16,17,0.298,0.34,0.362,17.607,51,python
0,16,25,5,46,0.348,21,0.457,1,1,0.5,2,3,27,19,11,15,20,0.239,0.326,0.435,17.622,52,python
0,23,19,5,47,0.489,28,0.596,4,0,1.0,2,2,26,21,13,15,19,0.277,0.319,0.404,17.628,53,python
0,24,22,2,48,0.5,26,0.542,6,2,0.75,4,1,31,17,13,12,23,0.271,0.25,0.479,17.61,54,python
0,14,27,4,45,0.311,18,0.4,2,2,0.5,0,4,30,15,8,17,20,0.178,0.378,0.444,17.619,55,python
0,18,23,4,45,0.4,22,0.489,2,2,0.5,2,3,26,19,10,14,21,0.222,0.311,0.467,17.617,56,python
0,21,22,6,49,0.429,27,0.551,3,1,0.75,3,3,28,21,9,16,24,0.184,0.327,0.49,17.62,57,python
0,19,21,5,45,0.422,24,0.533,2,0,1.0,3,1,22,23,11,18,16,0.244,0.4,0.356,17.619,58,python
0,18,23,4,45,0.4,22,0.489,1,1,0.5,2,2,26,19,11,12,22,0.244,0.267,0.489,17.606,59,python
0,24,19,3,46,0.522,27,0.587,1,3,0.25,2,2,29,17,15,12,19,0.326,0.261,0.413,17.61,60,python
0,20,22,4,46,0.435,24,0.522,2,0,1.0,4,2,23,23,14,13,19,0.304,0.283,0.413,17.603,61,python
0,21,20,6,47,0.447,27,0.574,3,3,0.5,4,3,26,21,8,15,24,0.17,0.319,0.511,17.599,62,python
0,17,25,4,46,0.37,21,0.457,1,2,0.333,2,3,31,15,9,11,26,0.196,0.239,0.565,17.591,63,python
0,21,17,5,43,0.488,26,0.605,5,0,1.0,0,1,26,17,9,13,21,0.209,0.302,0.488,17.587,64,python
0,25,21,2,48,0.521,27,0.562,4,0,1.0,4,0,29,19,16,11,21,0.333,0.229,0.438,17.585,65,python
0,15,24,7,46,0.326,22,0.478,1,2,0.333,1,3,30,16,9,15,22,0.196,0.326,0.478,17.578,66,python
0,18,20,5,43,0.419,23,0.535,1,3,0.25,1,3,30,13,14,12,17,0.326,0.279,0.395,17.58,67,python
0,21,20,5,46,0.457,26,0.565,2,1,0.667,0,2,27,19,11,16,19,0.239,0.348,0.413,17.587,68,python
0,26,16,4,46,0.565,30,0.652,5,1,0.833,5,2,26,20,11,14,21,0.239,0.304,0.457,17.574,69,python
0,16,23,7,46,0.348,23,0.5,5,4,0.556,3,5,31,15,8,12,26,0.174,0.261,0.565,17.575,70,python
0,19,26,2,47,0.404,21,0.447,1,3,0.25,3,4,34,13,12,11,24,0.255,0.234,0.511,17.574,71,python
0,23,15,5,43,0.535,28,0.651,3,3,0.5,3,0,24,19,11,18,14,0.256,0.419,0.326,17.584,72,python
0,25,21,2,48,0.521,27,0.562,3,2,0.6,2,2,25,23,12,15,21,0.25,0.312,0.438,17.589,73,python
0,22,18,8,48,0.458,30,0.625,2,2,0.5,4,3,26,22,12,15,21,0.25,0.312,0.438,17.59,74,python
0,18,22,4,44,0.409,22,0.5,1,3,0.25,1,3,25,19,9,14,21,0.205,0.318,0.477,17.588,75,python
0,25,22,4,51,0.49,29,0.569,1,5,0.167,0,0,28,23,18,18,15,0.353,0.353,0.294,17.598,76,python
0,18,21,7,46,0.391,25,0.543,2,1,0.667,3,4,28,18,12,11,23,0.261,0.239,0.5,17.6,77,python
0,23,14,6,43,0.535,29,0.674,7,1,0.875,1,1,25,18,13,15,15,0.302,0.349,0.349,17.609,78,python
0,20,20,5,45,0.444,25,0.556,4,2,0.667,3,1,26,19,11,11,23,0.244,0.244,0.511,17.611,79,python
0,19,24,3,46,0.413,22,0.478,3,2,0.6,1,4,28,18,8,17,21,0.174,0.37,0.457,17.608,80,python
0,17,25,4,46,0.37,21,0.457,2,0,1.0,1,2,26,20,8,20,18,0.174,0.435,0.391,17.61,81,python
0,18,21,5,44,0.409,23,0.523,0,1,0.0,3,1,29,15,10,13,21,0.227,0.295,0.477,17.602,82,python
0,15,24,6,45,0.333,21,0.467,2,2,0.5,3,3,28,17,8,14,23,0.178,0.311,0.511,17.595,83,python
0,15,26,8,49,0.306,23,0.469,4,3,0.571,0,2,29,20,10,12,27,0.204,0.245,0.551,17.608,84,python
0,20,20,3,43,0.465,23,0.535,6,1,0.857,0,2,30,13,12,13,18,0.279,0.302,0.419,17.608,85,python
0,13,32,3,48,0.271,16,0.333,2,5,0.286,2,3,32,16,3,16,29,0.062,0.333,0.604,17.61,86,python
0,15,26,6,47,0.319,21,0.447,1,4,0.2,2,2,29,18,5,20,22,0.106,0.426,0.468,17.615,87,python
0,15,22,7,44,0.341,22,0.5,2,2,0.5,0,1,27,17,11,14,19,0.25,0.318,0.432,17.617,88,python
0,20,19,3,42,0.476,23,0.548,3,2,0.6,1,0,24,18,13,13,16,0.31,0.31,0.381,17.621,89,python
0,23,16,7,46,0.5,30,0.652,4,1,0.8,4,2,27,19,12,14,20,0.261,0.304,0.435,17.623,90,python
0,25,17,3,45,0.556,28,0.622,2,1,0.667,1,0,25,20,13,17,15,0.289,0.378,0.333,17.626,91,python
0,23,20,3,46,0.5,26,0.565,1,2,0.333,2,1,26,20,13,16,17,0.283,0.348,0.37,17.627,92,python
0,16,24,4,44,0.364,20,0.455,1,2,0.333,1,4,25,19,10,16,18,0.227,0.364,0.409,17.629,93,python
0,21,20,4,45,0.467,25,0.556,3,0,1.0,2,6,30,15,10,15,20,0.222,0.333,0.444,17.628,94,python
0,19,21,4,44,0.432,23,0.523,5,5,0.5,3,3,26,18,11,16,17,0.25,0.364,0.386,17.631,95,python
0,16,28,1,45,0.356,17,0.378,2,1,0.667,2,0,24,21,9,20,16,0.2,0.444,0.356,17.635,96,python
0,23,20,2,45,0.511,25,0.556,3,1,0.75,1,1,24,21,13,15,17,0.289,0.333,0.378,17.731,1,python
0,18,22,4,44,0.409,22,0.5,3,0,1.0,1,2,28,16,8,17,19,0.182,0.386,0.432,17.429,2,python
0,18,24,4,46,0.391,22,0.478,3,3,0.5,1,2,32,14,9,13,24,0.196,0.283,0.522,17.631,3,python
0,25,17,4,46,0.543,29,0.63,5,2,0.714,3,3,31,15,14,8,24,0.304,0.174,0.522,17.696,4,python
0,20,21,4,45,0.444,24,0.533,2,2,0.5,2,0,23,22,11,16,18,0.244,0.356,0.4,17.801,5,python
0,14,23,7,44,0.318,21,0.477,4,2,0.667,1,0,28,16,5,16,23,0.114,0.364,0.523,17.767,6,python
0,18,21,6,45,0.4,24,0.533,5,3,0.625,0,3,23,22,6,21,18,0.133,0.467,0.4,17.85,7,python
0,21,25,4,50,0.42,25,0.5,2,2,0.5,1,3,30,20,14,17,19,0.28,0.34,0.38,17.888,8,python
0,20,25,6,51,0.392,26,0.51,0,2,0.0,2,1,32,19,11,22,18,0.216,0.431,0.353,17.865,9,python
0,23,20,5,48,0.479,28,0.583,3,4,0.429,2,4,37,11,12,12,24,0.25,0.25,0.5,17.887,10,python
0,22,18,7,47,0.468,29,0.617,2,2,0.5,2,2,31,16,13,14,20,0.277,0.298,0.426,17.885,11,python
0,19,23,3,45,0.422,22,0.489,1,2,0.333,1,3,29,16,10,15,20,0.222,0.333,0.444,17.858,12,python
0,20,24,6,50,0.4,26,0.52,5,3,0.625,6,2,34,16,7,15,28,0.14,0.3,0.56,17.787,13,python
0,21,23,3,47,0.447,24,0.511,2,1,0.667,2,2,22,25,13,14,20,0.277,0.298,0.426,17.757,14,python
0,15,25,7,47,0.319,22,0.468,3,4,0.429,1,4,28,19,5,19,23,0.106,0.404,0.489,17.77,15,python
0,21,18,4,43,0.488,25,0.581,2,3,0.4,2,1,26,17,11,17,15,0.256,0.395,0.349,17.814,16,python
0,22,20,5,47,0.468,27,0.574,2,3,0.4,2,3,28,19,13,11,23,0.277,0.234,0.489,17.778,17,python
0,18,22,4,44,0.409,22,0.5,4,0,1.0,1,1,26,18,13,11,20,0.295,0.25,0.455,17.799,18,python
0,20,24,3,47,0.426,23,0.489,3,0,1.0,0,0,24,23,13,16,18,0.277,0.34,0.383,17.825,19,python
0,20,22,4,46,0.435,24,0.522,3,1,0.75,1,3,28,18,9,17,20,0.196,0.37,0.435,17.809,20,python
0,19,23,6,48,0.396,25,0.521,3,1,0.75,1,0,38,10,10,5,33,0.208,0.104,0.688,17.778,21,python
0,23,21,1,45,0.511,24,0.533,4,3,0.571,2,1,28,17,11,10,24,0.244,0.222,0.533,17.753,22,python
0,20,21,5,46,0.435,25,0.543,3,1,0.75,1,1,30,16,13,15,18,0.283,0.326,0.391,17.754,23,python
0,18,24,4,46,0.391,22,0.478,1,1,0.5,2,3,28,18,10,12,24,0.217,0.261,0.522,17.729,24,python
0,18,23,5,46,0.391,23,0.5,3,2,0.6,2,3,31,15,11,14,21,0.239,0.304,0.457,17.722,25,python
0,17,22,4,43,0.395,21,0.488,5,1,0.833,2,2,24,19,12,15,16,0.279,0.349,0.372,17.722,26,python
0,23,18,7,48,0.479,30,0.625,6,2,0.75,1,4,19,29,15,19,14,0.312,0.396,0.292,17.754,27,python
0,21,22,6,49,0.429,27,0.551,8,1,0.889,2,1,28,21,12,13,24,0.245,0.265,0.49,17.761,28,python
0,18,24,2,44,0.409,20,0.455,4,0,1.0,4,0,28,16,7,16,21,0.159,0.364,0.477,17.737,29,python
0,21,22,2,45,0.467,23,0.511,1,2,0.333,1,1,29,16,11,14,20,0.244,0.311,0.444,17.74,30,python
0,14,26,6,46,0.304,20,0.435,1,2,0.333,5,3,29,17,7,16,23,0.152,0.348,0.5,17.735,31,python
0,19,23,2,44,0.432,21,0.477,4,5,0.444,2,1,27,17,9,15,20,0.205,0.341,0.455,17.738,32,python
0,16,25,4,45,0.356,20,0.444,5,3,0.625,1,3,24,21,10,17,18,0.222,0.378,0.4,17.751,33,python
0,20,19,4,43,0.465,24,0.558,4,1,0.8,1,2,28,15,11,13,19,0.256,0.302,0.442,17.736,34,python
0,17,24,4,45,0.378,21,0.467,2,0,1.0,4,4,27,18,8,13,24,0.178,0.289,0.533,17.735,35,python
0,17,23,5,45,0.378,22,0.489,6,5,0.545,2,2,28,17,9,13,23,0.2,0.289,0.511,17.735,36,python
0,19,22,4,45,0.422,23,0.511,4,4,0.5,0,1,27,18,14,12,19,0.311,0.267,0.422,17.73,37,python
0,22,23,3,48,0.458,25,0.521,2,4,0.333,1,2,29,19,11,19,18,0.229,0.396,0.375,17.714,38,python
0,19,22,6,47,0.404,25,0.532,5,4,0.556,2,1,27,20,10,15,22,0.213,0.319,0.468,17.721,39,python
0,22,19,4,45,0.489,26,0.578,6,1,0.857,3,2,26,19,10,17,18,0.222,0.378,0.4,17.732,40,python
0,16,26,2,44,0.364,18,0.409,3,3,0.5,2,5,27,17,12,11,21,0.273,0.25,0.477,17.726,41,python
0,19,20,3,42,0.452,22,0.524,5,4,0.556,2,1,24,18,11,13,18,0.262,0.31,0.429,17.719,42,python
0,12,30,3,45,0.267,15,0.333,2,3,0.4,2,5,33,12,7,10,28,0.156,0.222,0.622,17.719,43,python
0,22,18,4,44,0.5,26,0.591,3,2,0.6,2,1,29,15,10,14,20,0.227,0.318,0.455,17.692,44,python
0,18,23,5,46,0.391,23,0.5,4,2,0.667,2,2,25,21,13,14,19,0.283,0.304,0.413,17.696,45,python
0,20,24,3,47,0.426,23,0.489,6,3,0.667,1,2,29,18,12,19,16,0.255,0.404,0.34,17.691,46,python
0,28,10,6,44,0.636,34,0.773,7,1,0.875,3,1,23,21,16,12,16,0.364,0.273,0.364,17.706,47,python
0,25,15,5,45,0.556,30,0.667,1,2,0.333,2,0,21,24,13,15,17,0.289,0.333,0.378,17.705,48,python
0,25,19,5,49,0.51,30,0.612,4,3,0.571,1,1,27,22,14,14,21,0.286,0.286,0.429,17.713,49,python
0,18,25,3,46,0.391,21,0.457,5,1,0.833,1,4,26,20,12,13,21,0.261,0.283,0.457,17.707,50,python
0,22,15,6,43,0.512,28,0.651,3,2,0.6,1,1,30,13,15,15,13,0.349,0.349,0.302,17.711,51,python
0,18,23,5,46,0.391,23,0.5,2,2,0.5,1,3,31,15,10,13,23,0.217,0.283,0.5,17.703,52,python
0,22,19,4,45,0.489,26,0.578,1,0,1.0,5,1,25,20,9,15,21,0.2,0.333,0.467,17.688,53,python
0,20,24,3,47,0.426,23,0.489,1,1,0.5,3,2,27,20,6,15,26,0.128,0.319,0.553,17.687,54,python
0,31,12,1,44,0.705,32,0.727,4,0,1.0,2,0,25,19,18,12,14,0.409,0.273,0.318,17.681,55,python
0,21,18,6,45,0.467,27,0.6,2,4,0.333,2,3,23,22,11,16,18,0.244,0.356,0.4,17.692,56,python
0,27,16,2,45,0.6,29,0.644,4,2,0.667,2,2,26,19,13,16,16,0.289,0.356,0.356,17.696,57,python
0,19,23,2,44,0.432,21,0.477,2,5,0.286,1,1,22,22,11,17,16,0.25,0.386,0.364,17.699,58,python
0,19,20,6,45,0.422,25,0.556,2,1,0.667,2,5,25,20,10,14,21,0.222,0.311,0.467,17.692,59,python
0,22,20,4,46,0.478,26,0.565,5,0,1.0,4,2,27,19,11,12,23,0.239,0.261,0.5,17.691,60,python
0,17,23,5,45,0.378,22,0.489,2,1,0.667,2,1,26,19,7,15,23,0.156,0.333,0.511,17.695,61,python
0,21,23,4,48,0.438,25,0.521,2,1,0.667,2,1,27,21,14,13,21,0.292,0.271,0.438,17.694,62,python
0,17,23,5,45,0.378,22,0.489,5,3,0.625,2,2,22,23,5,23,17,0.111,0.511,0.378,17.703,63,python
0,25,17,3,45,0.556,28,0.622,1,2,0.333,5,1,20,25,12,15,18,0.267,0.333,0.4,17.707,64,python
0,23,19,5,47,0.489,28,0.596,2,3,0.4,4,2,34,13,10,15,22,0.213,0.319,0.468,17.704,65,python
0,20,20,5,45,0.444,25,0.556,5,0,1.0,2,1,33,12,5,15,25,0.111,0.333,0.556,17.699,66,python
0,20,19,6,45,0.444,26,0.578,3,0,1.0,2,4,32,13,12,9,24,0.267,0.2,0.533,17.692,67,python
0,20,16,8,44,0.455,28,0.636,4,0,1.0,1,4,28,16,14,11,19,0.318,0.25,0.432,17.696,68,python
0,19,23,1,43,0.442,20,0.465,3,1,0.75,1,1,24,19,13,14,16,0.302,0.326,0.372,17.686,69,python
0,15,24,6,45,0.333,21,0.467,1,3,0.25,1,1,29,16,10,16,19,0.222,0.356,0.422,17.693,70,python
0,21,17,5,43,0.488,26,0.605,4,1,0.8,1,0,25,18,15,14,14,0.349,0.326,0.326,17.693,71,python
0,11,28,6,45,0.244,17,0.378,5,0,1.0,1,4,29,16,3,21,21,0.067,0.467,0.467,17.697,72,python
0,22,18,6,46,0.478,28,0.609,3,2,0.6,3,2,21,25,18,11,17,0.391,0.239,0.37,17.698,73,python
0,23,15,6,44,0.523,29,0.659,1,0,1.0,2,2,32,12,13,13,18,0.295,0.295,0.409,17.698,74,python
0,15,21,9,45,0.333,24,0.533,3,1,0.75,2,4,35,10,5,14,26,0.111,0.311,0.578,17.699,75,python
0,17,27,1,45,0.378,18,0.4,3,4,0.429,1,1,30,15,10,14,21,0.222,0.311,0.467,17.7,76,python
0,20,18,6,44,0.455,26,0.591,6,2,0.75,1,1,25,19,11,15,18,0.25,0.341,0.409,17.707,77,python
0,23,22,3,48,0.479,26,0.542,4,4,0.5,3,0,27,21,12,16,20,0.25,0.333,0.417,17.711,78,python
0,22,18,5,45,0.489,27,0.6,2,1,0.667,2,5,30,15,10,11,24,0.222,0.244,0.533,17.714,79,python
0,19,20,6,45,0.422,25,0.556,2,6,0.25,4,0,32,13,11,13,21,0.244,0.289,0.467,17.712,80,python
0,20,21,3,44,0.455,23,0.523,5,2,0.714,1,0,24,20,13,14,17,0.295,0.318,0.386,17.706,81,python
0,19,16,10,45,0.422,29,0.644,1,4,0.2,2,1,29,16,11,15,19,0.244,0.333,0.422,17.716,82,python
0,20,22,3,45,0.444,23,0.511,4,2,0.667,0,0,27,18,9,14,22,0.2,0.311,0.489,17.715,83,python
0,21,27,2,50,0.42,23,0.46,2,5,0.286,3,4,30,20,12,15,23,0.24,0.3,0.46,17.706,84,python
0,16,24,4,44,0.364,20,0.455,2,3,0.4,4,2,20,24,11,11,22,0.25,0.25,0.5,17.694,85,python
0,20,23,4,47,0.426,24,0.511,0,0,0,3,1,29,18,10,18,19,0.213,0.383,0.404,17.684,86,python
0,27,14,4,45,0.6,31,0.689,3,0,1.0,0,2,27,18,19,11,15,0.422,0.244,0.333,17.686,87,python
0,21,27,1,49,0.429,22,0.449,1,0,1.0,2,7,30,19,11,11,27,0.224,0.224,0.551,17.684,88,python
0,18,25,2,45,0.4,20,0.444,2,3,0.4,3,0,25,20,6,16,23,0.133,0.356,0.511,17.689,89,python
0,18,25,6,49,0.367,24,0.49,4,4,0.5,4,1,30,19,8,18,23,0.163,0.367,0.469,17.686,90,python
0,15,25,6,46,0.326,21,0.457,1,1,0.5,4,3,25,21,2,21,23,0.043,0.457,0.5,17.686,91,python
0,18,23,5,46,0.391,23,0.5,1,2,0.333,0,2,29,17,11,15,20,0.239,0.326,0.435,17.687,92,python
0,23,16,4,43,0.535,27,0.628,3,2,0.6,2,1,29,14,11,12,20,0.256,0.279,0.465,17.686,93,python
0,24,20,4,48,0.5,28,0.583,3,3,0.5,3,3,23,25,17,14,17,0.354,0.292,0.354,17.687,94,python
0,20,17,8,45,0.444,28,0.622,0,2,0.0,4,2,24,21,11,14,20,0.244,0.311,0.444,17.681,95,python
0,24,19,3,46,0.522,27,0.587,8,0,1.0,4,2,23,23,18,12,16,0.391,0.261,0.348,17.681,96,python
0,19,22,4,45,0.422,23,0.511,4,3,0.571,2,2,31,14,11,12,22,0.244,0.267,0.489,17.821,1,python
0,20,18,6,44,0.455,26,0.591,3,0,1.0,2,2,27,17,10,14,20,0.227,0.318,0.455,17.737,2,python
0,22,16,5,43,0.512,27,0.628,4,0,1.0,5,1,25,18,8,15,20,0.186,0.349,0.465,17.596,3,python
0,28,19,2,49,0.571,30,0.612,0,1,0.0,1,1,34,15,12,14,23,0.245,0.286,0.469,17.417,4,python
0,23,21,3,47,0.489,26,0.553,7,1,0.875,2,6,29,18,13,9,25,0.277,0.191,0.532,17.315,5,python
0,23,17,5,45,0.511,28,0.622,4,1,0.8,1,1,26,19,13,12,20,0.289,0.267,0.444,17.42,6,python
0,25,20,3,48,0.521,28,0.583,1,5,0.167,3,3,29,19,10,17,21,0.208,0.354,0.438,17.437,7,python
0,18,24,4,46,0.391,22,0.478,0,2,0.0,2,2,31,15,11,15,20,0.239,0.326,0.435,17.496,8,python
0,24,19,3,46,0.522,27,0.587,3,4,0.429,4,1,25,21,12,17,17,0.261,0.37,0.37,17.527,9,python
0,31,13,2,46,0.674,33,0.717,3,2,0.6,3,1,23,23,15,12,19,0.326,0.261,0.413,17.471,10,python
0,26,19,2,47,0.553,28,0.596,3,3,0.5,3,0,30,17,16,10,21,0.34,0.213,0.447,17.43,11,python
0,15,24,6,45,0.333,21,0.467,2,3,0.4,2,4,26,19,8,15,22,0.178,0.333,0.489,17.349,12,python
0,16,22,7,45,0.356,23,0.511,0,3,0.0,1,3,31,14,11,15,19,0.244,0.333,0.422,17.408,13,python
0,15,28,4,47,0.319,19,0.404,3,2,0.6,2,2,31,16,9,16,22,0.191,0.34,0.468,17.384,14,python
0,19,23,3,45,0.422,22,0.489,2,2,0.5,1,2,31,14,12,10,23,0.267,0.222,0.511,17.406,15,python
0,19,24,3,46,0.413,22,0.478,1,0,1.0,2,4,35,11,12,6,28,0.261,0.13,0.609,17.412,16,python
0,19,19,5,43,0.442,24,0.558,4,0,1.0,1,1,29,14,13,10,20,0.302,0.233,0.465,17.439,17,python
0,13,19,11,43,0.302,24,0.558,3,2,0.6,1,3,27,16,7,13,23,0.163,0.302,0.535,17.466,18,python
0,21,19,4,44,0.477,25,0.568,2,2,0.5,2,2,31,13,11,16,17,0.25,0.364,0.386,17.486,19,python
0,20,26,2,48,0.417,22,0.458,5,3,0.625,2,3,26,22,9,16,23,0.188,0.333,0.479,17.493,20,python
0,19,22,5,46,0.413,24,0.522,1,0,1.0,2,3,31,15,8,18,20,0.174,0.391,0.435,17.479,21,python
0,21,23,1,45,0.467,22,0.489,2,1,0.667,3,1,24,21,9,13,23,0.2,0.289,0.511,17.466,22,python
0,21,26,2,49,0.429,23,0.469,3,2,0.6,2,5,30,19,14,10,25,0.286,0.204,0.51,17.444,23,python
0,26,20,2,48,0.542,28,0.583,2,1,0.667,2,2,26,22,12,13,23,0.25,0.271,0.479,17.413,24,python
0,21,22,2,45,0.467,23,0.511,3,2,0.6,3,4,26,19,15,11,19,0.333,0.244,0.422,17.414,25,python
0,20,22,3,45,0.444,23,0.511,4,2,0.667,1,2,27,18,12,13,20,0.267,0.289,0.444,17.419,26,python
0,15,23,6,44,0.341,21,0.477,2,4,0.333,1,1,31,13,10,13,21,0.227,0.295,0.477,17.455,27,python
0,22,21,3,46,0.478,25,0.543,3,2,0.6,2,3,32,14,13,11,22,0.283,0.239,0.478,17.442,28,python
0,23,19,6,48,0.479,29,0.604,4,1,0.8,2,3,27,21,14,14,20,0.292,0.292,0.417,17.464,29,python
0,21,25,2,48,0.438,23,0.479,2,4,0.333,1,4,27,21,12,16,20,0.25,0.333,0.417,17.484,30,python
0,18,24,4,46,0.391,22,0.478,2,3,0.4,1,1,27,19,10,15,21,0.217,0.326,0.457,17.505,31,python
0,24,17,3,44,0.545,27,0.614,5,0,1.0,4,2,25,19,14,8,22,0.318,0.182,0.5,17.493,32,python
0,16,23,6,45,0.356,22,0.489,2,3,0.4,2,3,29,16,13,9,23,0.289,0.2,0.511,17.507,33,python
0,23,19,4,46,0.5,27,0.587,5,1,0.833,1,3,30,16,14,13,19,0.304,0.283,0.413,17.516,34,python
0,21,19,4,44,0.477,25,0.568,3,3,0.5,1,1,24,20,14,14,16,0.318,0.318,0.364,17.517,35,python
0,17,21,7,45,0.378,24,0.533,2,3,0.4,4,1,27,18,10,16,19,0.222,0.356,0.422,17.526,36,python
0,25,16,3,44,0.568,28,0.636,3,3,0.5,1,1,27,17,17,10,17,0.386,0.227,0.386,17.535,37,python
0,13,28,4,45,0.289,17,0.378,3,1,0.75,2,5,32,13,6,11,28,0.133,0.244,0.622,17.539,38,python
0,13,30,3,46,0.283,16,0.348,1,6,0.143,0,1,25,21,6,24,16,0.13,0.522,0.348,17.556,39,python
0,23,19,1,43,0.535,24,0.558,6,3,0.667,1,1,29,14,14,13,16,0.326,0.302,0.372,17.583,40,python
0,21,23,2,46,0.457,23,0.5,2,2,0.5,4,2,27,19,12,14,20,0.261,0.304,0.435,17.571,41,python
0,19,23,3,45,0.422,22,0.489,2,5,0.286,2,0,23,22,10,14,21,0.222,0.311,0.467,17.567,42,python
0,24,22,2,48,0.5,26,0.542,6,1,0.857,3,1,30,18,8,15,25,0.167,0.312,0.521,17.586,43,python
0,22,18,6,46,0.478,28,0.609,5,1,0.833,1,3,33,13,15,12,19,0.326,0.261,0.413,17.584,44,python
0,32,11,2,45,0.711,34,0.756,3,1,0.75,2,1,22,23,17,9,19,0.378,0.2,0.422,17.574,45,python
0,21,22,5,48,0.438,26,0.542,1,1,0.5,1,2,26,22,12,16,20,0.25,0.333,0.417,17.583,46,python
0,21,17,7,45,0.467,28,0.622,3,1,0.75,2,2,29,16,12,13,20,0.267,0.289,0.444,17.583,47,python
0,25,19,4,48,0.521,29,0.604,4,2,0.667,1,4,31,17,6,22,20,0.125,0.458,0.417,17.592,48,python
0,19,23,4,46,0.413,23,0.5,3,0,1.0,3,1,22,24,10,15,21,0.217,0.326,0.457,17.576,49,python
0,24,18,4,46,0.522,28,0.609,1,5,0.167,4,1,28,18,15,11,20,0.326,0.239,0.435,17.568,50,python
0,20,22,3,45,0.444,23,0.511,3,2,0.6,5,4,29,16,8,12,25,0.178,0.267,0.556,17.551,51,python
0,23,22,1,46,0.5,24,0.522,3,1,0.75,2,1,29,17,10,13,23,0.217,0.283,0.5,17.545,52,python
0,19,21,5,45,0.422,24,0.533,1,3,0.25,2,3,30,15,7,14,24,0.156,0.311,0.533,17.532,53,python
0,20,22,4,46,0.435,24,0.522,1,3,0.25,2,2,25,21,7,14,25,0.152,0.304,0.543,17.521,54,python
0,15,25,7,47,0.319,22,0.468,3,1,0.75,1,3,23,24,7,22,18,0.149,0.468,0.383,17.527,55,python
0,16,24,8,48,0.333,24,0.5,1,4,0.2,3,2,25,23,9,18,21,0.188,0.375,0.438,17.535,56,python
0,17,27,3,47,0.362,20,0.426,2,6,0.25,2,1,25,22,9,19,19,0.191,0.404,0.404,17.526,57,python
0,23,20,4,47,0.489,27,0.574,5,0,1.0,1,2,32,15,15,13,19,0.319,0.277,0.404,17.53,58,python
0,19,21,5,45,0.422,24,0.533,3,1,0.75,2,4,28,17,12,10,23,0.267,0.222,0.511,17.525,59,python
0,18,19,5,42,0.429,23,0.548,6,2,0.75,2,0,22,20,8,15,19,0.19,0.357,0.452,17.532,60,python
0,18,24,6,48,0.375,24,0.5,2,4,0.333,0,3,29,19,10,13,25,0.208,0.271,0.521,17.537,61,python
0,21,23,2,46,0.457,23,0.5,3,2,0.6,2,6,32,14,9,12,25,0.196,0.261,0.543,17.539,62,python
0,17,27,2,46,0.37,19,0.413,2,4,0.333,1,2,31,15,11,12,23,0.239,0.261,0.5,17.529,63,python
0,15,23,8,46,0.326,23,0.5,2,4,0.333,1,2,34,12,6,19,21,0.13,0.413,0.457,17.537,64,python
0,25,17,2,44,0.568,27,0.614,1,3,0.25,3,2,34,10,12,9,23,0.273,0.205,0.523,17.543,65,python
0,25,19,1,45,0.556,26,0.578,4,0,1.0,4,2,33,12,11,11,23,0.244,0.244,0.511,17.543,66,python
0,21,19,2,42,0.5,23,0.548,3,0,1.0,1,1,27,15,13,11,18,0.31,0.262,0.429,17.55,67,python
0,21,18,4,43,0.488,25,0.581,1,2,0.333,2,2,26,17,12,16,15,0.279,0.372,0.349,17.555,68,python
0,27,15,3,45,0.6,30,0.667,7,1,0.875,4,2,26,19,13,13,19,0.289,0.289,0.422,17.553,69,python
0,24,18,5,47,0.511,29,0.617,3,2,0.6,4,1,29,18,10,16,21,0.213,0.34,0.447,17.544,70,python
0,16,24,4,44,0.364,20,0.455,2,3,0.4,1,0,32,12,11,8,25,0.25,0.182,0.568,17.531,71,python
0,18,25,3,46,0.391,21,0.457,2,1,0.667,1,4,31,15,10,15,21,0.217,0.326,0.457,17.529,72,python
0,24,20,3,47,0.511,27,0.574,3,3,0.5,1,3,29,18,12,15,20,0.255,0.319,0.426,17.534,73,python
0,17,22,5,44,0.386,22,0.5,2,3,0.4,1,1,32,12,8,16,20,0.182,0.364,0.455,17.538,74,python
0,21,20,6,47,0.447,27,0.574,1,3,0.25,4,2,24,23,14,12,21,0.298,0.255,0.447,17.543,75,python
0,20,21,4,45,0.444,24,0.533,1,3,0.25,2,2,31,14,11,15,19,0.244,0.333,0.422,17.548,76,python
0,20,23,2,45,0.444,22,0.489,3,2,0.6,1,0,30,15,9,18,18,0.2,0.4,0.4,17.541,77,python
0,19,20,6,45,0.422,25,0.556,4,3,0.571,1,0,28,17,13,11,21,0.289,0.244,0.467,17.545,78,python
0,18,28,3,49,0.367,21,0.429,3,5,0.375,4,3,31,18,10,12,27,0.204,0.245,0.551,17.539,79,python
0,14,28,3,45,0.311,17,0.378,1,1,0.5,1,3,32,13,8,14,23,0.178,0.311,0.511,17.551,80,python
0,23,19,6,48,0.479,29,0.604,3,2,0.6,3,3,29,19,15,12,21,0.312,0.25,0.438,17.546,81,python
0,19,22,3,44,0.432,22,0.5,4,3,0.571,2,1,32,12,7,17,20,0.159,0.386,0.455,17.554,82,python
0,16,25,5,46,0.348,21,0.457,1,2,0.333,3,2,31,15,10,13,23,0.217,0.283,0.5,17.55,83,python
0,19,21,5,45,0.422,24,0.533,3,3,0.5,1,2,27,18,13,12,20,0.289,0.267,0.444,17.547,84,python
0,20,20,6,46,0.435,26,0.565,1,2,0.333,5,0,28,18,10,13,23,0.217,0.283,0.5,17.537,85,python
0,22,21,3,46,0.478,25,0.543,5,0,1.0,2,1,24,22,9,14,23,0.196,0.304,0.5,17.528,86,python
0,28,14,4,46,0.609,32,0.696,4,1,0.8,5,3,24,22,10,14,22,0.217,0.304,0.478,17.522,87,python
0,25,15,5,45,0.556,30,0.667,3,2,0.6,5,1,27,18,11,14,20,0.244,0.311,0.444,17.509,88,python
0,23,18,7,48,0.479,30,0.625,4,3,0.571,2,3,29,19,12,16,20,0.25,0.333,0.417,17.513,89,python
0,14,30,5,49,0.286,19,0.388,2,3,0.4,0,4,36,13,7,18,24,0.143,0.367,0.49,17.517,90,python
0,19,23,2,44,0.432,21,0.477,1,3,0.25,2,0,24,20,13,12,19,0.295,0.273,0.432,17.514,91,python
0,19,23,3,45,0.422,22,0.489,1,1,0.5,4,0,25,20,12,17,16,0.267,0.378,0.356,17.512,92,python
0,18,22,5,45,0.4,23,0.511,6,2,0.75,0,3,29,16,11,12,22,0.244,0.267,0.489,17.51,93,python
0,21,21,1,43,0.488,22,0.512,4,2,0.667,0,2,23,20,14,14,15,0.326,0.326,0.349,17.518,94,python
0,15,27,2,44,0.341,17,0.386,2,2,0.5,0,4,31,13,7,17,20,0.159,0.386,0.455,17.529,95,python
0,20,22,5,47,0.426,25,0.532,3,0,1.0,1,4,26,21,12,16,19,0.255,0.34,0.404,17.528,96,python
0,15,26,6,47,0.319,21,0.447,1,5,0.167,1,6,29,18,10,16,21,0.213,0.34,0.447,17.481,1,python
0,24,24,0,48,0.5,24,0.5,3,1,0.75,2,4,28,20,14,12,22,0.292,0.25,0.458,17.585,2,python
0,19,16,9,44,0.432,28,0.636,5,2,0.714,1,4,27,17,14,14,16,0.318,0.318,0.364,17.848,3,python
0,22,23,1,46,0.478,23,0.5,2,4,0.333,3,1,23,23,14,16,16,0.304,0.348,0.348,17.819,4,python
0,23,19,5,47,0.489,28,0.596,1,2,0.333,6,2,27,20,9,13,25,0.191,0.277,0.532,17.82,5,python
0,20,19,6,45,0.444,26,0.578,3,3,0.5,2,1,21,24,10,15,20,0.222,0.333,0.444,17.899,6,python
0,18,24,2,44,0.409,20,0.455,4,4,0.5,2,3,24,20,13,13,18,0.295,0.295,0.409,17.881,7,python
0,18,20,5,43,0.419,23,0.535,2,1,0.667,0,1,29,14,10,12,21,0.233,0.279,0.488,17.91,8,python
0,18,20,9,47,0.383,27,0.574,0,1,0.0,3,3,34,13,8,10,29,0.17,0.213,0.617,17.868,9,python
0,21,20,6,47,0.447,27,0.574,5,2,0.714,0,3,26,21,15,14,18,0.319,0.298,0.383,17.852,10,python
0,20,21,7,48,0.417,27,0.562,4,1,0.8,2,1,27,21,10,17,21,0.208,0.354,0.438,17.904,11,python
0,15,26,4,45,0.333,19,0.422,4,1,0.8,1,1,23,22,10,16,19,0.222,0.356,0.422,17.87,12,python
0,26,17,6,49,0.531,32,0.653,5,4,0.556,2,0,29,20,14,13,22,0.286,0.265,0.449,17.875,13,python
0,27,17,3,47,0.574,30,0.638,0,2,0.0,3,1,29,18,12,15,20,0.255,0.319,0.426,17.877,14,python
0,16,24,6,46,0.348,22,0.478,3,5,0.375,2,3,25,21,9,18,19,0.196,0.391,0.413,17.864,15,python
0,25,15,4,44,0.568,29,0.659,4,0,1.0,3,2,30,14,14,9,21,0.318,0.205,0.477,17.818,16,python
0,19,22,3,44,0.432,22,0.5,2,2,0.5,2,4,29,15,12,9,23,0.273,0.205,0.523,17.818,17,python
0,19,23,2,44,0.432,21,0.477,4,1,0.8,2,3,33,11,7,15,22,0.159,0.341,0.5,17.789,18,python
0,20,22,2,44,0.455,22,0.5,3,5,0.375,4,0,28,16,8,15,21,0.182,0.341,0.477,17.813,19,python
0,18,20,8,46,0.391,26,0.565,3,2,0.6,1,2,26,20,9,15,22,0.196,0.326,0.478,17.794,20,python
0,20,20,4,44,0.455,24,0.545,2,4,0.333,4,2,28,16,10,14,20,0.227,0.318,0.455,17.792,21,python
0,21,23,3,47,0.447,24,0.511,5,1,0.833,0,2,30,17,10,14,23,0.213,0.298,0.489,17.808,22,python
0,22,17,8,47,0.468,30,0.638,2,0,1.0,3,1,35,12,5,17,25,0.106,0.362,0.532,17.803,23,python
0,22,16,7,45,0.489,29,0.644,2,3,0.4,3,1,24,21,12,16,17,0.267,0.356,0.378,17.801,24,python
0,18,21,4,43,0.419,22,0.512,4,2,0.667,1,2,27,16,13,13,17,0.302,0.302,0.395,17.774,25,python
0,23,15,5,43,0.535,28,0.651,5,5,0.5,2,0,26,17,12,12,19,0.279,0.279,0.442,17.791,26,python
0,26,18,1,45,0.578,27,0.6,3,2,0.6,2,2,29,16,17,10,18,0.378,0.222,0.4,17.78,27,python
0,21,21,5,47,0.447,26,0.553,3,3,0.5,6,3,25,22,9,17,21,0.191,0.362,0.447,17.749,28,python
0,26,16,3,45,0.578,29,0.644,3,0,1.0,4,1,27,18,15,12,18,0.333,0.267,0.4,17.756,29,python
0,21,21,5,47,0.447,26,0.553,5,0,1.0,3,3,21,26,10,14,23,0.213,0.298,0.489,17.753,30,python
0,23,20,2,45,0.511,25,0.556,5,4,0.556,5,1,26,19,8,18,19,0.178,0.4,0.422,17.756,31,python
0,25,19,2,46,0.543,27,0.587,2,2,0.5,3,2,28,18,11,12,23,0.239,0.261,0.5,17.762,32,python
0,15,28,2,45,0.333,17,0.378,2,2,0.5,1,3,32,13,8,13,24,0.178,0.289,0.533,17.773,33,python
0,25,20,5,50,0.5,30,0.6,6,3,0.667,5,4,26,24,16,13,21,0.32,0.26,0.42,17.765,34,python
0,20,25,2,47,0.426,22,0.468,4,4,0.5,2,5,33,14,13,9,25,0.277,0.191,0.532,17.76,35,python
0,19,18,6,43,0.442,25,0.581,2,3,0.4,0,1,27,16,13,16,14,0.302,0.372,0.326,17.761,36,python
0,20,21,7,48,0.417,27,0.562,3,0,1.0,0,0,26,22,10,15,23,0.208,0.312,0.479,17.745,37,python
0,19,25,1,45,0.422,20,0.444,2,3,0.4,4,1,26,19,11,13,21,0.244,0.289,0.467,17.754,38,python
0,16,24,4,44,0.364,20,0.455,2,1,0.667,2,1,28,16,8,15,21,0.182,0.341,0.477,17.762,39,python
0,17,25,4,46,0.37,21,0.457,2,1,0.667,2,0,30,16,10,13,23,0.217,0.283,0.5,17.749,40,python
0,18,26,1,45,0.4,19,0.422,2,3,0.4,1,5,27,18,9,16,20,0.2,0.356,0.444,17.748,41,python
0,22,22,3,47,0.468,25,0.532,4,4,0.5,3,1,26,21,9,13,25,0.191,0.277,0.532,17.743,42,python
0,19,23,4,46,0.413,23,0.5,4,3,0.571,0,1,26,20,10,18,18,0.217,0.391,0.391,17.746,43,python
0,24,22,2,48,0.5,26,0.542,5,2,0.714,4,4,30,18,7,17,24,0.146,0.354,0.5,17.737,44,python
0,17,21,7,45,0.378,24,0.533,3,4,0.429,1,0,25,20,10,15,20,0.222,0.333,0.444,17.742,45,python
0,23,18,5,46,0.5,28,0.609,4,2,0.667,2,1,26,20,11,15,20,0.239,0.326,0.435,17.738,46,python
0,23,20,2,45,0.511,25,0.556,4,0,1.0,3,2,27,18,11,15,19,0.244,0.333,0.422,17.742,47,python
0,14,25,6,45,0.311,20,0.444,0,5,0.0,2,1,27,18,8,17,20,0.178,0.378,0.444,17.734,48,python
0,20,19,4,43,0.465,24,0.558,5,0,1.0,1,1,21,22,12,18,13,0.279,0.419,0.302,17.743,49,python
0,23,16,6,45,0.511,29,0.644,0,0,0,6,2,31,14,8,12,25,0.178,0.267,0.556,17.715,50,python
0,20,22,2,44,0.455,22,0.5,4,3,0.571,4,2,28,16,11,14,19,0.25,0.318,0.432,17.724,51,python
0,20,22,3,45,0.444,23,0.511,5,2,0.714,1,1,30,15,10,11,24,0.222,0.244,0.533,17.71,52,python
0,20,22,4,46,0.435,24,0.522,2,3,0.4,3,3,24,22,12,14,20,0.261,0.304,0.435,17.713,53,python
0,22,24,1,47,0.468,23,0.489,0,0,0,4,5,23,24,14,14,19,0.298,0.298,0.404,17.702,54,python
0,15,28,3,46,0.326,18,0.391,0,5,0.0,3,3,31,15,6,17,23,0.13,0.37,0.5,17.693,55,python
0,14,27,6,47,0.298,20,0.426,1,4,0.2,2,5,29,18,6,17,24,0.128,0.362,0.511,17.686,56,python
0,24,15,5,44,0.545,29,0.659,4,3,0.571,2,2,28,16,12,11,21,0.273,0.25,0.477,17.676,57,python
0,15,28,4,47,0.319,19,0.404,0,7,0.0,0,5,30,17,8,13,26,0.17,0.277,0.553,17.674,58,python
0,20,22,4,46,0.435,24,0.522,2,2,0.5,2,3,23,23,13,15,18,0.283,0.326,0.391,17.681,59,python
0,22,20,2,44,0.5,24,0.545,2,3,0.4,4,1,30,14,8,13,23,0.182,0.295,0.523,17.681,60,python
0,20,24,1,45,0.444,21,0.467,3,1,0.75,2,3,35,10,11,9,25,0.244,0.2,0.556,17.68,61,python
0,18,28,1,47,0.383,19,0.404,2,3,0.4,2,4,26,21,11,15,21,0.234,0.319,0.447,17.664,62,python
0,24,18,3,45,0.533,27,0.6,2,3,0.4,2,2,22,23,8,21,16,0.178,0.467,0.356,17.67,63,python
0,20,23,5,48,0.417,25,0.521,0,2,0.0,3,1,31,17,9,15,24,0.188,0.312,0.5,17.663,64,python
0,20,23,4,47,0.426,24,0.511,4,5,0.444,1,4,24,23,13,17,17,0.277,0.362,0.362,17.668,65,python
0,16,22,6,44,0.364,22,0.5,4,1,0.8,2,2,26,18,9,17,18,0.205,0.386,0.409,17.677,66,python
0,18,25,3,46,0.391,21,0.457,2,3,0.4,3,1,27,19,9,20,17,0.196,0.435,0.37,17.674,67,python
0,25,18,3,46,0.543,28,0.609,2,1,0.667,6,1,27,19,10,12,24,0.217,0.261,0.522,17.665,68,python
0,20,26,1,47,0.426,21,0.447,3,3,0.5,2,3,24,23,14,12,21,0.298,0.255,0.447,17.668,69,python
0,19,23,5,47,0.404,24,0.511,2,4,0.333,1,2,29,18,11,18,18,0.234,0.383,0.383,17.674,70,python
0,18,23,5,46,0.391,23,0.5,2,6,0.25,1,1,27,19,16,11,19,0.348,0.239,0.413,17.667,71,python
0,21,17,7,45,0.467,28,0.622,5,0,1.0,2,1,23,22,14,10,21,0.311,0.222,0.467,17.671,72,python
0,19,24,3,46,0.413,22,0.478,1,3,0.25,2,2,31,15,7,11,28,0.152,0.239,0.609,17.667,73,python
0,23,17,6,46,0.5,29,0.63,4,2,0.667,2,1,25,21,13,14,19,0.283,0.304,0.413,17.665,74,python
0,16,25,2,43,0.372,18,0.419,1,2,0.333,1,1,28,15,11,10,22,0.256,0.233,0.512,17.653,75,python
0,22,21,1,44,0.5,23,0.523,5,2,0.714,1,1,23,21,18,13,13,0.409,0.295,0.295,17.659,76,python
0,18,23,5,46,0.391,23,0.5,3,2,0.6,4,4,27,19,8,13,25,0.174,0.283,0.543,17.668,77,python
0,26,20,2,48,0.542,28,0.583,4,3,0.571,1,2,28,20,13,23,12,0.271,0.479,0.25,17.676,78,python
0,19,20,4,43,0.442,23,0.535,6,4,0.6,1,2,23,20,13,12,18,0.302,0.279,0.419,17.681,79,python
0,18,23,4,45,0.4,22,0.489,3,3,0.5,1,3,30,15,11,15,19,0.244,0.333,0.422,17.689,80,python
0,18,21,8,47,0.383,26,0.553,0,0,0,2,2,31,16,5,21,21,0.106,0.447,0.447,17.691,81,python
0,15,24,5,44,0.341,20,0.455,4,4,0.5,2,4,28,16,10,12,22,0.227,0.273,0.5,17.699,82,python
0,18,26,7,51,0.353,25,0.49,3,5,0.375,2,2,29,22,6,20,25,0.118,0.392,0.49,17.706,83,python
0,21,21,0,42,0.5,21,0.5,2,4,0.333,1,0,19,23,12,14,16,0.286,0.333,0.381,17.695,84,python
0,15,23,5,43,0.349,20,0.465,5,2,0.714,2,5,29,14,7,14,22,0.163,0.326,0.512,17.694,85,python
0,19,22,4,45,0.422,23,0.511,4,1,0.8,1,0,33,12,11,11,23,0.244,0.244,0.511,17.694,86,python
0,21,21,4,46,0.457,25,0.543,6,2,0.75,1,3,24,22,12,15,19,0.261,0.326,0.413,17.695,87,python
0,14,23,6,43,0.326,20,0.465,4,0,1.0,0,3,29,14,11,16,16,0.256,0.372,0.372,17.688,88,python
0,22,22,6,50,0.44,28,0.56,4,2,0.667,3,3,33,17,15,13,22,0.3,0.26,0.44,17.681,89,python
0,20,26,3,49,0.408,23,0.469,4,5,0.444,2,2,28,21,7,22,20,0.143,0.449,0.408,17.681,90,python
0,17,23,7,47,0.362,24,0.511,1,1,0.5,1,2,27,20,12,13,22,0.255,0.277,0.468,17.683,91,python
0,21,21,2,44,0.477,23,0.523,3,4,0.429,2,1,29,15,11,18,15,0.25,0.409,0.341,17.686,92,python
0,19,23,3,45,0.422,22,0.489,4,3,0.571,1,2,27,18,10,15,20,0.222,0.333,0.444,17.685,93,python
0,13,31,3,47,0.277,16,0.34,2,4,0.333,1,7,33,14,5,11,31,0.106,0.234,0.66,17.689,94,python
0,18,24,3,45,0.4,21,0.467,0,2,0.0,3,0,32,13,9,13,23,0.2,0.289,0.511,17.68,95,python
0,22,22,2,46,0.478,24,0.522,4,2,0.667,1,1,24,22,14,15,17,0.304,0.326,0.37,17.683,96,python
0,17,24,7,48,0.354,24,0.5,4,2,0.667,3,2,28,20,6,19,23,0.125,0.396,0.479,18.056,1,python
0,21,19,5,45,0.467,26,0.578,1,2,0.333,3,4,25,20,12,13,20,0.267,0.289,0.444,18.078,2,python
0,17,22,5,44,0.386,22,0.5,1,0,1.0,1,1,27,17,10,17,17,0.227,0.386,0.386,17.892,3,python
0,21,19,6,46,0.457,27,0.587,5,1,0.833,2,2,25,21,12,15,19,0.261,0.326,0.413,17.792,4,python
0,18,19,7,44,0.409,25,0.568,1,2,0.333,3,1,29,15,11,15,18,0.25,0.341,0.409,17.709,5,python
0,22,23,3,48,0.458,25,0.521,3,3,0.5,4,3,29,19,10,16,22,0.208,0.333,0.458,17.62,6,python
0,23,16,5,44,0.523,28,0.636,3,1,0.75,3,1,26,18,12,12,20,0.273,0.273,0.455,17.668,7,python
0,24,17,5,46,0.522,29,0.63,6,0,1.0,1,3,30,16,17,9,20,0.37,0.196,0.435,17.716,8,python
0,21,19,7,47,0.447,28,0.596,5,1,0.833,1,3,26,21,15,10,22,0.319,0.213,0.468,17.717,9,python
0,17,23,5,45,0.378,22,0.489,0,2,0.0,1,0,27,18,8,18,19,0.178,0.4,0.422,17.752,10,python
0,25,21,4,50,0.5,29,0.58,7,4,0.636,3,2,23,27,15,19,16,0.3,0.38,0.32,17.722,11,python
0,17,27,3,47,0.362,20,0.426,4,3,0.571,0,2,29,18,11,14,22,0.234,0.298,0.468,17.744,12,python
0,25,15,3,43,0.581,28,0.651,3,0,1.0,3,1,27,16,13,12,18,0.302,0.279,0.419,17.682,13,python
0,17,22,8,47,0.362,25,0.532,3,1,0.75,0,2,25,22,12,17,18,0.255,0.362,0.383,17.715,14,python
0,19,22,4,45,0.422,23,0.511,1,1,0.5,2,0,24,21,10,19,16,0.222,0.422,0.356,17.743,15,python
0,17,27,1,45,0.378,18,0.4,3,2,0.6,2,2,28,17,10,13,22,0.222,0.289,0.489,17.722,16,python
0,20,23,2,45,0.444,22,0.489,4,3,0.571,1,0,27,18,11,12,22,0.244,0.267,0.489,17.694,17,python
0,18,17,9,44,0.409,27,0.614,4,1,0.8,1,2,30,14,11,9,24,0.25,0.205,0.545,17.684,18,python
0,17,26,1,44,0.386,18,0.409,2,1,0.667,3,1,25,19,11,17,16,0.25,0.386,0.364,17.697,19,python
0,15,26,4,45,0.333,19,0.422,3,0,1.0,3,1,31,14,7,15,23,0.156,0.333,0.511,17.711,20,python
0,9,30,6,45,0.2,15,0.333,1,5,0.167,1,6,30,15,6,17,22,0.133,0.378,0.489,17.73,21,python
0,20,20,4,44,0.455,24,0.545,1,3,0.25,0,1,23,21,12,15,17,0.273,0.341,0.386,17.766,22,python
0,25,18,5,48,0.521,30,0.625,2,3,0.4,4,0,27,21,10,21,17,0.208,0.438,0.354,17.772,23,python
0,22,22,3,47,0.468,25,0.532,3,2,0.6,5,2,27,20,10,12,25,0.213,0.255,0.532,17.757,24,python
0,14,23,9,46,0.304,23,0.5,4,1,0.8,2,0,23,23,4,21,21,0.087,0.457,0.457,17.786,25,python
0,19,21,6,46,0.413,25,0.543,3,1,0.75,3,0,23,23,13,15,18,0.283,0.326,0.391,17.79,26,python
0,15,25,4,44,0.341,19,0.432,3,2,0.6,0,0,27,17,6,19,19,0.136,0.432,0.432,17.792,27,python
0,19,27,5,51,0.373,24,0.471,1,0,1.0,4,4,28,23,15,17,19,0.294,0.333,0.373,17.773,28,python
0,19,23,5,47,0.404,24,0.511,2,1,0.667,2,1,28,19,11,12,24,0.234,0.255,0.511,17.789,29,python
0,13,34,2,49,0.265,15,0.306,0,4,0.0,1,1,28,21,6,26,17,0.122,0.531,0.347,17.801,30,python
0,25,20,2,47,0.532,27,0.574,5,1,0.833,4,7,30,17,15,9,23,0.319,0.191,0.489,17.764,31,python
0,14,25,5,44,0.318,19,0.432,3,4,0.429,1,3,26,18,10,14,20,0.227,0.318,0.455,17.802,32,python
0,20,19,5,44,0.455,25,0.568,2,3,0.4,0,2,26,18,17,10,17,0.386,0.227,0.386,17.79,33,python
0,17,22,5,44,0.386,22,0.5,2,3,0.4,4,0,30,14,7,13,24,0.159,0.295,0.545,17.778,34,python
0,21,23,3,47,0.447,24,0.511,1,3,0.25,0,2,26,21,13,17,17,0.277,0.362,0.362,17.78,35,python
0,20,20,4,44,0.455,24,0.545,3,0,1.0,2,3,24,20,13,11,20,0.295,0.25,0.455,17.771,36,python
0,22,17,6,45,0.489,28,0.622,4,0,1.0,1,0,33,12,10,12,23,0.222,0.267,0.511,17.772,37,python
0,19,22,3,44,0.432,22,0.5,2,4,0.333,2,1,26,18,13,11,20,0.295,0.25,0.455,17.777,38,python
0,18,24,2,44,0.409,20,0.455,3,4,0.429,1,4,27,17,13,15,16,0.295,0.341,0.364,17.779,39,python
0,18,25,3,46,0.391,21,0.457,5,4,0.556,3,3,34,12,10,12,24,0.217,0.261,0.522,17.784,40,python
0,14,29,4,47,0.298,18,0.383,3,0,1.0,0,5,31,16,9,11,27,0.191,0.234,0.574,17.773,41,python
0,21,20,4,45,0.467,25,0.556,6,2,0.75,4,5,30,15,8,13,24,0.178,0.289,0.533,17.773,42,python
0,19,22,3,44,0.432,22,0.5,4,2,0.667,3,1,33,11,11,9,24,0.25,0.205,0.545,17.775,43,python
0,23,18,4,45,0.511,27,0.6,2,1,0.667,1,0,30,15,13,14,18,0.289,0.311,0.4,17.776,44,python
0,20,22,4,46,0.435,24,0.522,1,1,0.5,1,2,32,14,9,14,23,0.196,0.304,0.5,17.793,45,python
0,24,17,4,45,0.533,28,0.622,3,0,1.0,0,3,26,19,12,8,25,0.267,0.178,0.556,17.802,46,python
0,22,21,3,46,0.478,25,0.543,4,1,0.8,4,0,25,21,9,14,23,0.196,0.304,0.5,17.78,47,python
0,24,20,1,45,0.533,25,0.556,2,4,0.333,5,2,27,18,11,15,19,0.244,0.333,0.422,17.766,48,python
0,17,21,6,44,0.386,23,0.523,2,3,0.4,4,4,30,14,10,11,23,0.227,0.25,0.523,17.766,49,python
0,21,18,7,46,0.457,28,0.609,3,2,0.6,4,0,23,23,9,18,19,0.196,0.391,0.413,17.759,50,python
0,20,20,5,45,0.444,25,0.556,3,2,0.6,1,2,26,19,11,17,17,0.244,0.378,0.378,17.756,51,python
0,15,23,6,44,0.341,21,0.477,3,3,0.5,0,4,33,11,9,9,26,0.205,0.205,0.591,17.756,52,python
0,18,25,4,47,0.383,22,0.468,2,2,0.5,2,2,26,21,9,15,23,0.191,0.319,0.489,17.755,53,python
0,20,22,5,47,0.426,25,0.532,3,4,0.429,1,4,30,17,7,16,24,0.149,0.34,0.511,17.761,54,python
0,22,23,3,48,0.458,25,0.521,4,4,0.5,3,2,36,12,8,21,19,0.167,0.438,0.396,17.765,55,python
0,15,27,1,43,0.349,16,0.372,2,0,1.0,0,2,29,14,11,11,21,0.256,0.256,0.488,17.76,56,python
0,24,17,4,45,0.533,28,0.622,7,2,0.778,3,3,25,20,16,9,20,0.356,0.2,0.444,17.761,57,python
0,28,16,5,49,0.571,33,0.673,6,1,0.857,0,2,30,19,16,12,21,0.327,0.245,0.429,17.763,58,python
0,12,27,5,44,0.273,17,0.386,1,3,0.25,2,4,31,13,7,16,21,0.159,0.364,0.477,17.755,59,python
0,15,25,6,46,0.326,21,0.457,2,3,0.4,2,0,31,15,11,15,20,0.239,0.326,0.435,17.76,60,python
0,21,17,7,45,0.467,28,0.622,4,2,0.667,2,1,25,20,11,18,16,0.244,0.4,0.356,17.765,61,python
0,20,21,5,46,0.435,25,0.543,4,1,0.8,3,0,28,18,9,14,23,0.196,0.304,0.5,17.764,62,python
0,23,18,4,45,0.511,27,0.6,5,2,0.714,0,1,25,20,9,17,19,0.2,0.378,0.422,17.769,63,python
0,19,23,4,46,0.413,23,0.5,3,3,0.5,2,3,27,19,10,13,23,0.217,0.283,0.5,17.774,64,python
0,19,24,3,46,0.413,22,0.478,3,3,0.5,2,3,28,18,12,14,20,0.261,0.304,0.435,17.775,65,python
0,27,16,2,45,0.6,29,0.644,2,1,0.667,3,2,34,11,9,12,24,0.2,0.267,0.533,17.76,66,python
0,24,23,1,48,0.5,25,0.521,0,2,0.0,3,1,27,21,16,12,20,0.333,0.25,0.417,17.742,67,python
0,18,21,4,43,0.419,22,0.512,2,3,0.4,3,3,29,14,9,11,23,0.209,0.256,0.535,17.739,68,python
0,27,17,2,46,0.587,29,0.63,2,5,0.286,2,3,27,19,15,12,19,0.326,0.261,0.413,17.743,69,python
0,24,22,1,47,0.511,25,0.532,5,2,0.714,2,2,26,21,14,14,19,0.298,0.298,0.404,17.738,70,python
0,20,22,3,45,0.444,23,0.511,3,1,0.75,3,4,31,14,14,11,20,0.311,0.244,0.444,17.742,71,python
0,23,17,3,43,0.535,26,0.605,3,2,0.6,2,1,21,22,17,15,11,0.395,0.349,0.256,17.742,72,python
0,25,21,0,46,0.543,25,0.543,2,1,0.667,3,2,31,15,14,9,23,0.304,0.196,0.5,17.743,73,python
0,19,22,3,44,0.432,22,0.5,5,5,0.5,2,2,25,19,14,11,19,0.318,0.25,0.432,17.734,74,python
0,18,25,6,49,0.367,24,0.49,1,0,1.0,1,4,28,21,10,21,18,0.204,0.429,0.367,17.736,75,python
0,13,25,6,44,0.295,19,0.432,1,1,0.5,0,3,30,14,8,15,21,0.182,0.341,0.477,17.736,76,python
0,22,22,0,44,0.5,22,0.5,3,1,0.75,3,4,28,16,10,12,22,0.227,0.273,0.5,17.724,77,python
0,21,20,6,47,0.447,27,0.574,2,2,0.5,4,2,29,18,8,16,23,0.17,0.34,0.489,17.724,78,python
0,20,22,3,45,0.444,23,0.511,3,2,0.6,4,1,32,13,8,12,25,0.178,0.267,0.556,17.711,79,python
0,21,20,4,45,0.467,25,0.556,4,3,0.571,1,3,22,23,10,19,16,0.222,0.422,0.356,17.717,80,python
0,23,17,5,45,0.511,28,0.622,3,0,1.0,3,1,24,21,13,15,17,0.289,0.333,0.378,17.717,81,python
0,16,31,1,48,0.333,17,0.354,3,2,0.6,1,8,25,23,9,22,17,0.188,0.458,0.354,17.713,82,python
0,23,18,4,45,0.511,27,0.6,5,2,0.714,1,3,29,16,9,13,23,0.2,0.289,0.511,17.713,83,python
0,10,33,2,45,0.222,12,0.267,1,4,0.2,1,4,25,20,6,18,21,0.133,0.4,0.467,17.717,84,python
0,21,20,3,44,0.477,24,0.545,1,3,0.25,2,1,25,19,11,13,20,0.25,0.295,0.455,17.717,85,python
0,23,17,4,44,0.523,27,0.614,3,1,0.75,0,0,21,23,17,14,13,0.386,0.318,0.295,17.718,86,python
0,27,19,4,50,0.54,31,0.62,5,0,1.0,1,2,32,18,14,17,19,0.28,0.34,0.38,17.713,87,python
0,22,17,6,45,0.489,28,0.622,3,0,1.0,3,1,29,16,12,13,20,0.267,0.289,0.444,17.705,88,python
0,17,24,1,42,0.405,18,0.429,2,4,0.333,1,1,24,18,9,15,18,0.214,0.357,0.429,17.709,89,python
0,20,20,6,46,0.435,26,0.565,2,1,0.667,2,2,25,21,12,16,18,0.261,0.348,0.391,17.703,90,python
0,23,20,2,45,0.511,25,0.556,1,0,1.0,2,2,31,14,10,15,20,0.222,0.333,0.444,17.708,91,python
0,19,22,5,46,0.413,24,0.522,3,1,0.75,2,3,26,20,12,15,19,0.261,0.326,0.413,17.705,92,python
0,20,21,3,44,0.455,23,0.523,3,2,0.6,2,3,23,21,12,14,18,0.273,0.318,0.409,17.706,93,python
0,20,20,5,45,0.444,25,0.556,3,1,0.75,2,1,28,17,7,15,23,0.156,0.333,0.511,17.703,94,python
0,17,24,4,45,0.378,21,0.467,2,2,0.5,2,3,27,18,11,14,20,0.244,0.311,0.444,17.705,95,python
0,24,18,1,43,0.558,25,0.581,4,1,0.8,1,3,28,15,13,8,22,0.302,0.186,0.512,17.7,96,python
0,16,26,3,45,0.356,19,0.422,4,2,0.667,2,3,29,16,9,16,20,0.2,0.356,0.444,17.654,1,python
0,21,23,2,46,0.457,23,0.5,4,1,0.8,2,0,29,17,14,13,19,0.304,0.283,0.413,17.704,2,python
0,19,21,4,44,0.432,23,0.523,2,3,0.4,1,3,25,19,11,13,20,0.25,0.295,0.455,17.812,3,python
0,21,22,3,46,0.457,24,0.522,3,2,0.6,3,2,24,22,11,21,14,0.239,0.457,0.304,17.982,4,python
0,22,16,4,42,0.524,26,0.619,3,0,1.0,1,0,27,15,14,13,15,0.333,0.31,0.357,18.088,5,python
0,15,26,3,44,0.341,18,0.409,1,2,0.333,2,2,29,15,8,14,22,0.182,0.318,0.5,18.157,6,python
0,21,24,4,49,0.429,25,0.51,9,2,0.818,0,1,32,17,11,13,25,0.224,0.265,0.51,18.111,7,python
0,16,24,5,45,0.356,21,0.467,1,4,0.2,2,2,30,15,6,15,24,0.133,0.333,0.533,18.145,8,python
0,22,23,0,45,0.489,22,0.489,4,3,0.571,0,2,31,14,14,10,21,0.311,0.222,0.467,18.164,9,python
0,19,26,2,47,0.404,21,0.447,4,5,0.444,2,4,26,21,9,19,19,0.191,0.404,0.404,18.093,10,python
0,21,19,5,45,0.467,26,0.578,2,0,1.0,2,2,28,17,10,15,20,0.222,0.333,0.444,17.994,11,python
0,24,19,1,44,0.545,25,0.568,4,2,0.667,1,2,21,23,12,19,13,0.273,0.432,0.295,17.957,12,python
0,19,24,4,47,0.404,23,0.489,3,5,0.375,1,0,28,19,11,13,23,0.234,0.277,0.489,17.931,13,python
0,24,21,4,49,0.49,28,0.571,2,2,0.5,2,1,15,34,14,22,13,0.286,0.449,0.265,17.896,14,python
0,17,23,5,45,0.378,22,0.489,0,1,0.0,1,3,25,20,13,14,18,0.289,0.311,0.4,17.861,15,python
0,17,24,4,45,0.378,21,0.467,4,5,0.444,1,5,27,18,9,14,22,0.2,0.311,0.489,17.82,16,python
0,21,20,5,46,0.457,26,0.565,0,0,0,2,3,35,11,10,13,23,0.217,0.283,0.5,17.84,17,python
0,20,25,2,47,0.426,22,0.468,2,1,0.667,2,1,24,23,11,9,27,0.234,0.191,0.574,17.796,18,python
0,19,24,2,45,0.422,21,0.467,4,1,0.8,4,1,31,14,7,14,24,0.156,0.311,0.533,17.774,19,python
0,19,21,4,44,0.432,23,0.523,3,1,0.75,1,0,27,17,16,12,16,0.364,0.273,0.364,17.753,20,python
0,16,25,4,45,0.356,20,0.444,3,0,1.0,1,3,27,18,7,16,22,0.156,0.356,0.489,17.737,21,python
0,18,26,1,45,0.4,19,0.422,2,2,0.5,2,4,31,14,7,13,25,0.156,0.289,0.556,17.723,22,python
0,21,19,5,45,0.467,26,0.578,3,0,1.0,2,1,27,18,13,14,18,0.289,0.311,0.4,17.717,23,python
0,21,21,2,44,0.477,23,0.523,2,0,1.0,0,2,28,16,11,12,21,0.25,0.273,0.477,17.732,24,python
0,24,16,4,44,0.545,28,0.636,3,2,0.6,2,0,26,18,14,12,18,0.318,0.273,0.409,17.711,25,python
0,26,16,4,46,0.565,30,0.652,1,1,0.5,2,4,28,18,15,10,21,0.326,0.217,0.457,17.679,26,python
0,18,26,2,46,0.391,20,0.435,0,1,0.0,1,1,28,18,7,16,23,0.152,0.348,0.5,17.696,27,python
0,20,20,3,43,0.465,23,0.535,1,0,1.0,2,2,27,16,12,13,18,0.279,0.302,0.419,17.705,28,python
0,19,20,5,44,0.432,24,0.545,5,1,0.833,1,2,31,13,13,13,18,0.295,0.295,0.409,17.732,29,python
0,16,22,7,45,0.356,23,0.511,5,1,0.833,0,3,34,11,10,14,21,0.222,0.311,0.467,17.726,30,python
0,22,18,4,44,0.5,26,0.591,5,3,0.625,3,0,23,21,11,17,16,0.25,0.386,0.364,17.717,31,python
0,15,27,3,45,0.333,18,0.4,4,3,0.571,2,2,35,10,6,14,25,0.133,0.311,0.556,17.714,32,python
0,20,21,5,46,0.435,25,0.543,2,2,0.5,4,1,27,19,11,14,21,0.239,0.304,0.457,17.664,33,python
0,19,22,4,45,0.422,23,0.511,3,5,0.375,3,2,29,16,12,13,20,0.267,0.289,0.444,17.648,34,python
0,15,27,3,45,0.333,18,0.4,3,4,0.429,1,5,30,15,7,14,24,0.156,0.311,0.533,17.637,35,python
0,17,21,6,44,0.386,23,0.523,1,0,1.0,1,1,31,13,8,12,24,0.182,0.273,0.545,17.649,36,python
0,20,22,3,45,0.444,23,0.511,2,2,0.5,0,3,25,20,12,16,17,0.267,0.356,0.378,17.641,37,python
0,19,21,3,43,0.442,22,0.512,3,3,0.5,1,1,24,19,7,17,19,0.163,0.395,0.442,17.639,38,python
0,19,22,5,46,0.413,24,0.522,2,1,0.667,2,4,29,17,9,17,20,0.196,0.37,0.435,17.633,39,python
0,13,30,3,46,0.283,16,0.348,0,1,0.0,2,3,27,19,7,12,27,0.152,0.261,0.587,17.616,40,python
0,18,23,9,50,0.36,27,0.54,2,2,0.5,0,3,28,22,12,15,23,0.24,0.3,0.46,17.612,41,python
0,20,25,2,47,0.426,22,0.468,2,2,0.5,5,0,25,22,9,18,20,0.191,0.383,0.426,17.61,42,python
0,17,21,7,45,0.378,24,0.533,0,2,0.0,2,2,31,14,9,15,21,0.2,0.333,0.467,17.609,43,python
0,24,19,2,45,0.533,26,0.578,5,3,0.625,2,3,28,17,13,10,22,0.289,0.222,0.489,17.607,44,python
0,14,27,7,48,0.292,21,0.438,1,6,0.143,1,1,28,20,6,22,20,0.125,0.458,0.417,17.619,45,python
0,21,25,2,48,0.438,23,0.479,6,3,0.667,2,2,24,24,15,14,19,0.312,0.292,0.396,17.632,46,python
0,22,25,1,48,0.458,23,0.479,6,1,0.857,2,5,33,15,13,7,28,0.271,0.146,0.583,17.621,47,python
0,16,26,2,44,0.364,18,0.409,0,2,0.0,2,1,26,18,10,14,20,0.227,0.318,0.455,17.629,48,python
0,22,21,4,47,0.468,26,0.553,4,1,0.8,3,0,27,20,13,14,20,0.277,0.298,0.426,17.62,49,python
0,16,23,4,43,0.372,20,0.465,2,0,1.0,0,1,23,20,10,16,17,0.233,0.372,0.395,17.635,50,python
0,17,23,5,45,0.378,22,0.489,3,1,0.75,2,1,25,20,10,21,14,0.222,0.467,0.311,17.637,51,python
0,22,18,5,45,0.489,27,0.6,3,1,0.75,4,1,23,22,14,10,21,0.311,0.222,0.467,17.638,52,python
0,20,22,3,45,0.444,23,0.511,3,1,0.75,2,4,31,14,12,6,27,0.267,0.133,0.6,17.623,53,python
0,22,17,4,43,0.512,26,0.605,3,3,0.5,1,2,26,17,13,15,15,0.302,0.349,0.349,17.628,54,python
0,18,22,6,46,0.391,24,0.522,2,2,0.5,3,3,28,18,13,11,22,0.283,0.239,0.478,17.631,55,python
0,14,20,9,43,0.326,23,0.535,3,2,0.6,0,1,33,10,7,9,27,0.163,0.209,0.628,17.631,56,python
0,19,24,7,50,0.38,26,0.52,1,4,0.2,2,3,31,19,11,18,21,0.22,0.36,0.42,17.634,57,python
0,20,17,8,45,0.444,28,0.622,3,2,0.6,2,1,22,23,12,16,17,0.267,0.356,0.378,17.644,58,python
0,17,23,6,46,0.37,23,0.5,2,0,1.0,1,1,28,18,12,14,20,0.261,0.304,0.435,17.65,59,python
0,24,18,4,46,0.522,28,0.609,5,2,0.714,3,2,28,18,8,14,24,0.174,0.304,0.522,17.652,60,python
0,18,20,6,44,0.409,24,0.545,5,1,0.833,0,3,21,23,10,18,16,0.227,0.409,0.364,17.661,61,python
0,19,25,2,46,0.413,21,0.457,4,3,0.571,5,2,32,14,8,11,27,0.174,0.239,0.587,17.659,62,python
0,23,21,2,46,0.5,25,0.543,5,0,1.0,1,3,23,23,15,12,19,0.326,0.261,0.413,17.668,63,python
0,26,18,4,48,0.542,30,0.625,7,0,1.0,1,4,26,22,15,11,22,0.312,0.229,0.458,17.652,64,python
0,24,20,1,45,0.533,25,0.556,3,0,1.0,1,3,25,20,15,12,18,0.333,0.267,0.4,17.648,65,python
0,19,22,4,45,0.422,23,0.511,3,3,0.5,4,0,36,9,11,11,23,0.244,0.244,0.511,17.635,66,python
0,15,21,7,43,0.349,22,0.512,1,2,0.333,2,0,27,16,8,16,19,0.186,0.372,0.442,17.638,67,python
0,15,26,5,46,0.326,20,0.435,3,2,0.6,1,2,26,20,10,15,21,0.217,0.326,0.457,17.64,68,python
0,22,20,4,46,0.478,26,0.565,4,0,1.0,1,1,27,19,13,16,17,0.283,0.348,0.37,17.643,69,python
0,23,24,0,47,0.489,23,0.489,6,2,0.75,1,0,31,16,14,12,21,0.298,0.255,0.447,17.652,70,python
0,17,23,8,48,0.354,25,0.521,3,0,1.0,1,2,35,13,11,11,26,0.229,0.229,0.542,17.656,71,python
0,23,21,4,48,0.479,27,0.562,3,1,0.75,3,2,26,22,11,16,21,0.229,0.333,0.438,17.667,72,python
0,17,25,2,44,0.386,19,0.432,5,2,0.714,2,4,27,17,6,21,17,0.136,0.477,0.386,17.672,73,python
0,12,28,4,44,0.273,16,0.364,2,3,0.4,2,2,26,18,5,19,20,0.114,0.432,0.455,17.67,74,python
0,19,26,4,49,0.388,23,0.469,3,2,0.6,1,3,35,14,12,12,25,0.245,0.245,0.51,17.665,75,python
0,22,20,3,45,0.489,25,0.556,1,1,0.5,2,2,21,24,11,13,21,0.244,0.289,0.467,17.662,76,python
0,24,17,3,44,0.545,27,0.614,3,2,0.6,1,1,25,19,14,14,16,0.318,0.318,0.364,17.669,77,python
0,20,20,4,44,0.455,24,0.545,3,2,0.6,1,4,27,17,8,18,18,0.182,0.409,0.409,17.673,78,python
0,24,16,4,44,0.545,28,0.636,7,0,1.0,3,2,26,18,16,14,14,0.364,0.318,0.318,17.679,79,python
0,20,20,5,45,0.444,25,0.556,1,2,0.333,4,2,27,18,7,15,23,0.156,0.333,0.511,17.666,80,python
0,26,15,5,46,0.565,31,0.674,2,0,1.0,2,1,30,16,18,11,17,0.391,0.239,0.37,17.653,81,python
0,23,22,1,46,0.5,24,0.522,3,2,0.6,2,0,25,21,18,9,19,0.391,0.196,0.413,17.656,82,python
0,24,16,6,46,0.522,30,0.652,4,2,0.667,3,1,26,20,13,14,19,0.283,0.304,0.413,17.651,83,python
0,19,22,3,44,0.432,22,0.5,4,2,0.667,2,2,26,18,10,17,17,0.227,0.386,0.386,17.654,84,python
0,20,19,4,43,0.465,24,0.558,2,1,0.667,1,1,25,18,14,14,15,0.326,0.326,0.349,17.661,85,python
0,18,27,4,49,0.367,22,0.449,6,2,0.75,3,1,29,20,13,15,21,0.265,0.306,0.429,17.662,86,python
0,24,20,4,48,0.5,28,0.583,7,1,0.875,2,0,27,21,11,17,20,0.229,0.354,0.417,17.653,87,python
0,23,22,2,47,0.489,25,0.532,4,1,0.8,3,5,28,19,14,11,22,0.298,0.234,0.468,17.648,88,python
0,21,21,3,45,0.467,24,0.533,4,1,0.8,3,0,29,16,8,16,21,0.178,0.356,0.467,17.641,89,python
0,19,23,2,44,0.432,21,0.477,3,0,1.0,0,3,27,17,8,17,19,0.182,0.386,0.432,17.644,90,python
0,19,24,1,44,0.432,20,0.455,2,0,1.0,4,2,25,19,11,14,19,0.25,0.318,0.432,17.636,91,python
0,19,28,0,47,0.404,19,0.404,2,2,0.5,2,1,28,19,13,13,21,0.277,0.277,0.447,17.632,92,python
0,23,18,3,44,0.523,26,0.591,4,2,0.667,2,2,28,16,11,15,18,0.25,0.341,0.409,17.638,93,python
0,22,20,2,44,0.5,24,0.545,1,4,0.2,0,2,33,11,9,14,21,0.205,0.318,0.477,17.643,94,python
0,17,24,4,45,0.378,21,0.467,1,0,1.0,3,7,28,17,11,13,21,0.244,0.289,0.467,17.64,95,python
0,15,25,4,44,0.341,19,0.432,2,1,0.667,3,0,27,17,7,11,26,0.159,0.25,0.591,17.634,96,python
0,22,20,4,46,0.478,26,0.565,3,0,1.0,3,4,28,18,13,11,22,0.283,0.239,0.478,16.667,1,python
0,20,27,1,48,0.417,21,0.438,3,4,0.429,1,4,30,18,13,15,20,0.271,0.312,0.417,17.537,2,python
0,27,15,4,46,0.587,31,0.674,6,1,0.857,3,1,25,21,13,14,19,0.283,0.304,0.413,17.576,3,python
0,20,24,6,50,0.4,26,0.52,3,3,0.5,1,3,35,15,10,15,25,0.2,0.3,0.5,17.776,4,python
0,19,21,5,45,0.422,24,0.533,1,3,0.25,1,0,28,17,9,15,21,0.2,0.333,0.467,17.899,5,python
0,21,21,4,46,0.457,25,0.543,3,1,0.75,2,4,26,20,13,15,18,0.283,0.326,0.391,17.943,6,python
0,19,21,5,45,0.422,24,0.533,3,3,0.5,1,1,32,13,9,9,27,0.2,0.2,0.6,17.967,7,python
0,21,22,4,47,0.447,25,0.532,5,2,0.714,2,1,25,22,9,16,22,0.191,0.34,0.468,17.979,8,python
0,23,21,3,47,0.489,26,0.553,4,3,0.571,5,3,27,20,12,14,21,0.255,0.298,0.447,17.891,9,python
0,19,19,6,44,0.432,25,0.568,1,1,0.5,1,3,29,15,14,9,21,0.318,0.205,0.477,17.87,10,python
0,21,21,4,46,0.457,25,0.543,2,2,0.5,0,5,29,17,10,17,19,0.217,0.37,0.413,17.901,11,python
0,20,19,7,46,0.435,27,0.587,5,0,1.0,1,1,29,17,8,16,22,0.174,0.348,0.478,17.891,12,python
0,24,20,0,44,0.545,24,0.545,3,3,0.5,1,2,28,16,10,15,19,0.227,0.341,0.432,17.882,13,python
0,18,23,3,44,0.409,21,0.477,2,4,0.333,1,2,27,17,9,14,21,0.205,0.318,0.477,17.865,14,python
0,17,23,3,43,0.395,20,0.465,5,1,0.833,1,5,32,11,9,12,22,0.209,0.279,0.512,17.865,15,python
0,25,22,0,47,0.532,25,0.532,2,0,1.0,2,2,30,17,12,17,18,0.255,0.362,0.383,17.881,16,python
0,20,24,3,47,0.426,23,0.489,2,3,0.4,4,4,34,13,10,16,21,0.213,0.34,0.447,17.82,17,python
0,20,20,5,45,0.444,25,0.556,3,0,1.0,2,3,29,16,13,14,18,0.289,0.311,0.4,17.823,18,python
0,17,25,3,45,0.378,20,0.444,4,0,1.0,0,4,33,12,14,10,21,0.311,0.222,0.467,17.802,19,python
0,20,21,5,46,0.435,25,0.543,2,3,0.4,4,4,34,12,11,7,28,0.239,0.152,0.609,17.756,20,python
0,20,20,4,44,0.455,24,0.545,2,0,1.0,1,3,28,16,9,15,20,0.205,0.341,0.455,17.779,21,python
0,21,21,2,44,0.477,23,0.523,5,0,1.0,3,4,30,14,9,8,27,0.205,0.182,0.614,17.753,22,python
0,29,16,3,48,0.604,32,0.667,3,0,1.0,1,4,30,18,19,12,17,0.396,0.25,0.354,17.76,23,python
0,13,28,4,45,0.289,17,0.378,1,2,0.333,1,5,28,17,9,13,23,0.2,0.289,0.511,17.745,24,python
0,23,17,4,44,0.523,27,0.614,2,3,0.4,2,2,31,13,13,11,20,0.295,0.25,0.455,17.718,25,python
0,18,24,5,47,0.383,23,0.489,3,2,0.6,5,3,28,19,9,20,18,0.191,0.426,0.383,17.689,26,python
0,21,24,2,47,0.447,23,0.489,1,3,0.25,4,0,27,20,11,14,22,0.234,0.298,0.468,17.678,27,python
0,22,14,8,44,0.5,30,0.682,2,0,1.0,1,2,27,17,12,13,19,0.273,0.295,0.432,17.692,28,python
0,22,22,3,47,0.468,25,0.532,0,5,0.0,0,0,32,15,11,15,21,0.234,0.319,0.447,17.712,29,python
0,16,23,5,44,0.364,21,0.477,5,4,0.556,2,3,30,14,8,15,21,0.182,0.341,0.477,17.728,30,python
0,15,27,3,45,0.333,18,0.4,3,0,1.0,0,5,34,11,9,8,28,0.2,0.178,0.622,17.73,31,python
0,25,17,3,45,0.556,28,0.622,4,3,0.571,4,0,31,14,10,12,23,0.222,0.267,0.511,17.725,32,python
0,16,24,6,46,0.348,22,0.478,1,1,0.5,0,4,31,15,10,13,23,0.217,0.283,0.5,17.737,33,python
0,18,27,5,50,0.36,23,0.46,3,1,0.75,2,3,29,21,12,18,20,0.24,0.36,0.4,17.742,34,python
0,21,20,2,43,0.488,23,0.535,7,0,1.0,1,2,25,18,15,12,16,0.349,0.279,0.372,17.738,35,python
0,20,23,4,47,0.426,24,0.511,2,2,0.5,1,2,24,23,13,16,18,0.277,0.34,0.383,17.743,36,python
0,24,19,4,47,0.511,28,0.596,6,3,0.667,3,1,26,21,12,14,21,0.255,0.298,0.447,17.733,37,python
0,20,22,4,46,0.435,24,0.522,3,2,0.6,1,1,26,20,9,17,20,0.196,0.37,0.435,17.736,38,python
0,20,23,4,47,0.426,24,0.511,2,3,0.4,4,5,30,17,10,13,24,0.213,0.277,0.511,17.734,39,python
0,19,23,4,46,0.413,23,0.5,1,1,0.5,7,1,30,16,7,16,23,0.152,0.348,0.5,17.721,40,python
0,16,25,2,43,0.372,18,0.419,4,0,1.0,1,2,23,20,7,17,19,0.163,0.395,0.442,17.711,41,python
0,26,18,2,46,0.565,28,0.609,3,4,0.429,2,2,28,18,7,18,21,0.152,0.391,0.457,17.717,42,python
0,22,18,4,44,0.5,26,0.591,8,4,0.667,3,1,25,19,13,12,19,0.295,0.273,0.432,17.72,43,python
0,21,18,5,44,0.477,26,0.591,3,4,0.429,3,1,26,18,10,12,22,0.227,0.273,0.5,17.729,44,python
0,19,23,3,45,0.422,22,0.489,2,1,0.667,1,4,28,17,11,10,24,0.244,0.222,0.533,17.724,45,python
0,20,20,4,44,0.455,24,0.545,1,1,0.5,1,2,31,13,11,14,19,0.25,0.318,0.432,17.709,46,python
0,20,24,1,45,0.444,21,0.467,4,2,0.667,3,3,26,19,10,14,21,0.222,0.311,0.467,17.692,47,python
0,16,26,3,45,0.356,19,0.422,1,2,0.333,1,5,30,15,9,13,23,0.2,0.289,0.511,17.693,48,python
0,20,23,2,45,0.444,22,0.489,1,0,1.0,1,2,30,15,12,10,23,0.267,0.222,0.511,17.7,49,python
0,19,23,2,44,0.432,21,0.477,4,2,0.667,3,2,25,19,9,13,22,0.205,0.295,0.5,17.69,50,python
0,20,27,0,47,0.426,20,0.426,1,4,0.2,1,2,25,22,15,13,19,0.319,0.277,0.404,17.686,51,python
0,18,23,4,45,0.4,22,0.489,1,4,0.2,2,2,30,15,7,16,22,0.156,0.356,0.489,17.696,52,python
0,22,20,4,46,0.478,26,0.565,4,2,0.667,2,4,27,19,7,12,27,0.152,0.261,0.587,17.686,53,python
0,20,24,2,46,0.435,22,0.478,1,7,0.125,1,4,18,28,13,17,16,0.283,0.37,0.348,17.694,54,python
0,19,22,4,45,0.422,23,0.511,2,3,0.4,3,1,29,16,13,16,16,0.289,0.356,0.356,17.699,55,python
0,13,28,4,45,0.289,17,0.378,2,2,0.5,0,2,27,18,7,17,21,0.156,0.378,0.467,17.702,56,python
0,18,20,5,43,0.419,23,0.535,1,3,0.25,1,1,27,16,11,15,17,0.256,0.349,0.395,17.712,57,python
0,18,25,2,45,0.4,20,0.444,4,3,0.571,4,4,31,14,8,14,23,0.178,0.311,0.511,17.721,58,python
0,22,19,4,45,0.489,26,0.578,3,2,0.6,3,2,29,16,10,15,20,0.222,0.333,0.444,17.707,59,python
0,17,26,4,47,0.362,21,0.447,4,2,0.667,2,3,27,20,10,19,18,0.213,0.404,0.383,17.708,60,python
0,19,25,6,50,0.38,25,0.5,4,3,0.571,5,2,31,19,7,18,25,0.14,0.36,0.5,17.693,61,python
0,20,15,10,45,0.444,30,0.667,3,2,0.6,2,0,24,21,14,14,17,0.311,0.311,0.378,17.701,62,python
0,15,30,2,47,0.319,17,0.362,3,0,1.0,2,4,31,16,8,19,20,0.17,0.404,0.426,17.69,63,python
0,16,27,4,47,0.34,20,0.426,3,3,0.5,1,1,30,17,7,15,25,0.149,0.319,0.532,17.689,64,python
0,15,28,3,46,0.326,18,0.391,2,2,0.5,0,3,28,18,8,14,24,0.174,0.304,0.522,17.696,65,python
0,20,17,9,46,0.435,29,0.63,0,6,0.0,5,2,23,23,9,14,23,0.196,0.304,0.5,17.686,66,python
0,20,18,7,45,0.444,27,0.6,3,3,0.5,5,0,26,19,9,20,16,0.2,0.444,0.356,17.68,67,python
0,18,25,3,46,0.391,21,0.457,4,4,0.5,1,4,30,16,9,14,23,0.196,0.304,0.5,17.68,68,python
0,12,31,4,47,0.255,16,0.34,0,1,0.0,2,3,31,16,3,16,28,0.064,0.34,0.596,17.673,69,python
0,17,22,4,43,0.395,21,0.488,4,3,0.571,3,2,25,18,10,13,20,0.233,0.302,0.465,17.677,70,python
0,20,22,3,45,0.444,23,0.511,1,1,0.5,4,3,20,25,14,15,16,0.311,0.333,0.356,17.671,71,python
0,12,29,4,45,0.267,16,0.356,1,4,0.2,2,2,31,14,5,16,24,0.111,0.356,0.533,17.664,72,python
0,16,23,6,45,0.356,22,0.489,3,2,0.6,1,2,30,15,10,11,24,0.222,0.244,0.533,17.657,73,python
0,13,25,6,44,0.295,19,0.432,3,2,0.6,0,3,29,15,10,13,21,0.227,0.295,0.477,17.667,74,python
0,22,19,2,43,0.512,24,0.558,3,2,0.6,2,1,23,20,14,13,16,0.326,0.302,0.372,17.67,75,python
0,18,20,6,44,0.409,24,0.545,2,2,0.5,0,1,29,15,14,11,19,0.318,0.25,0.432,17.671,76,python
0,20,18,8,46,0.435,28,0.609,3,1,0.75,2,2,25,21,10,16,20,0.217,0.348,0.435,17.672,77,python
0,15,28,6,49,0.306,21,0.429,1,5,0.167,4,1,27,22,4,22,23,0.082,0.449,0.469,17.661,78,python
0,16,23,6,45,0.356,22,0.489,3,4,0.429,2,3,28,17,10,13,22,0.222,0.289,0.489,17.668,79,python
0,17,25,4,46,0.37,21,0.457,3,4,0.429,5,3,24,22,7,15,24,0.152,0.326,0.522,17.659,80,python
0,28,15,3,46,0.609,31,0.674,2,1,0.667,2,2,25,21,18,10,18,0.391,0.217,0.391,17.657,81,python
0,19,20,6,45,0.422,25,0.556,4,1,0.8,1,1,28,17,11,15,19,0.244,0.333,0.422,17.668,82,python
0,24,20,2,46,0.522,26,0.565,2,1,0.667,5,1,29,17,13,12,21,0.283,0.261,0.457,17.66,83,python
0,21,21,2,44,0.477,23,0.523,3,0,1.0,2,1,25,19,11,11,22,0.25,0.25,0.5,17.656,84,python
0,21,18,6,45,0.467,27,0.6,4,3,0.571,3,2,24,21,14,11,20,0.311,0.244,0.444,17.654,85,python
0,22,16,6,44,0.5,28,0.636,3,3,0.5,1,1,26,18,13,13,18,0.295,0.295,0.409,17.656,86,python
0,21,24,2,47,0.447,23,0.489,6,3,0.667,5,1,26,21,9,15,23,0.191,0.319,0.489,17.658,87,python
0,20,24,3,47,0.426,23,0.489,5,1,0.833,0,1,29,18,14,11,22,0.298,0.234,0.468,17.663,88,python
0,16,25,6,47,0.34,22,0.468,3,1,0.75,2,2,25,22,10,21,16,0.213,0.447,0.34,17.674,89,python
0,23,18,3,44,0.523,26,0.591,6,2,0.75,2,3,28,16,12,10,22,0.273,0.227,0.5,17.675,90,python
0,18,26,3,47,0.383,21,0.447,0,3,0.0,2,1,23,24,10,17,20,0.213,0.362,0.426,17.666,91,python
0,19,23,5,47,0.404,24,0.511,1,2,0.333,2,3,30,17,11,8,28,0.234,0.17,0.596,17.662,92,python
0,16,25,6,47,0.34,22,0.468,3,2,0.6,1,2,31,16,6,16,25,0.128,0.34,0.532,17.665,93,python
0,24,24,1,49,0.49,25,0.51,2,2,0.5,3,1,34,15,14,11,24,0.286,0.224,0.49,17.661,94,python
0,19,23,4,46,0.413,23,0.5,4,0,1.0,1,2,33,13,8,13,25,0.174,0.283,0.543,17.66,95,python
0,18,22,4,44,0.409,22,0.5,3,2,0.6,2,0,25,19,10,17,17,0.227,0.386,0.386,17.661,96,python
0,20,21,4,45,0.444,24,0.533,3,3,0.5,3,1,28,17,11,12,22,0.244,0.267,0.489,17.387,1,python
0,19,23,5,47,0.404,24,0.511,5,1,0.833,5,1,22,25,11,15,21,0.234,0.319,0.447,17.274,2,python
0,16,27,4,47,0.34,20,0.426,5,5,0.5,3,1,31,16,6,20,21,0.128,0.426,0.447,17.433,3,python
0,18,23,4,45,0.4,22,0.489,0,2,0.0,0,1,25,20,11,15,19,0.244,0.333,0.422,17.5,4,python
0,25,17,3,45,0.556,28,0.622,4,2,0.667,2,1,22,23,14,12,19,0.311,0.267,0.422,17.312,5,python
0,16,25,4,45,0.356,20,0.444,3,5,0.375,1,1,26,19,11,15,19,0.244,0.333,0.422,17.462,6,python
0,17,22,4,43,0.395,21,0.488,3,2,0.6,1,1,25,18,11,14,18,0.256,0.326,0.419,17.586,7,python
0,19,20,4,43,0.442,23,0.535,2,4,0.333,1,1,20,23,11,15,17,0.256,0.349,0.395,17.57,8,python
0,23,16,4,43,0.535,27,0.628,4,2,0.667,2,1,26,17,14,10,19,0.326,0.233,0.442,17.607,9,python
0,21,20,4,45,0.467,25,0.556,1,3,0.25,1,1,25,20,11,22,12,0.244,0.489,0.267,17.667,10,python
0,26,14,3,43,0.605,29,0.674,1,3,0.25,2,1,25,18,14,14,15,0.326,0.326,0.349,17.666,11,python
0,21,18,5,44,0.477,26,0.591,3,2,0.6,0,4,31,13,10,15,19,0.227,0.341,0.432,17.693,12,python
0,20,21,2,43,0.465,22,0.512,6,2,0.75,0,2,23,20,13,14,16,0.302,0.326,0.372,17.744,13,python
0,17,25,3,45,0.378,20,0.444,3,3,0.5,0,1,27,18,8,16,21,0.178,0.356,0.467,17.812,14,python
0,23,24,1,48,0.479,24,0.5,3,2,0.6,5,4,33,15,13,13,22,0.271,0.271,0.458,17.766,15,python
0,17,24,5,46,0.37,22,0.478,3,2,0.6,4,2,32,14,9,12,25,0.196,0.261,0.543,17.709,16,python
0,21,27,2,50,0.42,23,0.46,3,1,0.75,3,1,20,30,13,23,14,0.26,0.46,0.28,17.756,17,python
0,16,26,5,47,0.34,21,0.447,2,1,0.667,3,2,29,18,8,16,23,0.17,0.34,0.489,17.756,18,python
0,23,20,2,45,0.511,25,0.556,5,3,0.625,1,0,23,22,12,17,16,0.267,0.378,0.356,17.782,19,python
0,19,20,3,42,0.452,22,0.524,1,1,0.5,1,0,27,15,10,16,16,0.238,0.381,0.381,17.76,20,python
0,19,23,3,45,0.422,22,0.489,4,2,0.667,2,0,30,15,10,11,24,0.222,0.244,0.533,17.717,21,python
0,18,24,4,46,0.391,22,0.478,1,0,1.0,5,1,28,18,5,17,24,0.109,0.37,0.522,17.688,22,python
0,20,21,4,45,0.444,24,0.533,2,2,0.5,0,3,22,23,11,21,13,0.244,0.467,0.289,17.716,23,python
0,14,30,2,46,0.304,16,0.348,3,3,0.5,2,4,31,15,6,19,21,0.13,0.413,0.457,17.729,24,python
0,20,24,6,50,0.4,26,0.52,2,3,0.4,4,2,34,16,13,12,25,0.26,0.24,0.5,17.717,25,python
0,18,26,5,49,0.367,23,0.469,4,7,0.364,4,1,32,17,7,13,29,0.143,0.265,0.592,17.713,26,python
0,17,25,2,44,0.386,19,0.432,2,1,0.667,1,2,27,17,12,13,19,0.273,0.295,0.432,17.72,27,python
0,21,20,2,43,0.488,23,0.535,4,2,0.667,1,1,27,16,11,17,15,0.256,0.395,0.349,17.724,28,python
0,23,23,0,46,0.5,23,0.5,0,1,0.0,2,5,30,16,16,14,16,0.348,0.304,0.348,17.729,29,python
0,20,21,3,44,0.455,23,0.523,7,1,0.875,2,3,26,18,10,14,20,0.227,0.318,0.455,17.713,30,python
0,22,20,4,46,0.478,26,0.565,2,0,1.0,3,0,28,18,13,16,17,0.283,0.348,0.37,17.694,31,python
0,20,18,5,43,0.465,25,0.581,2,2,0.5,1,0,24,19,12,14,17,0.279,0.326,0.395,17.694,32,python
0,17,27,1,45,0.378,18,0.4,3,3,0.5,1,3,27,18,7,15,23,0.156,0.333,0.511,17.699,33,python
0,20,21,7,48,0.417,27,0.562,5,2,0.714,3,1,30,18,8,20,20,0.167,0.417,0.417,17.714,34,python
0,19,23,2,44,0.432,21,0.477,4,0,1.0,2,2,24,20,12,12,20,0.273,0.273,0.455,17.713,35,python
0,16,25,5,46,0.348,21,0.457,0,1,0.0,1,6,25,21,9,14,23,0.196,0.304,0.5,17.714,36,python
0,16,27,2,45,0.356,18,0.4,2,4,0.333,0,1,32,13,11,11,23,0.244,0.244,0.511,17.709,37,python
0,24,18,3,45,0.533,27,0.6,2,3,0.4,1,2,30,15,14,7,24,0.311,0.156,0.533,17.703,38,python
0,22,19,4,45,0.489,26,0.578,4,2,0.667,2,1,29,16,14,8,23,0.311,0.178,0.511,17.699,39,python
0,18,22,4,44,0.409,22,0.5,0,0,0,1,1,30,14,11,15,18,0.25,0.341,0.409,17.707,40,python
0,19,21,5,45,0.422,24,0.533,1,2,0.333,2,0,32,13,10,16,19,0.222,0.356,0.422,17.69,41,python
0,17,26,4,47,0.362,21,0.447,2,4,0.333,2,5,31,16,8,16,23,0.17,0.34,0.489,17.694,42,python
0,19,24,3,46,0.413,22,0.478,1,0,1.0,1,2,27,19,8,14,24,0.174,0.304,0.522,17.701,43,python
0,23,16,7,46,0.5,30,0.652,5,4,0.556,2,5,26,20,13,14,19,0.283,0.304,0.413,17.699,44,python
0,21,19,4,44,0.477,25,0.568,2,3,0.4,3,0,27,17,9,17,18,0.205,0.386,0.409,17.708,45,python
0,21,15,8,44,0.477,29,0.659,3,2,0.6,3,0,26,18,10,16,18,0.227,0.364,0.409,17.709,46,python
0,29,16,3,48,0.604,32,0.667,2,1,0.667,5,2,29,19,15,8,25,0.312,0.167,0.521,17.672,47,python
0,23,14,8,45,0.511,31,0.689,3,2,0.6,1,2,28,17,14,16,15,0.311,0.356,0.333,17.684,48,python
0,23,16,5,44,0.523,28,0.636,6,2,0.75,5,4,31,13,11,13,20,0.25,0.295,0.455,17.677,49,python
0,17,20,6,43,0.395,23,0.535,3,1,0.75,1,0,24,19,10,18,15,0.233,0.419,0.349,17.682,50,python
0,17,21,6,44,0.386,23,0.523,1,1,0.5,1,1,29,15,10,10,24,0.227,0.227,0.545,17.679,51,python
0,18,18,7,43,0.419,25,0.581,4,3,0.571,1,4,27,16,10,15,18,0.233,0.349,0.419,17.675,52,python
0,16,27,1,44,0.364,17,0.386,2,4,0.333,2,1,26,18,11,10,23,0.25,0.227,0.523,17.686,53,python
0,15,25,5,45,0.333,20,0.444,2,2,0.5,2,5,29,16,8,13,24,0.178,0.289,0.533,17.685,54,python
0,24,21,2,47,0.511,26,0.553,2,3,0.4,3,2,23,24,11,15,21,0.234,0.319,0.447,17.68,55,python
0,21,22,5,48,0.438,26,0.542,4,3,0.571,3,4,32,16,9,17,22,0.188,0.354,0.458,17.675,56,python
0,15,23,6,44,0.341,21,0.477,0,0,0,1,4,31,13,7,14,23,0.159,0.318,0.523,17.682,57,python
0,21,26,2,49,0.429,23,0.469,3,5,0.375,3,4,29,20,10,17,22,0.204,0.347,0.449,17.681,58,python
0,21,18,4,43,0.488,25,0.581,3,1,0.75,2,3,20,23,15,12,16,0.349,0.279,0.372,17.682,59,python
0,13,27,6,46,0.283,19,0.413,2,1,0.667,3,3,30,16,6,13,27,0.13,0.283,0.587,17.681,60,python
0,20,19,6,45,0.444,26,0.578,4,3,0.571,2,2,28,17,11,15,19,0.244,0.333,0.422,17.686,61,python
0,25,18,4,47,0.532,29,0.617,4,0,1.0,3,2,25,22,14,12,21,0.298,0.255,0.447,17.679,62,python
0,20,20,5,45,0.444,25,0.556,4,1,0.8,2,5,30,15,7,15,23,0.156,0.333,0.511,17.681,63,python
0,24,17,4,45,0.533,28,0.622,3,3,0.5,2,0,26,19,10,17,18,0.222,0.378,0.4,17.688,64,python
0,21,20,2,43,0.488,23,0.535,1,2,0.333,0,2,29,14,11,16,16,0.256,0.372,0.372,17.693,65,python
0,18,19,6,43,0.419,24,0.558,4,2,0.667,1,1,27,16,11,13,19,0.256,0.302,0.442,17.692,66,python
0,21,24,0,45,0.467,21,0.467,0,2,0.0,2,2,25,20,12,13,20,0.267,0.289,0.444,17.688,67,python
0,15,24,5,44,0.341,20,0.455,1,1,0.5,0,3,30,14,7,16,21,0.159,0.364,0.477,17.696,68,python
0,22,20,6,48,0.458,28,0.583,3,1,0.75,4,1,31,17,10,12,26,0.208,0.25,0.542,17.7,69,python
0,22,18,1,41,0.537,23,0.561,4,3,0.571,1,0,31,10,17,9,15,0.415,0.22,0.366,17.698,70,python
0,25,20,1,46,0.543,26,0.565,2,2,0.5,4,0,28,18,12,16,18,0.261,0.348,0.391,17.699,71,python
0,16,24,4,44,0.364,20,0.455,1,4,0.2,1,0,27,17,6,16,22,0.136,0.364,0.5,17.705,72,python
0,23,22,5,50,0.46,28,0.56,2,1,0.667,2,0,27,23,7,18,25,0.14,0.36,0.5,17.702,73,python
0,19,22,4,45,0.422,23,0.511,6,2,0.75,1,1,31,14,9,15,21,0.2,0.333,0.467,17.701,74,python
0,22,23,4,49,0.449,26,0.531,3,1,0.75,1,3,30,19,11,16,22,0.224,0.327,0.449,17.702,75,python
0,22,22,2,46,0.478,24,0.522,1,3,0.25,2,2,25,21,13,15,18,0.283,0.326,0.391,17.696,76,python
0,18,22,6,46,0.391,24,0.522,4,5,0.444,5,1,34,12,5,13,28,0.109,0.283,0.609,17.691,77,python
0,19,20,4,43,0.442,23,0.535,1,2,0.333,2,2,27,16,13,12,18,0.302,0.279,0.419,17.694,78,python
0,14,27,4,45,0.311,18,0.4,4,5,0.444,0,1,24,21,12,17,16,0.267,0.378,0.356,17.695,79,python
0,21,23,5,49,0.429,26,0.531,5,4,0.556,3,0,27,22,14,14,21,0.286,0.286,0.429,17.694,80,python
0,19,22,7,48,0.396,26,0.542,2,2,0.5,2,1,27,21,6,23,19,0.125,0.479,0.396,17.692,81,python
0,19,25,4,48,0.396,23,0.479,4,2,0.667,0,6,31,17,11,14,23,0.229,0.292,0.479,17.701,82,python
0,22,18,6,46,0.478,28,0.609,3,2,0.6,2,1,28,18,11,16,19,0.239,0.348,0.413,17.704,83,python
0,25,15,4,44,0.568,29,0.659,4,0,1.0,1,1,28,16,13,11,20,0.295,0.25,0.455,17.707,84,python
0,16,26,4,46,0.348,20,0.435,1,2,0.333,1,5,29,17,12,13,21,0.261,0.283,0.457,17.704,85,python
0,25,16,5,46,0.543,30,0.652,2,0,1.0,4,2,30,16,13,14,19,0.283,0.304,0.413,17.701,86,python
0,20,18,6,44,0.455,26,0.591,3,1,0.75,0,3,27,17,12,16,16,0.273,0.364,0.364,17.705,87,python
0,14,31,1,46,0.304,15,0.326,3,5,0.375,3,3,27,19,6,17,23,0.13,0.37,0.5,17.704,88,python
0,20,21,5,46,0.435,25,0.543,2,4,0.333,1,2,23,23,11,19,16,0.239,0.413,0.348,17.707,89,python
0,17,25,4,46,0.37,21,0.457,1,1,0.5,2,4,31,15,10,16,20,0.217,0.348,0.435,17.711,90,python
0,19,23,4,46,0.413,23,0.5,3,3,0.5,2,2,23,23,13,16,17,0.283,0.348,0.37,17.711,91,python
0,20,21,7,48,0.417,27,0.562,2,4,0.333,2,2,33,15,9,18,21,0.188,0.375,0.438,17.711,92,python
0,19,25,3,47,0.404,22,0.468,5,5,0.5,2,3,27,20,12,16,19,0.255,0.34,0.404,17.71,93,python
0,19,22,4,45,0.422,23,0.511,2,2,0.5,2,1,26,19,12,15,18,0.267,0.333,0.4,17.71,94,python
0,26,16,4,46,0.565,30,0.652,3,0,1.0,1,3,30,16,12,13,21,0.261,0.283,0.457,17.702,95,python
0,21,20,4,45,0.467,25,0.556,3,2,0.6,3,1,28,17,9,13,23,0.2,0.289,0.511,17.702,96,python
0,15,22,8,45,0.333,23,0.511,3,1,0.75,2,2,35,10,6,13,26,0.133,0.289,0.578,17.686,1,riffle_perfect
0,17,21,5,43,0.395,22,0.512,3,0,1.0,2,2,22,21,12,12,19,0.279,0.279,0.442,17.516,2,riffle_perfect
0,21,23,3,47,0.447,24,0.511,3,1,0.75,2,3,28,19,11,13,23,0.234,0.277,0.489,17.409,3,riffle_perfect
0,21,22,4,47,0.447,25,0.532,4,1,0.8,4,3,29,18,13,12,22,0.277,0.255,0.468,17.31,4,riffle_perfect
0,14,27,4,45,0.311,18,0.4,3,1,0.75,0,5,27,18,8,18,19,0.178,0.4,0.422,17.521,5,riffle_perfect
0,15,28,1,44,0.341,16,0.364,2,1,0.667,1,2,27,17,9,13,22,0.205,0.295,0.5,17.649,6,riffle_perfect
0,15,27,2,44,0.341,17,0.386,2,2,0.5,1,1,24,20,7,15,22,0.159,0.341,0.5,17.618,7,riffle_perfect
0,21,19,3,43,0.488,24,0.558,2,2,0.5,3,0,30,13,11,13,19,0.256,0.302,0.442,17.658,8,riffle_perfect
0,24,22,1,47,0.511,25,0.532,2,2,0.5,1,5,32,15,17,9,21,0.362,0.191,0.447,17.731,9,riffle_perfect
0,24,17,5,46,0.522,29,0.63,2,2,0.5,5,2,29,17,12,9,25,0.261,0.196,0.543,17.545,10,riffle_perfect
0,22,19,5,46,0.478,27,0.587,6,1,0.857,0,1,28,18,9,17,20,0.196,0.37,0.435,17.543,11,riffle_perfect
0,24,13,7,44,0.545,31,0.705,5,0,1.0,1,1,32,12,14,11,19,0.318,0.25,0.432,17.559,12,riffle_perfect
0,27,13,6,46,0.587,33,0.717,4,3,0.571,6,1,24,22,11,16,19,0.239,0.348,0.413,17.456,13,riffle_perfect
0,20,20,6,46,0.435,26,0.565,3,0,1.0,4,3,26,20,9,15,22,0.196,0.326,0.478,17.465,14,riffle_perfect
0,19,24,3,46,0.413,22,0.478,4,2,0.667,1,1,26,20,14,13,19,0.304,0.283,0.413,17.462,15,riffle_perfect
0,20,21,2,43,0.465,22,0.512,1,1,0.5,3,3,27,16,8,15,20,0.186,0.349,0.465,17.507,16,riffle_perfect
0,20,20,5,45,0.444,25,0.556,2,1,0.667,0,1,34,11,10,9,26,0.222,0.2,0.578,17.525,17,riffle_perfect
0,21,20,5,46,0.457,26,0.565,6,3,0.667,3,4,31,15,9,14,23,0.196,0.304,0.5,17.526,18,riffle_perfect
0,22,20,2,44,0.5,24,0.545,4,2,0.667,3,1,30,14,11,8,25,0.25,0.182,0.568,17.535,19,riffle_perfect
0,16,27,2,45,0.356,18,0.4,1,3,0.25,1,2,28,17,8,15,22,0.178,0.333,0.489,17.548,20,riffle_perfect
0,15,22,6,43,0.349,21,0.488,4,4,0.5,2,2,30,13,10,14,19,0.233,0.326,0.442,17.562,21,riffle_perfect
0,18,24,3,45,0.4,21,0.467,5,1,0.833,2,0,23,22,7,18,20,0.156,0.4,0.444,17.58,22,riffle_perfect
0,22,23,2,47,0.468,24,0.511,1,1,0.5,5,2,28,19,11,14,22,0.234,0.298,0.468,17.551,23,riffle_perfect
0,20,23,6,49,0.408,26,0.531,5,4,0.556,4,0,29,20,10,20,19,0.204,0.408,0.388,17.581,24,riffle_perfect
0,20,22,3,45,0.444,23,0.511,2,2,0.5,1,2,29,16,10,9,26,0.222,0.2,0.578,17.619,25,riffle_perfect
0,20,16,9,45,0.444,29,0.644,1,1,0.5,5,2,23,22,12,16,17,0.267,0.356,0.378,17.591,26,riffle_perfect
0,17,25,2,44,0.386,19,0.432,1,1,0.5,2,3,30,14,8,14,22,0.182,0.318,0.5,17.598,27,riffle_perfect
0,25,17,3,45,0.556,28,0.622,4,0,1.0,2,2,23,22,17,12,16,0.378,0.267,0.356,17.589,28,riffle_perfect
0,19,24,3,46,0.413,22,0.478,2,3,0.4,0,2,28,18,11,15,20,0.239,0.326,0.435,17.598,29,riffle_perfect
0,19,26,1,46,0.413,20,0.435,4,2,0.667,3,2,28,18,11,14,21,0.239,0.304,0.457,17.608,30,riffle_perfect
0,21,21,3,45,0.467,24,0.533,1,1,0.5,1,4,27,18,10,14,21,0.222,0.311,0.467,17.585,31,riffle_perfect
0,16,23,6,45,0.356,22,0.489,5,2,0.714,1,2,23,22,11,17,17,0.244,0.378,0.378,17.618,32,riffle_perfect
0,17,26,6,49,0.347,23,0.469,1,4,0.2,1,2,32,17,10,16,23,0.204,0.327,0.469,17.631,33,riffle_perfect
0,21,18,8,47,0.447,29,0.617,3,0,1.0,3,1,31,16,11,13,23,0.234,0.277,0.489,17.631,34,riffle_perfect
0,18,23,5,46,0.391,23,0.5,2,5,0.286,4,1,32,14,5,14,27,0.109,0.304,0.587,17.648,35,riffle_perfect
0,18,26,3,47,0.383,21,0.447,3,2,0.6,0,5,31,16,8,15,24,0.17,0.319,0.511,17.651,36,riffle_perfect
0,16,21,9,46,0.348,25,0.543,2,1,0.667,1,2,29,17,6,19,21,0.13,0.413,0.457,17.665,37,riffle_perfect
0,16,22,8,46,0.348,24,0.522,3,3,0.5,0,2,28,18,8,19,19,0.174,0.413,0.413,17.684,38,riffle_perfect
0,22,23,3,48,0.458,25,0.521,4,2,0.667,4,5,28,20,8,16,24,0.167,0.333,0.5,17.658,39,riffle_perfect
0,24,17,6,47,0.511,30,0.638,5,2,0.714,1,2,25,22,18,10,19,0.383,0.213,0.404,17.662,40,riffle_perfect
0,19,29,2,50,0.38,21,0.42,4,0,1.0,2,2,32,18,11,12,27,0.22,0.24,0.54,17.646,41,riffle_perfect
0,21,22,2,45,0.467,23,0.511,1,3,0.25,2,2,28,17,6,18,21,0.133,0.4,0.467,17.656,42,riffle_perfect
0,24,21,2,47,0.511,26,0.553,2,2,0.5,2,4,32,15,11,14,22,0.234,0.298,0.468,17.654,43,riffle_perfect
0,25,15,7,47,0.532,32,0.681,2,2,0.5,4,1,28,19,18,11,18,0.383,0.234,0.383,17.659,44,riffle_perfect
0,22,19,4,45,0.489,26,0.578,1,0,1.0,1,3,23,22,9,16,20,0.2,0.356,0.444,17.65,45,riffle_perfect
0,21,18,6,45,0.467,27,0.6,4,1,0.8,3,3,28,17,13,10,22,0.289,0.222,0.489,17.652,46,riffle_perfect
0,22,20,3,45,0.489,25,0.556,1,0,1.0,0,3,27,18,14,14,17,0.311,0.311,0.378,17.658,47,riffle_perfect
0,21,16,7,44,0.477,28,0.636,1,3,0.25,3,3,27,17,11,14,19,0.25,0.318,0.432,17.651,48,riffle_perfect
0,26,15,2,43,0.605,28,0.651,1,0,1.0,4,2,28,15,17,9,17,0.395,0.209,0.395,17.624,49,riffle_perfect
0,21,19,4,44,0.477,25,0.568,5,0,1.0,2,2,23,21,9,19,16,0.205,0.432,0.364,17.63,50,riffle_perfect
0,23,25,3,51,0.451,26,0.51,4,4,0.5,3,3,32,19,11,16,24,0.216,0.314,0.471,17.626,51,riffle_perfect
0,23,19,5,47,0.489,28,0.596,4,3,0.571,1,3,27,20,14,17,16,0.298,0.362,0.34,17.633,52,riffle_perfect
0,18,26,4,48,0.375,22,0.458,1,2,0.333,3,1,31,17,12,14,22,0.25,0.292,0.458,17.629,53,riffle_perfect
0,24,20,4,48,0.5,28,0.583,7,0,1.0,2,1,25,23,14,16,18,0.292,0.333,0.375,17.632,54,riffle_perfect
0,23,22,1,46,0.5,24,0.522,5,2,0.714,2,3,30,16,10,15,21,0.217,0.326,0.457,17.636,55,riffle_perfect
0,17,26,3,46,0.37,20,0.435,2,3,0.4,2,2,22,24,9,15,22,0.196,0.326,0.478,17.639,56,riffle_perfect
0,20,17,7,44,0.455,27,0.614,0,1,0.0,2,1,30,14,11,18,15,0.25,0.409,0.341,17.648,57,riffle_perfect
0,18,26,2,46,0.391,20,0.435,2,0,1.0,3,6,31,15,9,13,24,0.196,0.283,0.522,17.649,58,riffle_perfect
0,15,22,7,44,0.341,22,0.5,0,5,0.0,5,2,26,18,6,15,23,0.136,0.341,0.523,17.636,59,riffle_perfect
0,20,25,2,47,0.426,22,0.468,2,2,0.5,1,0,26,21,10,17,20,0.213,0.362,0.426,17.641,60,riffle_perfect
0,20,22,3,45,0.444,23,0.511,1,1,0.5,2,4,30,15,12,13,20,0.267,0.289,0.444,17.632,61,riffle_perfect
0,21,20,3,44,0.477,24,0.545,4,1,0.8,0,1,31,13,10,10,24,0.227,0.227,0.545,17.634,62,riffle_perfect
0,18,25,2,45,0.4,20,0.444,2,2,0.5,1,1,25,20,11,10,24,0.244,0.222,0.533,17.62,63,riffle_perfect
0,23,14,7,44,0.523,30,0.682,5,0,1.0,1,3,30,14,15,8,21,0.341,0.182,0.477,17.628,64,riffle_perfect
0,22,20,3,45,0.489,25,0.556,1,1,0.5,1,3,26,19,12,16,17,0.267,0.356,0.378,17.635,65,riffle_perfect
0,25,16,4,45,0.556,29,0.644,0,1,0.0,3,1,25,20,14,15,16,0.311,0.333,0.356,17.639,66,riffle_perfect
0,17,23,3,43,0.395,20,0.465,1,2,0.333,1,1,29,14,9,13,21,0.209,0.302,0.488,17.64,67,riffle_perfect
0,17,22,5,44,0.386,22,0.5,1,4,0.2,4,3,26,18,10,13,21,0.227,0.295,0.477,17.639,68,riffle_perfect
0,15,23,6,44,0.341,21,0.477,0,2,0.0,1,1,25,19,10,16,18,0.227,0.364,0.409,17.653,69,riffle_perfect
0,18,23,3,44,0.409,21,0.477,5,1,0.833,1,3,25,19,7,16,21,0.159,0.364,0.477,17.654,70,riffle_perfect
0,16,21,8,45,0.356,24,0.533,3,1,0.75,1,3,28,17,6,16,23,0.133,0.356,0.511,17.657,71,riffle_perfect
0,17,24,5,46,0.37,22,0.478,1,2,0.333,4,3,29,17,5,17,24,0.109,0.37,0.522,17.659,72,riffle_perfect
0,22,19,4,45,0.489,26,0.578,3,2,0.6,3,0,23,22,10,18,17,0.222,0.4,0.378,17.663,73,riffle_perfect
0,23,17,8,48,0.479,31,0.646,4,2,0.667,0,3,34,14,12,15,21,0.25,0.312,0.438,17.669,74,riffle_perfect
0,19,24,3,46,0.413,22,0.478,1,2,0.333,4,3,30,16,11,12,23,0.239,0.261,0.5,17.66,75,riffle_perfect
0,23,16,6,45,0.511,29,0.644,5,1,0.833,1,2,22,23,14,16,15,0.311,0.356,0.333,17.663,76,riffle_perfect
0,20,20,5,45,0.444,25,0.556,7,2,0.778,4,3,27,18,11,15,19,0.244,0.333,0.422,17.662,77,riffle_perfect
0,19,22,6,47,0.404,25,0.532,2,1,0.667,6,2,24,23,8,19,20,0.17,0.404,0.426,17.656,78,riffle_perfect
0,21,19,4,44,0.477,25,0.568,5,4,0.556,1,3,28,16,12,15,17,0.273,0.341,0.386,17.656,79,riffle_perfect
0,23,17,4,44,0.523,27,0.614,6,1,0.857,1,1,25,19,13,13,18,0.295,0.295,0.409,17.663,80,riffle_perfect
0,26,17,5,48,0.542,31,0.646,1,3,0.25,3,1,30,18,9,17,22,0.188,0.354,0.458,17.663,81,riffle_perfect
0,19,24,3,46,0.413,22,0.478,4,1,0.8,0,5,28,18,7,18,21,0.152,0.391,0.457,17.659,82,riffle_perfect
0,16,28,1,45,0.356,17,0.378,3,1,0.75,0,0,27,18,12,14,19,0.267,0.311,0.422,17.657,83,riffle_perfect
0,23,18,4,45,0.511,27,0.6,3,2,0.6,2,3,30,15,12,14,19,0.267,0.311,0.422,17.656,84,riffle_perfect
0,20,25,3,48,0.417,23,0.479,0,5,0.0,3,2,24,24,14,14,20,0.292,0.292,0.417,17.65,85,riffle_perfect
0,13,32,1,46,0.283,14,0.304,1,4,0.2,1,3,25,21,7,18,21,0.152,0.391,0.457,17.657,86,riffle_perfect
0,26,22,3,51,0.51,29,0.569,2,1,0.667,3,0,28,23,6,22,23,0.118,0.431,0.451,17.654,87,riffle_perfect
0,22,25,0,47,0.468,22,0.468,5,1,0.833,3,4,28,19,11,15,21,0.234,0.319,0.447,17.657,88,riffle_perfect
0,25,18,5,48,0.521,30,0.625,4,1,0.8,0,2,28,20,14,15,19,0.292,0.312,0.396,17.664,89,riffle_perfect
0,19,19,6,44,0.432,25,0.568,1,0,1.0,1,1,29,15,10,13,21,0.227,0.295,0.477,17.661,90,riffle_perfect
0,21,20,1,42,0.5,22,0.524,1,3,0.25,0,0,27,15,13,12,17,0.31,0.286,0.405,17.657,91,riffle_perfect
0,18,23,3,44,0.409,21,0.477,1,2,0.333,1,2,29,15,9,17,18,0.205,0.386,0.409,17.659,92,riffle_perfect
0,19,21,3,43,0.442,22,0.512,3,1,0.75,1,2,32,11,8,12,23,0.186,0.279,0.535,17.658,93,riffle_perfect
0,18,26,3,47,0.383,21,0.447,6,3,0.667,2,2,31,16,3,17,27,0.064,0.362,0.574,17.657,94,riffle_perfect
0,16,25,3,44,0.364,19,0.432,0,5,0.0,0,3,25,19,12,17,15,0.273,0.386,0.341,17.659,95,riffle_perfect
0,24,18,4,46,0.522,28,0.609,3,1,0.75,8,1,25,21,12,14,20,0.261,0.304,0.435,17.647,96,riffle_perfect
0,18,22,4,44,0.409,22,0.5,1,2,0.333,4,1,31,13,10,11,23,0.227,0.25,0.523,17.455,1,riffle_perfect
0,17,22,4,43,0.395,21,0.488,3,3,0.5,4,2,29,14,9,14,20,0.209,0.326,0.465,17.667,2,riffle_perfect
0,16,29,0,45,0.356,16,0.356,3,2,0.6,3,4,30,15,7,16,22,0.156,0.356,0.489,17.894,3,riffle_perfect
0,22,22,4,48,0.458,26,0.542,3,3,0.5,3,2,25,23,11,13,24,0.229,0.271,0.5,17.856,4,riffle_perfect
0,23,17,4,44,0.523,27,0.614,1,1,0.5,1,2,29,15,13,15,16,0.295,0.341,0.364,17.793,5,riffle_perfect
0,21,18,4,43,0.488,25,0.581,5,1,0.833,1,2,24,19,15,14,14,0.349,0.326,0.326,17.837,6,riffle_perfect
0,21,20,5,46,0.457,26,0.565,2,5,0.286,2,3,28,18,12,11,23,0.261,0.239,0.5,17.809,7,riffle_perfect
0,16,26,3,45,0.356,19,0.422,2,3,0.4,2,0,26,19,9,17,19,0.2,0.378,0.422,17.67,8,riffle_perfect
0,24,19,2,45,0.533,26,0.578,3,3,0.5,2,5,30,15,14,12,19,0.311,0.267,0.422,17.654,9,riffle_perfect
0,11,30,4,45,0.244,15,0.333,0,5,0.0,1,3,27,18,6,18,21,0.133,0.4,0.467,17.632,10,riffle_perfect
0,19,25,1,45,0.422,20,0.444,3,2,0.6,2,3,25,20,11,14,20,0.244,0.311,0.444,17.698,11,riffle_perfect
0,20,18,6,44,0.455,26,0.591,2,1,0.667,1,2,27,17,11,12,21,0.25,0.273,0.477,17.708,12,riffle_perfect
0,18,22,5,45,0.4,23,0.511,5,0,1.0,2,2,27,18,9,15,21,0.2,0.333,0.467,17.684,13,riffle_perfect
0,10,32,3,45,0.222,13,0.289,1,1,0.5,0,5,29,16,5,17,23,0.111,0.378,0.511,17.717,14,riffle_perfect
0,21,20,6,47,0.447,27,0.574,4,1,0.8,2,2,24,23,13,19,15,0.277,0.404,0.319,17.657,15,riffle_perfect
0,21,20,4,45,0.467,25,0.556,5,0,1.0,6,1,24,21,10,11,24,0.222,0.244,0.533,17.601,16,riffle_perfect
0,21,23,2,46,0.457,23,0.5,4,2,0.667,0,2,27,19,13,15,18,0.283,0.326,0.391,17.607,17,riffle_perfect
0,21,17,7,45,0.467,28,0.622,2,2,0.5,2,1,25,20,10,13,22,0.222,0.289,0.489,17.61,18,riffle_perfect
0,22,20,3,45,0.489,25,0.556,3,1,0.75,4,1,27,18,12,15,18,0.267,0.333,0.4,17.626,19,riffle_perfect
0,19,21,4,44,0.432,23,0.523,1,2,0.333,3,3,23,21,10,14,20,0.227,0.318,0.455,17.644,20,riffle_perfect
0,16,27,3,46,0.348,19,0.413,4,1,0.8,1,4,22,24,9,19,18,0.196,0.413,0.391,17.623,21,riffle_perfect
0,19,24,2,45,0.422,21,0.467,1,1,0.5,3,3,25,20,10,13,22,0.222,0.289,0.489,17.568,22,riffle_perfect
0,20,22,4,46,0.435,24,0.522,2,2,0.5,4,3,28,18,9,16,21,0.196,0.348,0.457,17.568,23,riffle_perfect
0,18,23,4,45,0.4,22,0.489,4,3,0.571,2,4,30,15,11,16,18,0.244,0.356,0.4,17.574,24,riffle_perfect
0,26,17,3,46,0.565,29,0.63,7,1,0.875,3,0,31,15,13,12,21,0.283,0.261,0.457,17.604,25,riffle_perfect
0,27,17,5,49,0.551,32,0.653,4,2,0.667,5,2,33,16,12,10,27,0.245,0.204,0.551,17.581,26,riffle_perfect
0,20,24,3,47,0.426,23,0.489,1,6,0.143,1,0,27,20,15,12,20,0.319,0.255,0.426,17.588,27,riffle_perfect
0,20,20,6,46,0.435,26,0.565,3,2,0.6,5,3,24,22,12,11,23,0.261,0.239,0.5,17.582,28,riffle_perfect
0,22,21,0,43,0.512,22,0.512,2,0,1.0,2,3,31,12,14,6,23,0.326,0.14,0.535,17.577,29,riffle_perfect
0,17,26,2,45,0.378,19,0.422,3,0,1.0,1,2,26,19,11,16,18,0.244,0.356,0.4,17.571,30,riffle_perfect
0,21,23,3,47,0.447,24,0.511,1,3,0.25,2,3,23,24,12,14,21,0.255,0.298,0.447,17.584,31,riffle_perfect
0,19,21,5,45,0.422,24,0.533,4,2,0.667,6,2,24,21,11,17,17,0.244,0.378,0.378,17.579,32,riffle_perfect
0,14,25,7,46,0.304,21,0.457,3,5,0.375,2,2,30,16,5,18,23,0.109,0.391,0.5,17.601,33,riffle_perfect
0,17,19,9,45,0.378,26,0.578,3,2,0.6,0,0,32,13,8,17,20,0.178,0.378,0.444,17.617,34,riffle_perfect
0,15,28,1,44,0.341,16,0.364,0,4,0.0,2,3,22,22,7,15,22,0.159,0.341,0.5,17.609,35,riffle_perfect
0,18,25,3,46,0.391,21,0.457,5,3,0.625,1,2,28,18,10,12,24,0.217,0.261,0.522,17.624,36,riffle_perfect
0,18,25,2,45,0.4,20,0.444,2,2,0.5,5,2,27,18,9,14,22,0.2,0.311,0.489,17.627,37,riffle_perfect
0,20,19,7,46,0.435,27,0.587,1,1,0.5,4,4,30,16,8,13,25,0.174,0.283,0.543,17.629,38,riffle_perfect
0,19,23,4,46,0.413,23,0.5,3,1,0.75,3,0,26,20,5,21,20,0.109,0.457,0.435,17.646,39,riffle_perfect
0,23,18,5,46,0.5,28,0.609,1,6,0.143,3,1,30,16,11,13,22,0.239,0.283,0.478,17.651,40,riffle_perfect
0,15,25,6,46,0.326,21,0.457,1,2,0.333,0,1,34,12,6,13,27,0.13,0.283,0.587,17.654,41,riffle_perfect
0,14,23,6,43,0.326,20,0.465,5,2,0.714,0,0,27,16,6,15,22,0.14,0.349,0.512,17.664,42,riffle_perfect
0,19,24,1,44,0.432,20,0.455,4,2,0.667,2,3,26,18,7,11,26,0.159,0.25,0.591,17.666,43,riffle_perfect
0,14,23,6,43,0.326,20,0.465,4,3,0.571,0,1,26,17,10,10,23,0.233,0.233,0.535,17.684,44,riffle_perfect
0,21,20,5,46,0.457,26,0.565,3,1,0.75,2,3,29,17,16,12,18,0.348,0.261,0.391,17.683,45,riffle_perfect
0,21,23,2,46,0.457,23,0.5,3,1,0.75,1,2,18,28,14,18,14,0.304,0.391,0.304,17.701,46,riffle_perfect
0,19,19,6,44,0.432,25,0.568,4,3,0.571,2,0,27,17,11,17,16,0.25,0.386,0.364,17.691,47,riffle_perfect
0,18,26,0,44,0.409,18,0.409,3,1,0.75,2,3,25,19,9,15,20,0.205,0.341,0.455,17.697,48,riffle_perfect
0,23,21,3,47,0.489,26,0.553,7,2,0.778,2,2,29,18,13,15,19,0.277,0.319,0.404,17.695,49,riffle_perfect
0,22,21,3,46,0.478,25,0.543,1,0,1.0,1,2,26,20,16,12,18,0.348,0.261,0.391,17.702,50,riffle_perfect
0,20,22,5,47,0.426,25,0.532,5,2,0.714,2,7,24,23,10,18,19,0.213,0.383,0.404,17.716,51,riffle_perfect
0,16,24,4,44,0.364,20,0.455,1,1,0.5,1,1,26,18,8,16,20,0.182,0.364,0.455,17.719,52,riffle_perfect
0,21,22,4,47,0.447,25,0.532,1,2,0.333,1,3,25,22,13,14,20,0.277,0.298,0.426,17.71,53,riffle_perfect
0,17,23,5,45,0.378,22,0.489,6,3,0.667,2,3,24,21,12,13,20,0.267,0.289,0.444,17.712,54,riffle_perfect
0,14,30,1,45,0.311,15,0.333,2,2,0.5,1,3,26,19,7,17,21,0.156,0.378,0.467,17.72,55,riffle_perfect
0,18,22,5,45,0.4,23,0.511,2,4,0.333,1,1,23,22,8,19,18,0.178,0.422,0.4,17.721,56,riffle_perfect
0,24,16,4,44,0.545,28,0.636,6,0,1.0,5,1,26,18,13,15,16,0.295,0.341,0.364,17.713,57,riffle_perfect
0,18,26,5,49,0.367,23,0.469,0,1,0.0,2,2,25,24,10,15,24,0.204,0.306,0.49,17.705,58,riffle_perfect
0,14,27,4,45,0.311,18,0.4,3,4,0.429,2,1,28,17,6,12,27,0.133,0.267,0.6,17.703,59,riffle_perfect
0,24,19,3,46,0.522,27,0.587,2,5,0.286,3,0,26,20,11,17,18,0.239,0.37,0.391,17.699,60,riffle_perfect
0,14,27,4,45,0.311,18,0.4,1,0,1.0,2,4,31,14,6,16,23,0.133,0.356,0.511,17.7,61,riffle_perfect
0,19,20,6,45,0.422,25,0.556,2,1,0.667,4,2,25,20,7,21,17,0.156,0.467,0.378,17.7,62,riffle_perfect
0,20,22,4,46,0.435,24,0.522,2,4,0.333,3,4,29,17,14,11,21,0.304,0.239,0.457,17.704,63,riffle_perfect
0,22,18,5,45,0.489,27,0.6,5,2,0.714,1,2,28,17,13,15,17,0.289,0.333,0.378,17.707,64,riffle_perfect
0,18,20,7,45,0.4,25,0.556,1,2,0.333,1,0,24,21,12,18,15,0.267,0.4,0.333,17.713,65,riffle_perfect
0,17,24,5,46,0.37,22,0.478,4,0,1.0,0,3,31,15,10,14,22,0.217,0.304,0.478,17.72,66,riffle_perfect
0,21,22,3,46,0.457,24,0.522,2,2,0.5,1,3,23,23,16,12,18,0.348,0.261,0.391,17.723,67,riffle_perfect
0,23,15,7,45,0.511,30,0.667,3,1,0.75,2,1,33,12,12,9,24,0.267,0.2,0.533,17.731,68,riffle_perfect
0,16,23,7,46,0.348,23,0.5,2,1,0.667,2,3,24,22,10,17,19,0.217,0.37,0.413,17.734,69,riffle_perfect
0,19,22,5,46,0.413,24,0.522,2,1,0.667,4,1,33,13,7,16,23,0.152,0.348,0.5,17.728,70,riffle_perfect
0,16,24,4,44,0.364,20,0.455,5,0,1.0,2,2,26,18,9,15,20,0.205,0.341,0.455,17.722,71,riffle_perfect
0,16,29,4,49,0.327,20,0.408,4,3,0.571,1,1,28,21,10,17,22,0.204,0.347,0.449,17.73,72,riffle_perfect
0,22,18,4,44,0.5,26,0.591,2,1,0.667,2,2,26,18,11,16,17,0.25,0.364,0.386,17.732,73,riffle_perfect
0,17,23,3,43,0.395,20,0.465,2,2,0.5,2,0,26,17,12,12,19,0.279,0.279,0.442,17.735,74,riffle_perfect
0,26,18,3,47,0.553,29,0.617,7,2,0.778,3,3,23,24,13,17,17,0.277,0.362,0.362,17.73,75,riffle_perfect
0,17,21,6,44,0.386,23,0.523,2,1,0.667,1,2,28,16,12,12,20,0.273,0.273,0.455,17.727,76,riffle_perfect
0,17,27,5,49,0.347,22,0.449,4,2,0.667,2,3,34,15,10,10,29,0.204,0.204,0.592,17.725,77,riffle_perfect
0,20,21,2,43,0.465,22,0.512,4,6,0.4,1,1,23,20,13,13,17,0.302,0.302,0.395,17.731,78,riffle_perfect
0,19,21,4,44,0.432,23,0.523,3,3,0.5,2,1,25,19,12,13,19,0.273,0.295,0.432,17.734,79,riffle_perfect
0,20,20,4,44,0.455,24,0.545,5,2,0.714,3,1,24,20,11,13,20,0.25,0.295,0.455,17.729,80,riffle_perfect
0,15,24,4,43,0.349,19,0.442,0,3,0.0,2,2,26,17,6,19,18,0.14,0.442,0.419,17.734,81,riffle_perfect
0,19,24,4,47,0.404,23,0.489,1,0,1.0,2,4,24,23,10,15,22,0.213,0.319,0.468,17.728,82,riffle_perfect
0,20,21,5,46,0.435,25,0.543,3,2,0.6,2,1,31,15,10,13,23,0.217,0.283,0.5,17.732,83,riffle_perfect
0,21,22,1,44,0.477,22,0.5,5,2,0.714,2,1,27,17,13,13,18,0.295,0.295,0.409,17.732,84,riffle_perfect
0,23,21,5,49,0.469,28,0.571,3,4,0.429,2,1,31,18,16,9,24,0.327,0.184,0.49,17.734,85,riffle_perfect
0,18,23,3,44,0.409,21,0.477,4,3,0.571,1,2,27,17,11,13,20,0.25,0.295,0.455,17.736,86,riffle_perfect
0,19,20,5,44,0.432,24,0.545,2,1,0.667,3,0,23,21,9,16,19,0.205,0.364,0.432,17.733,87,riffle_perfect
0,28,12,4,44,0.636,32,0.727,4,2,0.667,3,1,25,19,13,14,17,0.295,0.318,0.386,17.734,88,riffle_perfect
0,13,30,3,46,0.283,16,0.348,4,2,0.667,1,6,28,18,6,16,24,0.13,0.348,0.522,17.73,89,riffle_perfect
0,21,17,7,45,0.467,28,0.622,2,1,0.667,3,1,23,22,11,14,20,0.244,0.311,0.444,17.731,90,riffle_perfect
0,22,18,3,43,0.512,25,0.581,1,0,1.0,3,1,26,17,14,16,13,0.326,0.372,0.302,17.731,91,riffle_perfect
0,21,19,2,42,0.5,23,0.548,1,2,0.333,0,0,21,21,14,18,10,0.333,0.429,0.238,17.734,92,riffle_perfect
0,18,23,4,45,0.4,22,0.489,3,2,0.6,1,1,27,18,8,16,21,0.178,0.356,0.467,17.741,93,riffle_perfect
0,13,26,7,46,0.283,20,0.435,1,3,0.25,1,1,30,16,7,15,24,0.152,0.326,0.522,17.746,94,riffle_perfect
0,22,18,3,43,0.512,25,0.581,2,2,0.5,2,1,27,16,13,13,17,0.302,0.302,0.395,17.749,95,riffle_perfect
0,20,22,2,44,0.455,22,0.5,1,3,0.25,5,1,24,20,10,17,17,0.227,0.386,0.386,17.754,96,riffle_perfect
0,22,21,1,44,0.5,23,0.523,4,3,0.571,4,1,25,19,12,11,21,0.273,0.25,0.477,17.429,1,riffle_perfect
0,19,25,2,46,0.413,21,0.457,1,2,0.333,3,4,22,24,13,16,17,0.283,0.348,0.37,17.642,2,riffle_perfect
0,19,19,5,43,0.442,24,0.558,5,3,0.625,0,1,29,14,14,12,17,0.326,0.279,0.395,17.615,3,riffle_perfect
0,21,21,4,46,0.457,25,0.543,5,2,0.714,3,2,26,20,12,14,20,0.261,0.304,0.435,17.685,4,riffle_perfect
0,14,23,8,45,0.311,22,0.489,2,2,0.5,3,5,32,13,5,15,25,0.111,0.333,0.556,17.705,5,riffle_perfect
0,18,22,4,44,0.409,22,0.5,5,4,0.556,1,1,24,20,11,13,20,0.25,0.295,0.455,17.746,6,riffle_perfect
0,18,22,4,44,0.409,22,0.5,1,3,0.25,4,3,27,17,10,15,19,0.227,0.341,0.432,17.65,7,riffle_perfect
0,16,23,4,43,0.372,20,0.465,5,1,0.833,0,4,25,18,9,14,20,0.209,0.326,0.465,17.751,8,riffle_perfect
0,20,19,6,45,0.444,26,0.578,3,0,1.0,2,1,25,20,11,17,17,0.244,0.378,0.378,17.792,9,riffle_perfect
0,22,21,1,44,0.5,23,0.523,6,0,1.0,3,2,27,17,13,9,22,0.295,0.205,0.5,17.682,10,riffle_perfect
0,17,29,1,47,0.362,18,0.383,3,2,0.6,1,6,30,17,13,17,17,0.277,0.362,0.362,17.765,11,riffle_perfect
0,15,24,5,44,0.341,20,0.455,2,5,0.286,3,2,30,14,8,14,22,0.182,0.318,0.5,17.74,12,riffle_perfect
0,19,22,3,44,0.432,22,0.5,5,2,0.714,3,2,28,16,10,18,16,0.227,0.409,0.364,17.721,13,riffle_perfect
0,18,21,6,45,0.4,24,0.533,2,4,0.333,1,3,29,16,13,13,19,0.289,0.289,0.422,17.706,14,riffle_perfect
0,22,20,5,47,0.468,27,0.574,3,0,1.0,3,3,31,16,10,12,25,0.213,0.255,0.532,17.596,15,riffle_perfect
0,18,25,2,45,0.4,20,0.444,5,3,0.625,2,1,34,11,7,16,22,0.156,0.356,0.489,17.62,16,riffle_perfect
0,20,20,3,43,0.465,23,0.535,5,1,0.833,1,2,23,20,11,14,18,0.256,0.326,0.419,17.625,17,riffle_perfect
0,27,16,3,46,0.587,30,0.652,4,2,0.667,3,0,24,22,13,14,19,0.283,0.304,0.413,17.647,18,riffle_perfect
0,20,24,2,46,0.435,22,0.478,4,0,1.0,0,5,30,16,15,11,20,0.326,0.239,0.435,17.683,19,riffle_perfect
0,21,22,2,45,0.467,23,0.511,3,3,0.5,2,0,28,17,11,13,21,0.244,0.289,0.467,17.695,20,riffle_perfect
0,20,20,5,45,0.444,25,0.556,4,0,1.0,0,0,25,20,11,16,18,0.244,0.356,0.4,17.698,21,riffle_perfect
0,17,22,5,44,0.386,22,0.5,2,3,0.4,2,1,26,18,8,18,18,0.182,0.409,0.409,17.732,22,riffle_perfect
0,20,20,3,43,0.465,23,0.535,4,0,1.0,1,1,28,15,12,8,23,0.279,0.186,0.535,17.746,23,riffle_perfect
0,15,28,3,46,0.326,18,0.391,4,3,0.571,1,4,29,17,9,17,20,0.196,0.37,0.435,17.779,24,riffle_perfect
0,21,21,2,44,0.477,23,0.523,2,3,0.4,3,2,25,19,12,12,20,0.273,0.273,0.455,17.758,25,riffle_perfect
0,20,23,3,46,0.435,23,0.5,3,4,0.429,3,3,28,18,11,15,20,0.239,0.326,0.435,17.773,26,riffle_perfect
0,16,27,5,48,0.333,21,0.438,0,4,0.0,2,2,35,13,13,13,22,0.271,0.271,0.458,17.758,27,riffle_perfect
0,18,25,4,47,0.383,22,0.468,4,1,0.8,2,0,30,17,7,23,17,0.149,0.489,0.362,17.781,28,riffle_perfect
0,19,21,6,46,0.413,25,0.543,4,1,0.8,1,2,28,18,11,15,20,0.239,0.326,0.435,17.782,29,riffle_perfect
0,21,23,2,46,0.457,23,0.5,3,2,0.6,2,2,28,18,8,14,24,0.174,0.304,0.522,17.761,30,riffle_perfect
0,22,20,5,47,0.468,27,0.574,2,4,0.333,2,2,26,21,10,16,21,0.213,0.34,0.447,17.781,31,riffle_perfect
0,17,24,5,46,0.37,22,0.478,3,3,0.5,4,3,30,16,8,12,26,0.174,0.261,0.565,17.781,32,riffle_perfect
0,20,27,3,50,0.4,23,0.46,6,5,0.545,2,1,34,16,11,12,27,0.22,0.24,0.54,17.753,33,riffle_perfect
0,15,25,3,43,0.349,18,0.419,3,4,0.429,2,0,22,21,9,18,16,0.209,0.419,0.372,17.747,34,riffle_perfect
0,22,22,1,45,0.489,23,0.511,1,0,1.0,2,1,26,19,12,13,20,0.267,0.289,0.444,17.728,35,riffle_perfect
0,21,21,4,46,0.457,25,0.543,1,0,1.0,0,2,28,18,15,15,16,0.326,0.326,0.348,17.721,36,riffle_perfect
0,23,20,5,48,0.479,28,0.583,5,2,0.714,1,1,28,20,15,9,24,0.312,0.188,0.5,17.735,37,riffle_perfect
0,19,27,1,47,0.404,20,0.426,3,2,0.6,2,1,23,24,8,18,21,0.17,0.383,0.447,17.749,38,riffle_perfect
0,24,16,4,44,0.545,28,0.636,3,1,0.75,5,0,29,15,11,14,19,0.25,0.318,0.432,17.749,39,riffle_perfect
0,23,19,3,45,0.511,26,0.578,1,4,0.2,5,3,30,15,7,14,24,0.156,0.311,0.533,17.749,40,riffle_perfect
0,22,27,0,49,0.449,22,0.449,4,5,0.444,1,0,26,23,15,21,13,0.306,0.429,0.265,17.753,41,riffle_perfect
0,17,26,2,45,0.378,19,0.422,4,4,0.5,1,1,29,16,11,14,20,0.244,0.311,0.444,17.749,42,riffle_perfect
0,24,18,2,44,0.545,26,0.591,4,3,0.571,3,1,26,18,17,14,13,0.386,0.318,0.295,17.753,43,riffle_perfect
0,21,21,3,45,0.467,24,0.533,1,2,0.333,3,1,26,19,12,12,21,0.267,0.267,0.467,17.757,44,riffle_perfect
0,28,14,2,44,0.636,30,0.682,4,1,0.8,2,1,20,24,18,17,9,0.409,0.386,0.205,17.752,45,riffle_perfect
0,17,19,8,44,0.386,25,0.568,3,3,0.5,0,2,23,21,9,17,18,0.205,0.386,0.409,17.754,46,riffle_perfect
0,22,14,7,43,0.512,29,0.674,4,1,0.8,2,1,30,13,11,12,20,0.256,0.279,0.465,17.755,47,riffle_perfect
0,24,20,3,47,0.511,27,0.574,4,2,0.667,6,3,27,20,12,14,21,0.255,0.298,0.447,17.748,48,riffle_perfect
0,21,21,5,47,0.447,26,0.553,2,1,0.667,3,2,28,19,11,17,19,0.234,0.362,0.404,17.748,49,riffle_perfect
0,18,23,3,44,0.409,21,0.477,2,4,0.333,4,2,26,18,8,17,19,0.182,0.386,0.432,17.739,50,riffle_perfect
0,18,22,6,46,0.391,24,0.522,2,3,0.4,3,1,27,19,8,16,22,0.174,0.348,0.478,17.736,51,riffle_perfect
0,18,26,4,48,0.375,22,0.458,2,1,0.667,2,4,30,18,10,16,22,0.208,0.333,0.458,17.743,52,riffle_perfect
0,22,26,0,48,0.458,22,0.458,4,2,0.667,1,1,28,20,15,12,21,0.312,0.25,0.438,17.75,53,riffle_perfect
0,22,16,7,45,0.489,29,0.644,6,1,0.857,3,0,25,20,13,12,20,0.289,0.267,0.444,17.744,54,riffle_perfect
0,15,30,3,48,0.312,18,0.375,3,2,0.6,3,3,34,14,9,13,26,0.188,0.271,0.542,17.731,55,riffle_perfect
0,19,22,5,46,0.413,24,0.522,1,1,0.5,3,2,24,22,11,15,20,0.239,0.326,0.435,17.733,56,riffle_perfect
0,19,22,3,44,0.432,22,0.5,3,2,0.6,0,4,28,16,11,14,19,0.25,0.318,0.432,17.729,57,riffle_perfect
0,17,22,5,44,0.386,22,0.5,1,3,0.25,3,1,22,22,11,18,15,0.25,0.409,0.341,17.721,58,riffle_perfect
0,22,20,3,45,0.489,25,0.556,9,1,0.9,4,1,34,11,13,10,22,0.289,0.222,0.489,17.713,59,riffle_perfect
0,17,27,4,48,0.354,21,0.438,0,1,0.0,1,5,31,17,11,17,20,0.229,0.354,0.417,17.721,60,riffle_perfect
0,21,20,5,46,0.457,26,0.565,2,1,0.667,2,1,29,17,12,13,21,0.261,0.283,0.457,17.714,61,riffle_perfect
0,26,17,2,45,0.578,28,0.622,3,1,0.75,2,2,32,13,15,10,20,0.333,0.222,0.444,17.719,62,riffle_perfect
0,20,23,3,46,0.435,23,0.5,4,1,0.8,1,0,24,22,12,17,17,0.261,0.37,0.37,17.719,63,riffle_perfect
0,21,18,6,45,0.467,27,0.6,5,1,0.833,2,3,28,17,11,15,19,0.244,0.333,0.422,17.712,64,riffle_perfect
0,23,19,2,44,0.523,25,0.568,4,2,0.667,3,3,22,22,11,16,17,0.25,0.364,0.386,17.713,65,riffle_perfect
0,17,20,7,44,0.386,24,0.545,2,3,0.4,1,0,23,21,12,11,21,0.273,0.25,0.477,17.709,66,riffle_perfect
0,26,17,0,43,0.605,26,0.605,6,2,0.75,1,0,26,17,18,9,16,0.419,0.209,0.372,17.71,67,riffle_perfect
0,17,25,5,47,0.362,22,0.468,3,1,0.75,2,5,29,18,11,11,25,0.234,0.234,0.532,17.709,68,riffle_perfect
0,19,21,4,44,0.432,23,0.523,2,0,1.0,2,2,29,15,8,16,20,0.182,0.364,0.455,17.706,69,riffle_perfect
0,13,32,5,50,0.26,18,0.36,1,1,0.5,0,4,29,21,6,20,24,0.12,0.4,0.48,17.717,70,riffle_perfect
0,20,21,5,46,0.435,25,0.543,2,0,1.0,1,1,27,19,9,17,20,0.196,0.37,0.435,17.724,71,riffle_perfect
0,14,25,4,43,0.326,18,0.419,1,1,0.5,1,3,30,13,9,14,20,0.209,0.326,0.465,17.729,72,riffle_perfect
0,22,21,3,46,0.478,25,0.543,3,2,0.6,1,3,35,11,10,9,27,0.217,0.196,0.587,17.721,73,riffle_perfect
0,17,23,4,44,0.386,21,0.477,4,3,0.571,0,2,25,19,13,15,16,0.295,0.341,0.364,17.724,74,riffle_perfect
0,26,18,3,47,0.553,29,0.617,5,5,0.5,3,0,24,23,11,17,19,0.234,0.362,0.404,17.716,75,riffle_perfect
0,20,22,3,45,0.444,23,0.511,2,2,0.5,2,1,30,15,8,15,22,0.178,0.333,0.489,17.717,76,riffle_perfect
0,16,27,4,47,0.34,20,0.426,1,3,0.25,2,1,25,22,6,19,22,0.128,0.404,0.468,17.721,77,riffle_perfect
0,19,23,4,46,0.413,23,0.5,1,2,0.333,3,1,26,20,11,15,20,0.239,0.326,0.435,17.714,78,riffle_perfect
0,21,24,1,46,0.457,22,0.478,3,2,0.6,2,2,23,23,12,17,17,0.261,0.37,0.37,17.72,79,riffle_perfect
0,20,25,2,47,0.426,22,0.468,3,5,0.375,2,2,35,12,11,12,24,0.234,0.255,0.511,17.724,80,riffle_perfect
0,22,24,3,49,0.449,25,0.51,2,4,0.333,1,2,31,18,13,15,21,0.265,0.306,0.429,17.73,81,riffle_perfect
0,21,18,4,43,0.488,25,0.581,3,2,0.6,1,1,23,20,14,12,17,0.326,0.279,0.395,17.738,82,riffle_perfect
0,22,21,3,46,0.478,25,0.543,6,2,0.75,0,3,23,23,14,12,20,0.304,0.261,0.435,17.747,83,riffle_perfect
0,23,18,4,45,0.511,27,0.6,1,1,0.5,3,1,26,19,16,12,17,0.356,0.267,0.378,17.737,84,riffle_perfect
0,19,23,4,46,0.413,23,0.5,3,2,0.6,2,2,29,17,10,14,22,0.217,0.304,0.478,17.73,85,riffle_perfect
0,22,21,1,44,0.5,23,0.523,5,2,0.714,1,2,26,18,12,10,22,0.273,0.227,0.5,17.73,86,riffle_perfect
0,18,25,2,45,0.4,20,0.444,2,4,0.333,3,3,30,15,5,15,25,0.111,0.333,0.556,17.722,87,riffle_perfect
0,16,21,9,46,0.348,25,0.543,1,3,0.25,3,3,26,20,7,18,21,0.152,0.391,0.457,17.726,88,riffle_perfect
0,21,22,2,45,0.467,23,0.511,4,1,0.8,3,3,30,15,12,11,22,0.267,0.244,0.489,17.726,89,riffle_perfect
0,13,28,4,45,0.289,17,0.378,0,3,0.0,2,5,28,17,7,19,19,0.156,0.422,0.422,17.729,90,riffle_perfect
0,23,19,5,47,0.489,28,0.596,4,2,0.667,3,3,23,24,9,20,18,0.191,0.426,0.383,17.729,91,riffle_perfect
0,20,20,4,44,0.455,24,0.545,2,3,0.4,2,1,24,20,13,14,17,0.295,0.318,0.386,17.725,92,riffle_perfect
0,14,29,5,48,0.292,19,0.396,2,4,0.333,1,2,31,17,9,16,23,0.188,0.333,0.479,17.727,93,riffle_perfect
0,18,24,5,47,0.383,23,0.489,3,3,0.5,1,2,29,18,10,13,24,0.213,0.277,0.511,17.734,94,riffle_perfect
0,21,21,3,45,0.467,24,0.533,2,1,0.667,1,1,33,12,11,10,24,0.244,0.222,0.533,17.728,95,riffle_perfect
0,18,22,3,43,0.419,21,0.488,0,3,0.0,1,0,31,12,12,14,17,0.279,0.326,0.395,17.727,96,riffle_perfect
0,18,24,5,47,0.383,23,0.489,0,2,0.0,3,7,32,15,10,10,27,0.213,0.213,0.574,17.933,1,riffle_perfect
0,14,27,4,45,0.311,18,0.4,4,2,0.667,4,2,28,17,5,17,23,0.111,0.378,0.511,17.75,2,riffle_perfect
0,17,23,4,44,0.386,21,0.477,4,0,1.0,1,1,29,15,10,15,19,0.227,0.341,0.432,17.785,3,riffle_perfect
0,20,22,3,45,0.444,23,0.511,1,1,0.5,2,4,31,14,8,13,24,0.178,0.289,0.533,17.678,4,riffle_perfect
0,20,25,1,46,0.435,21,0.457,8,5,0.615,2,3,30,16,11,10,25,0.239,0.217,0.543,17.715,5,riffle_perfect
0,18,28,2,48,0.375,20,0.417,1,2,0.333,3,2,22,26,11,19,18,0.229,0.396,0.375,17.682,6,riffle_perfect
0,19,21,4,44,0.432,23,0.523,3,1,0.75,3,2,28,16,12,12,20,0.273,0.273,0.455,17.629,7,riffle_perfect
0,16,30,2,48,0.333,18,0.375,0,0,0,2,4,25,23,10,20,18,0.208,0.417,0.375,17.652,8,riffle_perfect
0,18,26,3,47,0.383,21,0.447,1,0,1.0,1,1,26,21,11,18,18,0.234,0.383,0.383,17.701,9,riffle_perfect
0,21,20,3,44,0.477,24,0.545,4,4,0.5,0,3,27,17,16,13,15,0.364,0.295,0.341,17.743,10,riffle_perfect
0,21,26,2,49,0.429,23,0.469,5,2,0.714,2,3,25,24,13,15,21,0.265,0.306,0.429,17.732,11,riffle_perfect
0,22,16,6,44,0.5,28,0.636,1,3,0.25,2,1,31,13,13,12,19,0.295,0.273,0.432,17.716,12,riffle_perfect
0,16,28,2,46,0.348,18,0.391,3,3,0.5,1,3,31,15,6,16,24,0.13,0.348,0.522,17.695,13,riffle_perfect
0,22,21,4,47,0.468,26,0.553,4,1,0.8,4,1,27,20,13,12,22,0.277,0.255,0.468,17.675,14,riffle_perfect
0,19,24,5,48,0.396,24,0.5,4,3,0.571,2,0,25,23,12,18,18,0.25,0.375,0.375,17.724,15,riffle_perfect
0,20,23,1,44,0.455,21,0.477,3,0,1.0,1,4,30,14,13,12,19,0.295,0.273,0.432,17.714,16,riffle_perfect
0,22,20,2,44,0.5,24,0.545,4,2,0.667,2,0,23,21,17,10,17,0.386,0.227,0.386,17.717,17,riffle_perfect
0,16,23,5,44,0.364,21,0.477,5,4,0.556,1,2,25,19,8,17,19,0.182,0.386,0.432,17.713,18,riffle_perfect
0,24,21,1,46,0.522,25,0.543,5,1,0.833,3,3,23,23,14,11,21,0.304,0.239,0.457,17.645,19,riffle_perfect
0,24,19,3,46,0.522,27,0.587,4,1,0.8,4,0,27,19,12,15,19,0.261,0.326,0.413,17.633,20,riffle_perfect
0,22,20,5,47,0.468,27,0.574,4,1,0.8,2,2,24,23,11,20,16,0.234,0.426,0.34,17.654,21,riffle_perfect
0,23,17,6,46,0.5,29,0.63,3,2,0.6,1,2,29,17,13,12,21,0.283,0.261,0.457,17.649,22,riffle_perfect
0,19,22,4,45,0.422,23,0.511,3,2,0.6,3,2,35,10,9,13,23,0.2,0.289,0.511,17.654,23,riffle_perfect
0,21,25,3,49,0.429,24,0.49,4,3,0.571,4,1,30,19,14,13,22,0.286,0.265,0.449,17.632,24,riffle_perfect
0,19,22,5,46,0.413,24,0.522,6,4,0.6,2,1,26,20,14,12,20,0.304,0.261,0.435,17.634,25,riffle_perfect
0,27,17,2,46,0.587,29,0.63,6,0,1.0,3,2,26,20,14,11,21,0.304,0.239,0.457,17.622,26,riffle_perfect
0,25,19,5,49,0.51,30,0.612,2,2,0.5,2,2,23,26,14,17,18,0.286,0.347,0.367,17.616,27,riffle_perfect
0,21,18,5,44,0.477,26,0.591,5,4,0.556,3,2,25,19,11,18,15,0.25,0.409,0.341,17.634,28,riffle_perfect
0,18,24,6,48,0.375,24,0.5,3,0,1.0,2,2,33,15,7,14,27,0.146,0.292,0.562,17.656,29,riffle_perfect
0,18,28,0,46,0.391,18,0.391,5,3,0.625,0,3,26,20,10,13,23,0.217,0.283,0.5,17.66,30,riffle_perfect
0,26,13,4,43,0.605,30,0.698,2,2,0.5,2,1,30,13,14,6,23,0.326,0.14,0.535,17.663,31,riffle_perfect
0,19,24,5,48,0.396,24,0.5,3,3,0.5,4,2,28,20,8,19,21,0.167,0.396,0.438,17.701,32,riffle_perfect
0,20,20,4,44,0.455,24,0.545,3,1,0.75,4,0,20,24,11,17,16,0.25,0.386,0.364,17.675,33,riffle_perfect
0,14,26,4,44,0.318,18,0.409,2,3,0.4,3,0,27,17,10,15,19,0.227,0.341,0.432,17.675,34,riffle_perfect
0,17,20,7,44,0.386,24,0.545,1,2,0.333,1,1,26,18,9,14,21,0.205,0.318,0.477,17.678,35,riffle_perfect
0,15,26,2,43,0.349,17,0.395,3,2,0.6,0,3,27,16,12,11,20,0.279,0.256,0.465,17.696,36,riffle_perfect
0,18,24,4,46,0.391,22,0.478,5,0,1.0,1,2,30,16,13,10,23,0.283,0.217,0.5,17.682,37,riffle_perfect
0,27,18,2,47,0.574,29,0.617,3,0,1.0,1,3,25,22,17,13,17,0.362,0.277,0.362,17.673,38,riffle_perfect
0,21,20,5,46,0.457,26,0.565,0,2,0.0,2,2,29,17,13,16,17,0.283,0.348,0.37,17.672,39,riffle_perfect
0,20,20,6,46,0.435,26,0.565,3,0,1.0,3,1,21,25,11,18,17,0.239,0.391,0.37,17.671,40,riffle_perfect
0,26,15,3,44,0.591,29,0.659,3,0,1.0,1,1,25,19,16,10,18,0.364,0.227,0.409,17.648,41,riffle_perfect
0,15,29,1,45,0.333,16,0.356,1,2,0.333,3,7,34,11,7,12,26,0.156,0.267,0.578,17.623,42,riffle_perfect
0,19,21,7,47,0.404,26,0.553,2,4,0.333,2,1,32,15,12,15,20,0.255,0.319,0.426,17.64,43,riffle_perfect
0,18,26,4,48,0.375,22,0.458,6,2,0.75,2,2,26,22,13,17,18,0.271,0.354,0.375,17.634,44,riffle_perfect
0,17,21,7,45,0.378,24,0.533,4,3,0.571,3,0,31,14,6,14,25,0.133,0.311,0.556,17.646,45,riffle_perfect
0,18,21,6,45,0.4,24,0.533,4,1,0.8,1,0,30,15,7,18,20,0.156,0.4,0.444,17.664,46,riffle_perfect
0,20,21,3,44,0.455,23,0.523,3,2,0.6,0,2,24,20,13,15,16,0.295,0.341,0.364,17.681,47,riffle_perfect
0,24,21,4,49,0.49,28,0.571,7,2,0.778,4,4,29,20,13,12,24,0.265,0.245,0.49,17.675,48,riffle_perfect
0,12,32,2,46,0.261,14,0.304,1,5,0.167,1,2,28,18,5,15,26,0.109,0.326,0.565,17.681,49,riffle_perfect
0,18,26,3,47,0.383,21,0.447,3,4,0.429,2,3,32,15,7,17,23,0.149,0.362,0.489,17.672,50,riffle_perfect
0,26,15,3,44,0.591,29,0.659,6,1,0.857,1,0,25,19,13,13,18,0.295,0.295,0.409,17.668,51,riffle_perfect
0,25,14,6,45,0.556,31,0.689,1,1,0.5,4,0,26,19,14,14,17,0.311,0.311,0.378,17.661,52,riffle_perfect
0,21,17,6,44,0.477,27,0.614,0,3,0.0,3,2,25,19,14,14,16,0.318,0.318,0.364,17.669,53,riffle_perfect
0,22,17,4,43,0.512,26,0.605,4,4,0.5,1,1,27,16,9,13,21,0.209,0.302,0.488,17.676,54,riffle_perfect
0,18,28,0,46,0.391,18,0.391,2,2,0.5,1,1,31,15,12,13,21,0.261,0.283,0.457,17.676,55,riffle_perfect
0,14,26,5,45,0.311,19,0.422,0,3,0.0,3,2,28,17,7,14,24,0.156,0.311,0.533,17.684,56,riffle_perfect
0,19,25,4,48,0.396,23,0.479,3,4,0.429,1,4,29,19,9,17,22,0.188,0.354,0.458,17.703,57,riffle_perfect
0,23,22,3,48,0.479,26,0.542,4,2,0.667,3,2,27,21,11,16,21,0.229,0.333,0.438,17.702,58,riffle_perfect
0,26,18,1,45,0.578,27,0.6,4,0,1.0,6,1,28,17,14,9,22,0.311,0.2,0.489,17.687,59,riffle_perfect
0,16,27,3,46,0.348,19,0.413,1,5,0.167,1,4,31,15,8,14,24,0.174,0.304,0.522,17.69,60,riffle_perfect
0,19,18,7,44,0.432,26,0.591,4,1,0.8,2,1,25,19,9,16,19,0.205,0.364,0.432,17.705,61,riffle_perfect
0,20,25,2,47,0.426,22,0.468,3,2,0.6,3,1,24,23,12,15,20,0.255,0.319,0.426,17.695,62,riffle_perfect
0,21,24,2,47,0.447,23,0.489,8,2,0.8,1,3,27,20,11,18,18,0.234,0.383,0.383,17.697,63,riffle_perfect
0,16,28,1,45,0.356,17,0.378,4,5,0.444,1,2,27,18,8,11,26,0.178,0.244,0.578,17.699,64,riffle_perfect
0,19,22,2,43,0.442,21,0.488,4,2,0.667,3,2,26,17,9,14,20,0.209,0.326,0.465,17.695,65,riffle_perfect
0,19,19,5,43,0.442,24,0.558,3,3,0.5,2,1,25,18,10,16,17,0.233,0.372,0.395,17.686,66,riffle_perfect
0,21,24,2,47,0.447,23,0.489,4,2,0.667,4,3,33,14,8,13,26,0.17,0.277,0.553,17.692,67,riffle_perfect
0,20,25,1,46,0.435,21,0.457,2,3,0.4,1,3,26,20,14,9,23,0.304,0.196,0.5,17.687,68,riffle_perfect
0,23,20,2,45,0.511,25,0.556,4,1,0.8,3,0,25,20,11,13,21,0.244,0.289,0.467,17.688,69,riffle_perfect
0,16,24,4,44,0.364,20,0.455,5,4,0.556,1,5,29,15,12,14,18,0.273,0.318,0.409,17.689,70,riffle_perfect
0,21,23,4,48,0.438,25,0.521,5,1,0.833,1,3,29,19,15,12,21,0.312,0.25,0.438,17.696,71,riffle_perfect
0,16,23,6,45,0.356,22,0.489,1,3,0.25,0,1,25,20,10,16,19,0.222,0.356,0.422,17.708,72,riffle_perfect
0,24,15,7,46,0.522,31,0.674,3,1,0.75,2,1,29,17,16,10,20,0.348,0.217,0.435,17.7,73,riffle_perfect
0,16,28,2,46,0.348,18,0.391,2,3,0.4,2,4,30,16,9,14,23,0.196,0.304,0.5,17.696,74,riffle_perfect
0,24,17,3,44,0.545,27,0.614,3,2,0.6,3,3,27,17,14,12,18,0.318,0.273,0.409,17.695,75,riffle_perfect
0,24,14,5,43,0.558,29,0.674,5,0,1.0,4,4,28,15,13,11,19,0.302,0.256,0.442,17.691,76,riffle_perfect
0,16,25,6,47,0.34,22,0.468,3,2,0.6,1,3,27,20,8,17,22,0.17,0.362,0.468,17.695,77,riffle_perfect
0,17,25,5,47,0.362,22,0.468,1,3,0.25,3,2,26,21,8,14,25,0.17,0.298,0.532,17.688,78,riffle_perfect
0,18,23,4,45,0.4,22,0.489,2,1,0.667,4,3,24,21,9,11,25,0.2,0.244,0.556,17.675,79,riffle_perfect
0,17,22,7,46,0.37,24,0.522,4,2,0.667,1,4,30,16,8,15,23,0.174,0.326,0.5,17.679,80,riffle_perfect
0,17,19,9,45,0.378,26,0.578,1,2,0.333,3,1,25,20,8,20,17,0.178,0.444,0.378,17.684,81,riffle_perfect
0,15,22,5,42,0.357,20,0.476,5,2,0.714,0,0,30,12,8,14,20,0.19,0.333,0.476,17.684,82,riffle_perfect
0,26,15,4,45,0.578,30,0.667,8,0,1.0,3,2,24,21,15,12,18,0.333,0.267,0.4,17.681,83,riffle_perfect
0,24,20,3,47,0.511,27,0.574,2,2,0.5,2,0,25,22,8,18,21,0.17,0.383,0.447,17.679,84,riffle_perfect
0,22,22,4,48,0.458,26,0.542,3,1,0.75,1,3,30,18,12,11,25,0.25,0.229,0.521,17.674,85,riffle_perfect
0,19,23,2,44,0.432,21,0.477,2,5,0.286,1,5,29,15,11,10,23,0.25,0.227,0.523,17.68,86,riffle_perfect
0,19,19,5,43,0.442,24,0.558,3,2,0.6,3,2,29,14,8,18,17,0.186,0.419,0.395,17.687,87,riffle_perfect
0,19,22,4,45,0.422,23,0.511,2,4,0.333,4,2,31,14,11,9,25,0.244,0.2,0.556,17.679,88,riffle_perfect
0,19,23,1,43,0.442,20,0.465,1,2,0.333,2,0,23,20,12,12,19,0.279,0.279,0.442,17.688,89,riffle_perfect
0,24,21,2,47,0.511,26,0.553,7,4,0.636,2,2,30,17,10,15,22,0.213,0.319,0.468,17.69,90,riffle_perfect
0,18,29,0,47,0.383,18,0.383,2,1,0.667,2,3,24,23,9,17,21,0.191,0.362,0.447,17.682,91,riffle_perfect
0,18,24,3,45,0.4,21,0.467,3,2,0.6,1,1,27,18,14,10,21,0.311,0.222,0.467,17.684,92,riffle_perfect
0,16,22,6,44,0.364,22,0.5,4,0,1.0,0,4,29,15,9,15,20,0.205,0.341,0.455,17.692,93,riffle_perfect
0,25,17,2,44,0.568,27,0.614,5,0,1.0,2,2,25,19,16,10,18,0.364,0.227,0.409,17.689,94,riffle_perfect
0,18,21,5,44,0.409,23,0.523,2,1,0.667,2,3,31,13,9,11,24,0.205,0.25,0.545,17.682,95,riffle_perfect
0,20,20,5,45,0.444,25,0.556,2,3,0.4,2,0,28,17,12,15,18,0.267,0.333,0.4,17.691,96,riffle_perfect
0,15,28,4,47,0.319,19,0.404,2,3,0.4,4,2,31,16,7,14,26,0.149,0.298,0.553,17.818,1,riffle_perfect
0,14,28,5,47,0.298,19,0.404,2,2,0.5,1,2,28,19,6,21,20,0.128,0.447,0.426,18.132,2,riffle_perfect
0,23,22,3,48,0.479,26,0.542,1,1,0.5,2,1,29,19,14,11,23,0.292,0.229,0.479,17.99,3,riffle_perfect
0,18,21,7,46,0.391,25,0.543,3,4,0.429,4,2,29,17,5,19,22,0.109,0.413,0.478,17.918,4,riffle_perfect
0,20,25,3,48,0.417,23,0.479,7,0,1.0,2,4,29,19,9,17,22,0.188,0.354,0.458,17.747,5,riffle_perfect
0,21,17,6,44,0.477,27,0.614,4,0,1.0,3,0,20,24,13,11,20,0.295,0.25,0.455,17.687,6,riffle_perfect
0,27,14,5,46,0.587,32,0.696,2,1,0.667,3,3,26,20,16,8,22,0.348,0.174,0.478,17.67,7,riffle_perfect
0,21,20,3,44,0.477,24,0.545,1,1,0.5,5,0,29,15,5,17,22,0.114,0.386,0.5,17.589,8,riffle_perfect
0,21,23,2,46,0.457,23,0.5,4,1,0.8,4,2,30,16,10,14,22,0.217,0.304,0.478,17.556,9,riffle_perfect
0,20,23,2,45,0.444,22,0.489,4,3,0.571,3,3,27,18,9,16,20,0.2,0.356,0.444,17.595,10,riffle_perfect
0,18,23,4,45,0.4,22,0.489,3,1,0.75,2,1,29,16,15,11,19,0.333,0.244,0.422,17.603,11,riffle_perfect
0,18,26,2,46,0.391,20,0.435,5,1,0.833,1,2,27,19,12,12,22,0.261,0.261,0.478,17.625,12,riffle_perfect
0,16,23,7,46,0.348,23,0.5,3,1,0.75,1,2,29,17,11,17,18,0.239,0.37,0.391,17.642,13,riffle_perfect
0,24,19,5,48,0.5,29,0.604,5,0,1.0,2,1,22,26,12,15,21,0.25,0.312,0.438,17.629,14,riffle_perfect
0,20,22,5,47,0.426,25,0.532,2,2,0.5,4,3,26,21,13,11,23,0.277,0.234,0.489,17.522,15,riffle_perfect
0,17,28,1,46,0.37,18,0.391,2,4,0.333,2,2,27,19,10,14,22,0.217,0.304,0.478,17.509,16,riffle_perfect
0,20,24,2,46,0.435,22,0.478,3,3,0.5,1,0,27,19,12,18,16,0.261,0.391,0.348,17.5,17,riffle_perfect
0,20,20,3,43,0.465,23,0.535,3,4,0.429,1,1,27,16,9,11,23,0.209,0.256,0.535,17.491,18,riffle_perfect
0,22,19,3,44,0.5,25,0.568,2,3,0.4,3,1,33,11,10,15,19,0.227,0.341,0.432,17.519,19,riffle_perfect
0,22,22,1,45,0.489,23,0.511,3,5,0.375,3,1,25,20,12,15,18,0.267,0.333,0.4,17.531,20,riffle_perfect
0,17,28,2,47,0.362,19,0.404,2,3,0.4,4,3,27,20,10,13,24,0.213,0.277,0.511,17.468,21,riffle_perfect
0,24,17,6,47,0.511,30,0.638,3,2,0.6,3,1,24,23,10,22,15,0.213,0.468,0.319,17.506,22,riffle_perfect
0,13,27,6,46,0.283,19,0.413,0,1,0.0,0,2,33,13,5,17,24,0.109,0.37,0.522,17.514,23,riffle_perfect
0,18,21,6,45,0.4,24,0.533,0,5,0.0,1,3,31,14,9,15,21,0.2,0.333,0.467,17.523,24,riffle_perfect
0,26,18,3,47,0.553,29,0.617,4,2,0.667,2,1,30,17,14,10,23,0.298,0.213,0.489,17.522,25,riffle_perfect
0,21,19,5,45,0.467,26,0.578,1,2,0.333,2,1,28,17,8,17,20,0.178,0.378,0.444,17.531,26,riffle_perfect
0,23,21,0,44,0.523,23,0.523,7,2,0.778,0,2,25,19,13,20,11,0.295,0.455,0.25,17.554,27,riffle_perfect
0,13,31,3,47,0.277,16,0.34,3,2,0.6,2,3,30,17,5,16,26,0.106,0.34,0.553,17.561,28,riffle_perfect
0,21,20,3,44,0.477,24,0.545,4,3,0.571,3,2,24,20,10,12,22,0.227,0.273,0.5,17.543,29,riffle_perfect
0,18,23,3,44,0.409,21,0.477,1,2,0.333,3,1,24,20,10,15,19,0.227,0.341,0.432,17.56,30,riffle_perfect
0,18,28,1,47,0.383,19,0.404,2,3,0.4,2,2,32,15,8,11,28,0.17,0.234,0.596,17.537,31,riffle_perfect
0,21,18,5,44,0.477,26,0.591,0,4,0.0,3,1,24,20,9,17,18,0.205,0.386,0.409,17.546,32,riffle_perfect
0,20,24,3,47,0.426,23,0.489,6,1,0.857,1,3,25,22,12,12,23,0.255,0.255,0.489,17.554,33,riffle_perfect
0,11,29,5,45,0.244,16,0.356,1,4,0.2,2,3,28,17,5,18,22,0.111,0.4,0.489,17.56,34,riffle_perfect
0,21,18,4,43,0.488,25,0.581,6,4,0.6,1,0,24,19,13,13,17,0.302,0.302,0.395,17.579,35,riffle_perfect
0,19,25,3,47,0.404,22,0.468,1,2,0.333,3,4,27,20,10,11,26,0.213,0.234,0.553,17.562,36,riffle_perfect
0,20,25,4,49,0.408,24,0.49,7,1,0.875,1,4,31,18,14,14,21,0.286,0.286,0.429,17.565,37,riffle_perfect
0,20,21,4,45,0.444,24,0.533,2,2,0.5,5,3,32,13,8,12,25,0.178,0.267,0.556,17.55,38,riffle_perfect
0,21,25,1,47,0.447,22,0.468,2,2,0.5,1,2,24,23,14,14,19,0.298,0.298,0.404,17.536,39,riffle_perfect
0,24,16,5,45,0.533,29,0.644,6,2,0.75,3,3,27,18,15,12,18,0.333,0.267,0.4,17.542,40,riffle_perfect
0,16,23,4,43,0.372,20,0.465,3,3,0.5,0,2,27,16,11,18,14,0.256,0.419,0.326,17.555,41,riffle_perfect
0,18,21,5,44,0.409,23,0.523,0,0,0,2,2,26,18,11,11,22,0.25,0.25,0.5,17.556,42,riffle_perfect
0,10,31,4,45,0.222,14,0.311,2,1,0.667,1,5,33,12,4,16,25,0.089,0.356,0.556,17.555,43,riffle_perfect
0,12,28,7,47,0.255,19,0.404,1,3,0.25,4,4,31,16,4,14,29,0.085,0.298,0.617,17.571,44,riffle_perfect
0,19,25,4,48,0.396,23,0.479,2,1,0.667,4,3,25,23,8,22,18,0.167,0.458,0.375,17.573,45,riffle_perfect
0,23,21,1,45,0.511,24,0.533,6,3,0.667,2,2,28,17,12,13,20,0.267,0.289,0.444,17.579,46,riffle_perfect
0,20,15,8,43,0.465,28,0.651,2,0,1.0,1,2,27,16,11,17,15,0.256,0.395,0.349,17.604,47,riffle_perfect
0,19,21,3,43,0.442,22,0.512,5,1,0.833,2,1,29,14,10,11,22,0.233,0.256,0.512,17.611,48,riffle_perfect
0,23,16,6,45,0.511,29,0.644,4,2,0.667,0,0,22,23,16,16,13,0.356,0.356,0.289,17.617,49,riffle_perfect
0,16,27,2,45,0.356,18,0.4,0,0,0,2,3,27,18,8,15,22,0.178,0.333,0.489,17.61,50,riffle_perfect
0,18,25,1,44,0.409,19,0.432,5,2,0.714,5,0,25,19,10,11,23,0.227,0.25,0.523,17.588,51,riffle_perfect
0,21,21,3,45,0.467,24,0.533,3,4,0.429,3,4,27,18,10,15,20,0.222,0.333,0.444,17.587,52,riffle_perfect
0,17,22,6,45,0.378,23,0.511,2,6,0.25,2,3,21,24,11,18,16,0.244,0.4,0.356,17.593,53,riffle_perfect
0,29,20,3,52,0.558,32,0.615,4,3,0.571,2,2,32,20,17,11,24,0.327,0.212,0.462,17.586,54,riffle_perfect
0,25,16,4,45,0.556,29,0.644,3,4,0.429,3,1,24,21,17,13,15,0.378,0.289,0.333,17.569,55,riffle_perfect
0,20,22,3,45,0.444,23,0.511,1,0,1.0,3,0,22,23,9,17,19,0.2,0.378,0.422,17.57,56,riffle_perfect
0,21,17,9,47,0.447,30,0.638,2,3,0.4,2,0,28,19,8,16,23,0.17,0.34,0.489,17.576,57,riffle_perfect
0,19,25,2,46,0.413,21,0.457,2,3,0.4,3,3,30,16,8,11,27,0.174,0.239,0.587,17.57,58,riffle_perfect
0,21,22,4,47,0.447,25,0.532,5,4,0.556,2,0,30,17,8,16,23,0.17,0.34,0.489,17.557,59,riffle_perfect
0,19,21,4,44,0.432,23,0.523,2,3,0.4,1,2,30,14,13,10,21,0.295,0.227,0.477,17.564,60,riffle_perfect
0,23,19,2,44,0.523,25,0.568,2,2,0.5,2,0,20,24,13,15,16,0.295,0.341,0.364,17.567,61,riffle_perfect
0,23,20,3,46,0.5,26,0.565,4,2,0.667,1,3,24,22,18,9,19,0.391,0.196,0.413,17.57,62,riffle_perfect
0,24,23,1,48,0.5,25,0.521,6,1,0.857,2,3,30,18,8,14,26,0.167,0.292,0.542,17.565,63,riffle_perfect
0,22,22,3,47,0.468,25,0.532,2,4,0.333,1,3,27,20,12,18,17,0.255,0.383,0.362,17.573,64,riffle_perfect
0,24,21,0,45,0.533,24,0.533,5,1,0.833,1,0,29,16,13,12,20,0.289,0.267,0.444,17.567,65,riffle_perfect
0,25,19,1,45,0.556,26,0.578,3,1,0.75,4,0,29,16,9,15,21,0.2,0.333,0.467,17.573,66,riffle_perfect
0,18,22,4,44,0.409,22,0.5,3,1,0.75,3,2,21,23,9,18,17,0.205,0.409,0.386,17.578,67,riffle_perfect
0,17,27,3,47,0.362,20,0.426,2,4,0.333,5,3,30,17,7,16,24,0.149,0.34,0.511,17.581,68,riffle_perfect
0,28,17,3,48,0.583,31,0.646,2,6,0.25,2,0,26,22,12,17,19,0.25,0.354,0.396,17.59,69,riffle_perfect
0,21,25,5,51,0.412,26,0.51,3,1,0.75,3,1,26,25,15,18,18,0.294,0.353,0.353,17.594,70,riffle_perfect
0,19,20,4,43,0.442,23,0.535,3,3,0.5,2,1,28,15,12,13,18,0.279,0.302,0.419,17.596,71,riffle_perfect
0,19,22,5,46,0.413,24,0.522,2,4,0.333,2,1,28,18,9,21,16,0.196,0.457,0.348,17.604,72,riffle_perfect
0,17,24,6,47,0.362,23,0.489,0,5,0.0,4,0,32,15,11,15,21,0.234,0.319,0.447,17.598,73,riffle_perfect
0,25,22,3,50,0.5,28,0.56,1,1,0.5,4,3,30,20,9,18,23,0.18,0.36,0.46,17.59,74,riffle_perfect
0,18,24,2,44,0.409,20,0.455,4,3,0.571,2,1,25,19,9,20,15,0.205,0.455,0.341,17.592,75,riffle_perfect
0,19,23,4,46,0.413,23,0.5,4,4,0.5,5,2,30,16,12,10,24,0.261,0.217,0.522,17.585,76,riffle_perfect
0,25,16,3,44,0.568,28,0.636,2,3,0.4,3,0,28,16,8,16,20,0.182,0.364,0.455,17.585,77,riffle_perfect
0,21,19,3,43,0.488,24,0.558,4,3,0.571,2,2,30,13,12,10,21,0.279,0.233,0.488,17.591,78,riffle_perfect
0,19,24,4,47,0.404,23,0.489,4,0,1.0,0,4,25,22,14,16,17,0.298,0.34,0.362,17.598,79,riffle_perfect
0,18,24,3,45,0.4,21,0.467,1,3,0.25,1,4,28,17,12,14,19,0.267,0.311,0.422,17.604,80,riffle_perfect
0,16,23,7,46,0.348,23,0.5,0,1,0.0,4,1,32,14,5,16,25,0.109,0.348,0.543,17.592,81,riffle_perfect
0,18,25,2,45,0.4,20,0.444,3,2,0.6,0,3,29,16,12,13,20,0.267,0.289,0.444,17.598,82,riffle_perfect
0,21,23,3,47,0.447,24,0.511,5,2,0.714,2,3,28,19,15,10,22,0.319,0.213,0.468,17.601,83,riffle_perfect
0,20,18,8,46,0.435,28,0.609,5,1,0.833,2,3,26,20,7,20,19,0.152,0.435,0.413,17.603,84,riffle_perfect
0,18,23,3,44,0.409,21,0.477,0,1,0.0,3,1,27,17,11,14,19,0.25,0.318,0.432,17.602,85,riffle_perfect
0,11,27,6,44,0.25,17,0.386,3,1,0.75,0,2,30,14,6,18,20,0.136,0.409,0.455,17.603,86,riffle_perfect
0,14,26,6,46,0.304,20,0.435,3,2,0.6,1,1,28,18,7,15,24,0.152,0.326,0.522,17.601,87,riffle_perfect
0,20,22,2,44,0.455,22,0.5,1,1,0.5,2,3,25,19,12,14,18,0.273,0.318,0.409,17.594,88,riffle_perfect
0,22,23,3,48,0.458,25,0.521,4,3,0.571,3,3,23,25,13,15,20,0.271,0.312,0.417,17.585,89,riffle_perfect
0,25,13,5,43,0.581,30,0.698,7,0,1.0,1,3,25,18,13,17,13,0.302,0.395,0.302,17.593,90,riffle_perfect
0,18,23,2,43,0.419,20,0.465,3,2,0.6,2,1,31,12,9,11,23,0.209,0.256,0.535,17.587,91,riffle_perfect
0,13,26,5,44,0.295,18,0.409,1,1,0.5,2,2,26,18,9,14,21,0.205,0.318,0.477,17.597,92,riffle_perfect
0,22,20,3,45,0.489,25,0.556,0,2,0.0,1,0,27,18,13,12,20,0.289,0.267,0.444,17.595,93,riffle_perfect
0,15,29,2,46,0.326,17,0.37,4,2,0.667,2,2,29,17,10,12,24,0.217,0.261,0.522,17.591,94,riffle_perfect
0,19,26,3,48,0.396,22,0.458,4,1,0.8,3,3,34,14,9,12,27,0.188,0.25,0.562,17.587,95,riffle_perfect
0,22,21,2,45,0.489,24,0.533,3,4,0.429,3,2,25,20,10,18,17,0.222,0.4,0.378,17.589,96,riffle_perfect
0,18,22,7,47,0.383,25,0.532,3,2,0.6,4,2,24,23,9,15,23,0.191,0.319,0.489,17.452,1,riffle_perfect
0,21,18,5,44,0.477,26,0.591,5,2,0.714,2,3,27,17,9,16,19,0.205,0.364,0.432,17.557,2,riffle_perfect
0,22,21,4,47,0.468,26,0.553,3,2,0.6,1,1,30,17,14,9,24,0.298,0.191,0.511,17.584,3,riffle_perfect
0,24,21,0,45,0.533,24,0.533,4,1,0.8,0,3,29,16,10,12,23,0.222,0.267,0.511,17.658,4,riffle_perfect
0,18,23,6,47,0.383,24,0.511,5,4,0.556,1,1,24,23,14,18,15,0.298,0.383,0.319,17.713,5,riffle_perfect
0,24,17,3,44,0.545,27,0.614,6,0,1.0,2,2,26,18,13,17,14,0.295,0.386,0.318,17.732,6,riffle_perfect
0,20,22,3,45,0.444,23,0.511,4,3,0.571,2,2,31,14,9,11,25,0.2,0.244,0.556,17.693,7,riffle_perfect
0,22,21,3,46,0.478,25,0.543,5,5,0.5,1,2,26,20,9,13,24,0.196,0.283,0.522,17.732,8,riffle_perfect
0,17,27,5,49,0.347,22,0.449,0,4,0.0,4,4,34,15,7,15,27,0.143,0.306,0.551,17.712,9,riffle_perfect
0,16,25,3,44,0.364,19,0.432,5,4,0.556,1,2,29,15,8,14,22,0.182,0.318,0.5,17.755,10,riffle_perfect
0,18,18,8,44,0.409,26,0.591,2,1,0.667,1,4,31,13,11,7,26,0.25,0.159,0.591,17.752,11,riffle_perfect
0,22,21,2,45,0.489,24,0.533,2,3,0.4,2,2,26,19,14,20,11,0.311,0.444,0.244,17.761,12,riffle_perfect
0,29,13,4,46,0.63,33,0.717,2,2,0.5,3,2,25,21,15,10,21,0.326,0.217,0.457,17.711,13,riffle_perfect
0,17,24,4,45,0.378,21,0.467,3,5,0.375,3,2,28,17,12,10,23,0.267,0.222,0.511,17.708,14,riffle_perfect
0,23,18,3,44,0.523,26,0.591,3,2,0.6,3,1,29,15,10,10,24,0.227,0.227,0.545,17.716,15,riffle_perfect
0,27,16,2,45,0.6,29,0.644,4,1,0.8,5,2,22,23,18,15,12,0.4,0.333,0.267,17.693,16,riffle_perfect
0,18,21,8,47,0.383,26,0.553,3,0,1.0,2,2,28,19,11,13,23,0.234,0.277,0.489,17.665,17,riffle_perfect
0,21,22,2,45,0.467,23,0.511,3,0,1.0,1,1,24,21,8,18,19,0.178,0.4,0.422,17.687,18,riffle_perfect
0,24,18,2,44,0.545,26,0.591,2,2,0.5,1,0,32,12,13,10,21,0.295,0.227,0.477,17.675,19,riffle_perfect
0,17,26,1,44,0.386,18,0.409,1,2,0.333,1,1,28,16,7,19,18,0.159,0.432,0.409,17.695,20,riffle_perfect
0,17,24,3,44,0.386,20,0.455,1,0,1.0,2,5,24,20,8,18,18,0.182,0.409,0.409,17.654,21,riffle_perfect
0,19,25,4,48,0.396,23,0.479,2,4,0.333,2,3,30,18,9,15,24,0.188,0.312,0.5,17.666,22,riffle_perfect
0,22,20,5,47,0.468,27,0.574,4,2,0.667,2,3,30,17,16,10,21,0.34,0.213,0.447,17.676,23,riffle_perfect
0,22,22,3,47,0.468,25,0.532,2,2,0.5,2,2,26,21,9,19,19,0.191,0.404,0.404,17.668,24,riffle_perfect
0,23,17,6,46,0.5,29,0.63,2,1,0.667,1,2,30,16,16,9,21,0.348,0.196,0.457,17.657,25,riffle_perfect
0,24,24,1,49,0.49,25,0.51,6,5,0.545,3,3,26,23,14,15,20,0.286,0.306,0.408,17.643,26,riffle_perfect
0,22,21,3,46,0.478,25,0.543,4,4,0.5,4,1,33,13,7,12,27,0.152,0.261,0.587,17.65,27,riffle_perfect
0,20,24,3,47,0.426,23,0.489,2,2,0.5,2,3,26,21,9,19,19,0.191,0.404,0.404,17.644,28,riffle_perfect
0,17,25,4,46,0.37,21,0.457,4,3,0.571,0,3,29,17,7,13,26,0.152,0.283,0.565,17.629,29,riffle_perfect
0,19,22,4,45,0.422,23,0.511,2,3,0.4,0,2,26,19,12,16,17,0.267,0.356,0.378,17.643,30,riffle_perfect
0,14,27,4,45,0.311,18,0.4,4,1,0.8,1,2,28,17,6,16,23,0.133,0.356,0.511,17.611,31,riffle_perfect
0,16,27,3,46,0.348,19,0.413,4,4,0.5,1,2,29,17,8,15,23,0.174,0.326,0.5,17.605,32,riffle_perfect
0,22,20,2,44,0.5,24,0.545,3,4,0.429,4,3,28,16,9,13,22,0.205,0.295,0.5,17.601,33,riffle_perfect
0,19,23,3,45,0.422,22,0.489,2,0,1.0,1,1,22,23,10,17,18,0.222,0.378,0.4,17.605,34,riffle_perfect
0,16,22,7,45,0.356,23,0.511,1,1,0.5,0,5,25,20,15,13,17,0.333,0.289,0.378,17.618,35,riffle_perfect
0,23,19,3,45,0.511,26,0.578,3,1,0.75,1,1,21,24,12,18,15,0.267,0.4,0.333,17.63,36,riffle_perfect
0,18,19,6,43,0.419,24,0.558,2,1,0.667,2,0,25,18,9,13,21,0.209,0.302,0.488,17.641,37,riffle_perfect
0,24,19,5,48,0.5,29,0.604,5,1,0.833,1,2,26,22,13,20,15,0.271,0.417,0.312,17.648,38,riffle_perfect
0,20,25,2,47,0.426,22,0.468,7,1,0.875,1,4,28,19,15,15,17,0.319,0.319,0.362,17.657,39,riffle_perfect
0,23,24,2,49,0.469,25,0.51,6,4,0.6,3,2,23,26,14,13,22,0.286,0.265,0.449,17.662,40,riffle_perfect
0,13,26,6,45,0.289,19,0.422,3,2,0.6,3,3,28,17,7,17,21,0.156,0.378,0.467,17.668,41,riffle_perfect
0,20,16,8,44,0.455,28,0.636,1,1,0.5,1,3,27,17,17,11,16,0.386,0.25,0.364,17.671,42,riffle_perfect
0,28,22,0,50,0.56,28,0.56,5,1,0.833,2,0,31,19,16,12,22,0.32,0.24,0.44,17.673,43,riffle_perfect
0,31,14,3,48,0.646,34,0.708,6,2,0.75,1,0,30,18,16,11,21,0.333,0.229,0.438,17.661,44,riffle_perfect
0,20,24,2,46,0.435,22,0.478,1,2,0.333,1,1,30,16,13,9,24,0.283,0.196,0.522,17.634,45,riffle_perfect
0,23,17,6,46,0.5,29,0.63,2,3,0.4,2,2,32,14,6,18,22,0.13,0.391,0.478,17.655,46,riffle_perfect
0,16,24,4,44,0.364,20,0.455,2,2,0.5,0,1,32,12,8,12,24,0.182,0.273,0.545,17.65,47,riffle_perfect
0,20,24,2,46,0.435,22,0.478,1,4,0.2,2,2,27,19,8,17,21,0.174,0.37,0.457,17.655,48,riffle_perfect
0,21,25,1,47,0.447,22,0.468,7,4,0.636,1,2,25,22,4,24,19,0.085,0.511,0.404,17.661,49,riffle_perfect
0,21,22,3,46,0.457,24,0.522,5,1,0.833,2,3,33,13,10,12,24,0.217,0.261,0.522,17.663,50,riffle_perfect
0,25,23,2,50,0.5,27,0.54,2,3,0.4,4,5,32,18,13,6,31,0.26,0.12,0.62,17.639,51,riffle_perfect
0,20,20,4,44,0.455,24,0.545,7,0,1.0,0,3,20,24,8,18,18,0.182,0.409,0.409,17.649,52,riffle_perfect
0,23,18,4,45,0.511,27,0.6,2,2,0.5,2,2,31,14,11,17,17,0.244,0.378,0.378,17.65,53,riffle_perfect
0,8,34,5,47,0.17,13,0.277,1,3,0.25,1,1,27,20,5,21,21,0.106,0.447,0.447,17.656,54,riffle_perfect
0,22,21,1,44,0.5,23,0.523,4,0,1.0,2,0,26,18,9,14,21,0.205,0.318,0.477,17.659,55,riffle_perfect
0,15,24,8,47,0.319,23,0.489,2,7,0.222,1,2,35,12,8,15,24,0.17,0.319,0.511,17.665,56,riffle_perfect
0,17,27,2,46,0.37,19,0.413,4,3,0.571,3,1,32,14,9,9,28,0.196,0.196,0.609,17.665,57,riffle_perfect
0,17,21,6,44,0.386,23,0.523,3,4,0.429,2,1,25,19,11,14,19,0.25,0.318,0.432,17.686,58,riffle_perfect
0,25,18,3,46,0.543,28,0.609,3,2,0.6,7,1,25,21,13,15,18,0.283,0.326,0.391,17.68,59,riffle_perfect
0,18,27,2,47,0.383,20,0.426,2,2,0.5,1,5,30,17,10,13,24,0.213,0.277,0.511,17.665,60,riffle_perfect
0,22,16,6,44,0.5,28,0.636,1,3,0.25,2,3,26,18,12,10,22,0.273,0.227,0.5,17.659,61,riffle_perfect
0,19,20,7,46,0.413,26,0.565,1,2,0.333,5,1,33,13,6,15,25,0.13,0.326,0.543,17.654,62,riffle_perfect
0,20,24,1,45,0.444,21,0.467,5,1,0.833,2,2,22,23,11,17,17,0.244,0.378,0.378,17.659,63,riffle_perfect
0,25,21,1,47,0.532,26,0.553,1,2,0.333,4,1,33,14,14,11,22,0.298,0.234,0.468,17.657,64,riffle_perfect
0,17,23,6,46,0.37,23,0.5,2,2,0.5,2,2,24,22,8,17,21,0.174,0.37,0.457,17.659,65,riffle_perfect
0,21,22,2,45,0.467,23,0.511,3,4,0.429,3,3,34,11,15,11,19,0.333,0.244,0.422,17.649,66,riffle_perfect
0,19,25,4,48,0.396,23,0.479,1,3,0.25,2,4,29,19,11,13,24,0.229,0.271,0.5,17.642,67,riffle_perfect
0,24,20,1,45,0.533,25,0.556,3,2,0.6,2,1,30,15,10,10,25,0.222,0.222,0.556,17.642,68,riffle_perfect
0,21,21,2,44,0.477,23,0.523,0,1,0.0,2,1,27,17,10,14,20,0.227,0.318,0.455,17.643,69,riffle_perfect
0,23,22,2,47,0.489,25,0.532,1,5,0.167,3,1,22,25,12,22,13,0.255,0.468,0.277,17.634,70,riffle_perfect
0,16,23,5,44,0.364,21,0.477,2,3,0.4,1,1,29,15,5,18,21,0.114,0.409,0.477,17.642,71,riffle_perfect
0,15,24,4,43,0.349,19,0.442,2,4,0.333,2,1,24,19,10,14,19,0.233,0.326,0.442,17.644,72,riffle_perfect
0,16,29,1,46,0.348,17,0.37,3,4,0.429,0,2,30,16,11,15,20,0.239,0.326,0.435,17.657,73,riffle_perfect
0,19,24,2,45,0.422,21,0.467,2,4,0.333,3,1,27,18,10,14,21,0.222,0.311,0.467,17.656,74,riffle_perfect
0,20,26,0,46,0.435,20,0.435,2,1,0.667,2,2,28,18,8,18,20,0.174,0.391,0.435,17.654,75,riffle_perfect
0,21,23,5,49,0.429,26,0.531,4,2,0.667,1,2,29,20,11,14,24,0.224,0.286,0.49,17.657,76,riffle_perfect
0,20,20,6,46,0.435,26,0.565,3,1,0.75,2,2,33,13,9,15,22,0.196,0.326,0.478,17.656,77,riffle_perfect
0,16,22,5,43,0.372,21,0.488,2,2,0.5,1,2,26,17,10,13,20,0.233,0.302,0.465,17.662,78,riffle_perfect
0,18,22,4,44,0.409,22,0.5,4,1,0.8,1,1,26,18,11,15,18,0.25,0.341,0.409,17.663,79,riffle_perfect
0,20,18,7,45,0.444,27,0.6,6,2,0.75,3,2,26,19,12,16,17,0.267,0.356,0.378,17.673,80,riffle_perfect
0,13,30,4,47,0.277,17,0.362,3,3,0.5,4,2,27,20,8,15,24,0.17,0.319,0.511,17.677,81,riffle_perfect
0,23,20,1,44,0.523,24,0.545,2,3,0.4,2,1,29,15,12,14,18,0.273,0.318,0.409,17.678,82,riffle_perfect
0,19,22,3,44,0.432,22,0.5,6,5,0.545,2,0,26,18,8,17,19,0.182,0.386,0.432,17.689,83,riffle_perfect
0,18,22,6,46,0.391,24,0.522,4,0,1.0,3,2,26,20,9,17,20,0.196,0.37,0.435,17.683,84,riffle_perfect
0,13,25,6,44,0.295,19,0.432,2,2,0.5,0,4,30,14,10,18,16,0.227,0.409,0.364,17.684,85,riffle_perfect
0,16,25,2,43,0.372,18,0.419,3,3,0.5,1,2,26,17,9,16,18,0.209,0.372,0.419,17.693,86,riffle_perfect
0,23,21,4,48,0.479,27,0.562,4,1,0.8,2,1,21,27,16,14,18,0.333,0.292,0.375,17.697,87,riffle_perfect
0,24,18,2,44,0.545,26,0.591,5,3,0.625,3,0,25,19,12,14,18,0.273,0.318,0.409,17.688,88,riffle_perfect
0,15,22,7,44,0.341,22,0.5,3,3,0.5,2,3,29,15,10,12,22,0.227,0.273,0.5,17.693,89,riffle_perfect
0,17,23,5,45,0.378,22,0.489,3,3,0.5,2,3,24,21,13,12,20,0.289,0.267,0.444,17.689,90,riffle_perfect
0,20,20,4,44,0.455,24,0.545,2,4,0.333,1,5,28,16,13,13,18,0.295,0.295,0.409,17.688,91,riffle_perfect
0,17,25,5,47,0.362,22,0.468,2,1,0.667,3,1,31,16,10,10,27,0.213,0.213,0.574,17.683,92,riffle_perfect
0,19,21,6,46,0.413,25,0.543,5,3,0.625,2,3,29,17,13,10,23,0.283,0.217,0.5,17.685,93,riffle_perfect
0,18,25,4,47,0.383,22,0.468,2,3,0.4,5,4,33,14,9,10,28,0.191,0.213,0.596,17.686,94,riffle_perfect
0,19,20,6,45,0.422,25,0.556,3,3,0.5,4,2,28,17,9,16,20,0.2,0.356,0.444,17.677,95,riffle_perfect
0,22,17,6,45,0.489,28,0.622,1,2,0.333,5,3,32,13,9,15,21,0.2,0.333,0.467,17.673,96,riffle_perfect
0,20,21,5,46,0.435,25,0.543,3,2,0.6,4,0,31,15,11,15,20,0.239,0.326,0.435,17.562,1,riffle_perfect
0,18,24,4,46,0.391,22,0.478,3,4,0.429,1,1,23,23,9,20,17,0.196,0.435,0.37,17.885,2,riffle_perfect
0,23,22,3,48,0.479,26,0.542,3,2,0.6,1,4,31,17,13,15,20,0.271,0.312,0.417,18.144,3,riffle_perfect
0,15,21,9,45,0.333,24,0.533,3,1,0.75,1,2,26,19,8,16,21,0.178,0.356,0.467,18.107,4,riffle_perfect
0,20,25,1,46,0.435,21,0.457,3,2,0.6,3,3,28,18,12,15,19,0.261,0.326,0.413,18.141,5,riffle_perfect
0,16,27,2,45,0.356,18,0.4,0,3,0.0,1,4,30,15,10,11,24,0.222,0.244,0.533,18.159,6,riffle_perfect
0,25,20,1,46,0.543,26,0.565,3,2,0.6,2,2,28,18,10,12,24,0.217,0.261,0.522,18.048,7,riffle_perfect
0,26,19,2,47,0.553,28,0.596,1,0,1.0,1,3,26,21,13,17,17,0.277,0.362,0.362,18.009,8,riffle_perfect
0,25,18,4,47,0.532,29,0.617,5,2,0.714,2,1,29,18,11,15,21,0.234,0.319,0.447,17.981,9,riffle_perfect
0,17,29,2,48,0.354,19,0.396,3,2,0.6,4,4,28,20,10,17,21,0.208,0.354,0.438,17.952,10,riffle_perfect
0,22,15,8,45,0.489,30,0.667,2,0,1.0,0,1,28,17,14,14,17,0.311,0.311,0.378,17.981,11,riffle_perfect
0,22,17,6,45,0.489,28,0.622,2,0,1.0,2,2,32,13,11,14,20,0.244,0.311,0.444,17.945,12,riffle_perfect
0,15,28,0,43,0.349,15,0.349,4,1,0.8,1,3,26,17,8,14,21,0.186,0.326,0.488,17.928,13,riffle_perfect
0,18,25,3,46,0.391,21,0.457,3,4,0.429,0,6,27,19,12,17,17,0.261,0.37,0.37,17.985,14,riffle_perfect
0,24,16,5,45,0.533,29,0.644,2,0,1.0,4,3,28,17,10,14,21,0.222,0.311,0.467,17.93,15,riffle_perfect
0,21,18,5,44,0.477,26,0.591,3,1,0.75,4,2,30,14,11,12,21,0.25,0.273,0.477,17.906,16,riffle_perfect
0,24,19,3,46,0.522,27,0.587,4,1,0.8,3,3,30,16,10,12,24,0.217,0.261,0.522,17.906,17,riffle_perfect
0,19,25,2,46,0.413,21,0.457,5,2,0.714,4,1,24,22,9,14,23,0.196,0.304,0.5,17.828,18,riffle_perfect
0,22,24,3,49,0.449,25,0.51,2,2,0.5,4,3,30,19,12,15,22,0.245,0.306,0.449,17.807,19,riffle_perfect
0,17,24,4,45,0.378,21,0.467,4,1,0.8,1,2,25,20,9,19,17,0.2,0.422,0.378,17.811,20,riffle_perfect
0,12,29,5,46,0.261,17,0.37,2,6,0.25,1,6,25,21,7,20,19,0.152,0.435,0.413,17.802,21,riffle_perfect
0,15,28,2,45,0.333,17,0.378,0,0,0,1,4,27,18,9,15,21,0.2,0.333,0.467,17.797,22,riffle_perfect
0,19,23,3,45,0.422,22,0.489,5,3,0.625,1,3,33,12,11,10,24,0.244,0.222,0.533,17.813,23,riffle_perfect
0,18,24,3,45,0.4,21,0.467,7,3,0.7,1,3,32,13,11,13,21,0.244,0.289,0.467,17.81,24,riffle_perfect
0,20,20,2,42,0.476,22,0.524,1,2,0.333,1,1,26,16,11,10,21,0.262,0.238,0.5,17.806,25,riffle_perfect
0,18,27,3,48,0.375,21,0.438,1,5,0.167,2,3,31,17,8,13,27,0.167,0.271,0.562,17.785,26,riffle_perfect
0,21,23,2,46,0.457,23,0.5,2,1,0.667,3,1,28,18,12,15,19,0.261,0.326,0.413,17.798,27,riffle_perfect
0,21,20,5,46,0.457,26,0.565,4,2,0.667,1,2,23,23,8,19,19,0.174,0.413,0.413,17.808,28,riffle_perfect
0,18,22,5,45,0.4,23,0.511,1,3,0.25,4,1,29,16,8,17,20,0.178,0.378,0.444,17.81,29,riffle_perfect
0,14,24,5,43,0.326,19,0.442,1,3,0.25,0,2,26,17,12,13,18,0.279,0.302,0.419,17.816,30,riffle_perfect
0,14,26,5,45,0.311,19,0.422,1,3,0.25,3,2,30,15,5,15,25,0.111,0.333,0.556,17.804,31,riffle_perfect
0,18,20,6,44,0.409,24,0.545,4,0,1.0,1,3,30,14,12,14,18,0.273,0.318,0.409,17.81,32,riffle_perfect
0,16,25,5,46,0.348,21,0.457,3,2,0.6,1,3,32,14,10,9,27,0.217,0.196,0.587,17.809,33,riffle_perfect
0,11,23,9,43,0.256,20,0.465,3,1,0.75,0,3,25,18,5,20,18,0.116,0.465,0.419,17.816,34,riffle_perfect
0,20,20,4,44,0.455,24,0.545,1,1,0.5,3,1,27,17,11,14,19,0.25,0.318,0.432,17.782,35,riffle_perfect
0,17,23,7,47,0.362,24,0.511,4,4,0.5,1,1,31,16,11,16,20,0.234,0.34,0.426,17.765,36,riffle_perfect
0,26,24,0,50,0.52,26,0.52,2,3,0.4,2,4,31,19,17,11,22,0.34,0.22,0.44,17.754,37,riffle_perfect
0,25,20,4,49,0.51,29,0.592,4,0,1.0,4,1,25,24,12,16,21,0.245,0.327,0.429,17.755,38,riffle_perfect
0,26,20,1,47,0.553,27,0.574,3,4,0.429,5,0,22,25,14,15,18,0.298,0.319,0.383,17.732,39,riffle_perfect
0,23,16,4,43,0.535,27,0.628,3,1,0.75,2,1,22,21,11,18,14,0.256,0.419,0.326,17.735,40,riffle_perfect
0,15,28,3,46,0.326,18,0.391,2,1,0.667,2,4,27,19,10,14,22,0.217,0.304,0.478,17.732,41,riffle_perfect
0,18,26,2,46,0.391,20,0.435,3,3,0.5,1,3,29,17,9,16,21,0.196,0.348,0.457,17.712,42,riffle_perfect
0,21,23,5,49,0.429,26,0.531,5,1,0.833,3,3,28,21,14,13,22,0.286,0.265,0.449,17.709,43,riffle_perfect
0,22,19,3,44,0.5,25,0.568,1,0,1.0,2,1,31,13,16,7,21,0.364,0.159,0.477,17.708,44,riffle_perfect
0,21,23,2,46,0.457,23,0.5,3,0,1.0,4,2,25,21,12,13,21,0.261,0.283,0.457,17.674,45,riffle_perfect
0,17,25,4,46,0.37,21,0.457,6,2,0.75,0,1,26,20,13,15,18,0.283,0.326,0.391,17.682,46,riffle_perfect
0,21,23,2,46,0.457,23,0.5,1,0,1.0,6,3,33,13,8,11,27,0.174,0.239,0.587,17.659,47,riffle_perfect
0,20,24,1,45,0.444,21,0.467,3,2,0.6,2,4,24,21,9,14,22,0.2,0.311,0.489,17.678,48,riffle_perfect
0,25,15,6,46,0.543,31,0.674,5,1,0.833,5,0,24,22,14,14,18,0.304,0.304,0.391,17.672,49,riffle_perfect
0,17,23,4,44,0.386,21,0.477,2,1,0.667,4,3,30,14,7,13,24,0.159,0.295,0.545,17.659,50,riffle_perfect
0,17,22,6,45,0.378,23,0.511,2,1,0.667,3,4,26,19,13,12,20,0.289,0.267,0.444,17.649,51,riffle_perfect
0,12,30,4,46,0.261,16,0.348,3,4,0.429,2,3,31,15,5,19,22,0.109,0.413,0.478,17.647,52,riffle_perfect
0,23,17,4,44,0.523,27,0.614,3,2,0.6,3,2,31,13,11,6,27,0.25,0.136,0.614,17.657,53,riffle_perfect
0,26,14,3,43,0.605,29,0.674,5,1,0.833,3,0,20,23,16,14,13,0.372,0.326,0.302,17.649,54,riffle_perfect
0,21,19,5,45,0.467,26,0.578,4,2,0.667,3,3,30,15,13,15,17,0.289,0.333,0.378,17.658,55,riffle_perfect
0,25,17,2,44,0.568,27,0.614,6,1,0.857,2,3,27,17,17,10,17,0.386,0.227,0.386,17.655,56,riffle_perfect
0,23,16,4,43,0.535,27,0.628,4,4,0.5,1,2,25,18,13,16,14,0.302,0.372,0.326,17.659,57,riffle_perfect
0,17,22,5,44,0.386,22,0.5,2,0,1.0,3,4,29,15,11,14,19,0.25,0.318,0.432,17.677,58,riffle_perfect
0,18,23,4,45,0.4,22,0.489,6,2,0.75,3,2,27,18,11,13,21,0.244,0.289,0.467,17.666,59,riffle_perfect
0,25,18,1,44,0.568,26,0.591,6,1,0.857,4,1,27,17,17,9,18,0.386,0.205,0.409,17.652,60,riffle_perfect
0,17,29,1,47,0.362,18,0.383,4,5,0.444,2,4,25,22,10,20,17,0.213,0.426,0.362,17.65,61,riffle_perfect
0,23,19,4,46,0.5,27,0.587,4,1,0.8,0,1,22,24,16,12,18,0.348,0.261,0.391,17.651,62,riffle_perfect
0,18,23,4,45,0.4,22,0.489,0,1,0.0,3,1,32,13,8,13,24,0.178,0.289,0.533,17.648,63,riffle_perfect
0,25,18,3,46,0.543,28,0.609,5,1,0.833,2,1,32,14,12,12,22,0.261,0.261,0.478,17.65,64,riffle_perfect
0,20,18,7,45,0.444,27,0.6,2,2,0.5,4,2,31,14,11,10,24,0.244,0.222,0.533,17.64,65,riffle_perfect
0,18,21,4,43,0.419,22,0.512,3,0,1.0,1,2,31,12,11,12,20,0.256,0.279,0.465,17.637,66,riffle_perfect
0,24,17,4,45,0.533,28,0.622,3,0,1.0,3,0,29,16,11,16,18,0.244,0.356,0.4,17.642,67,riffle_perfect
0,19,23,3,45,0.422,22,0.489,3,3,0.5,1,3,30,15,12,15,18,0.267,0.333,0.4,17.642,68,riffle_perfect
0,18,25,4,47,0.383,22,0.468,4,4,0.5,3,1,32,15,10,14,23,0.213,0.298,0.489,17.648,69,riffle_perfect
0,24,18,4,46,0.522,28,0.609,6,1,0.857,1,4,26,20,13,12,21,0.283,0.261,0.457,17.652,70,riffle_perfect
0,23,19,4,46,0.5,27,0.587,8,1,0.889,2,3,26,20,17,8,21,0.37,0.174,0.457,17.658,71,riffle_perfect
0,22,22,3,47,0.468,25,0.532,3,1,0.75,3,1,21,26,16,11,20,0.34,0.234,0.426,17.66,72,riffle_perfect
0,15,22,7,44,0.341,22,0.5,3,1,0.75,1,1,27,17,5,18,21,0.114,0.409,0.477,17.674,73,riffle_perfect
0,17,26,4,47,0.362,21,0.447,2,3,0.4,4,1,27,20,6,17,24,0.128,0.362,0.511,17.679,74,riffle_perfect
0,18,26,4,48,0.375,22,0.458,2,5,0.286,1,0,29,19,10,19,19,0.208,0.396,0.396,17.677,75,riffle_perfect
0,18,27,2,47,0.383,20,0.426,2,0,1.0,1,4,30,17,10,17,20,0.213,0.362,0.426,17.674,76,riffle_perfect
0,17,23,4,44,0.386,21,0.477,1,1,0.5,2,2,27,17,11,13,20,0.25,0.295,0.455,17.676,77,riffle_perfect
0,20,20,3,43,0.465,23,0.535,2,0,1.0,0,0,29,14,9,15,19,0.209,0.349,0.442,17.677,78,riffle_perfect
0,25,12,8,45,0.556,33,0.733,3,3,0.5,4,0,29,16,9,16,20,0.2,0.356,0.444,17.685,79,riffle_perfect
0,18,27,3,48,0.375,21,0.438,0,1,0.0,2,4,28,20,10,16,22,0.208,0.333,0.458,17.69,80,riffle_perfect
0,25,18,3,46,0.543,28,0.609,6,3,0.667,1,3,28,18,17,12,17,0.37,0.261,0.37,17.691,81,riffle_perfect
0,18,22,4,44,0.409,22,0.5,3,2,0.6,3,2,29,15,7,14,23,0.159,0.318,0.523,17.686,82,riffle_perfect
0,19,25,2,46,0.413,21,0.457,2,1,0.667,5,4,32,14,9,11,26,0.196,0.239,0.565,17.681,83,riffle_perfect
0,20,22,4,46,0.435,24,0.522,3,4,0.429,2,1,27,19,10,16,20,0.217,0.348,0.435,17.685,84,riffle_perfect
0,17,23,5,45,0.378,22,0.489,4,1,0.8,4,3,26,19,8,14,23,0.178,0.311,0.511,17.677,85,riffle_perfect
0,25,17,4,46,0.543,29,0.63,4,2,0.667,3,3,27,19,16,11,19,0.348,0.239,0.413,17.665,86,riffle_perfect
0,17,20,6,43,0.395,23,0.535,3,1,0.75,1,2,30,13,7,11,25,0.163,0.256,0.581,17.671,87,riffle_perfect
0,17,25,5,47,0.362,22,0.468,2,1,0.667,1,2,27,20,13,13,21,0.277,0.277,0.447,17.673,88,riffle_perfect
0,19,27,1,47,0.404,20,0.426,3,4,0.429,1,4,32,15,12,12,23,0.255,0.255,0.489,17.676,89,riffle_perfect
0,17,23,5,45,0.378,22,0.489,3,1,0.75,3,3,29,16,8,14,23,0.178,0.311,0.511,17.667,90,riffle_perfect
0,19,20,4,43,0.442,23,0.535,3,2,0.6,1,1,26,17,12,17,14,0.279,0.395,0.326,17.669,91,riffle_perfect
0,18,21,7,46,0.391,25,0.543,3,1,0.75,4,0,29,17,11,15,20,0.239,0.326,0.435,17.662,92,riffle_perfect
0,16,22,5,43,0.372,21,0.488,3,1,0.75,5,3,28,15,9,14,20,0.209,0.326,0.465,17.664,93,riffle_perfect
0,15,22,6,43,0.349,21,0.488,5,1,0.833,1,1,27,16,10,15,18,0.233,0.349,0.419,17.668,94,riffle_perfect
0,20,20,5,45,0.444,25,0.556,0,2,0.0,3,2,28,17,9,12,24,0.2,0.267,0.533,17.666,95,riffle_perfect
0,20,23,4,47,0.426,24,0.511,6,2,0.75,0,3,28,19,12,12,23,0.255,0.255,0.489,17.671,96,riffle_perfect
0,16,23,5,44,0.364,21,0.477,3,3,0.5,3,2,29,15,7,14,23,0.159,0.318,0.523,17.677,1,riffle_perfect
0,28,14,7,49,0.571,35,0.714,2,2,0.5,3,1,35,14,9,18,22,0.184,0.367,0.449,17.5,2,riffle_perfect
0,20,21,3,44,0.455,23,0.523,2,4,0.333,1,4,27,17,9,17,18,0.205,0.386,0.409,17.725,3,riffle_perfect
0,19,18,9,46,0.413,28,0.609,3,2,0.6,1,0,26,20,11,20,15,0.239,0.435,0.326,17.839,4,riffle_perfect
0,27,15,3,45,0.6,30,0.667,2,6,0.25,3,3,25,20,17,13,15,0.378,0.289,0.333,17.695,5,riffle_perfect
0,13,26,6,45,0.289,19,0.422,2,1,0.667,2,2,29,16,6,12,27,0.133,0.267,0.6,17.635,6,riffle_perfect
0,20,21,6,47,0.426,26,0.553,2,0,1.0,1,6,29,18,13,13,21,0.277,0.277,0.447,17.49,7,riffle_perfect
0,26,14,5,45,0.578,31,0.689,3,2,0.6,3,2,28,17,8,16,21,0.178,0.356,0.467,17.606,8,riffle_perfect
0,16,26,6,48,0.333,22,0.458,3,3,0.5,1,3,30,18,13,19,16,0.271,0.396,0.333,17.606,9,riffle_perfect
0,22,21,2,45,0.489,24,0.533,6,1,0.857,1,3,28,17,8,17,20,0.178,0.378,0.444,17.594,10,riffle_perfect
0,21,24,3,48,0.438,24,0.5,5,5,0.5,3,3,30,18,8,16,24,0.167,0.333,0.5,17.57,11,riffle_perfect
0,25,15,4,44,0.568,29,0.659,6,2,0.75,3,0,27,17,10,14,20,0.227,0.318,0.455,17.561,12,riffle_perfect
0,20,25,2,47,0.426,22,0.468,2,1,0.667,1,4,31,16,11,15,21,0.234,0.319,0.447,17.537,13,riffle_perfect
0,23,20,3,46,0.5,26,0.565,4,2,0.667,4,3,32,14,11,11,24,0.239,0.239,0.522,17.471,14,riffle_perfect
0,22,19,4,45,0.489,26,0.578,5,3,0.625,1,2,27,18,11,17,17,0.244,0.378,0.378,17.472,15,riffle_perfect
0,22,18,6,46,0.478,28,0.609,5,3,0.625,5,1,25,21,12,14,20,0.261,0.304,0.435,17.467,16,riffle_perfect
0,19,23,4,46,0.413,23,0.5,5,6,0.455,1,1,24,22,13,15,18,0.283,0.326,0.391,17.527,17,riffle_perfect
0,24,18,4,46,0.522,28,0.609,4,1,0.8,2,2,27,19,16,11,19,0.348,0.239,0.413,17.536,18,riffle_perfect
0,19,21,6,46,0.413,25,0.543,4,1,0.8,6,1,27,19,9,15,22,0.196,0.326,0.478,17.496,19,riffle_perfect
0,21,18,5,44,0.477,26,0.591,3,1,0.75,0,0,26,18,12,18,14,0.273,0.409,0.318,17.535,20,riffle_perfect
0,21,22,3,46,0.457,24,0.522,1,2,0.333,3,1,31,15,8,12,26,0.174,0.261,0.565,17.555,21,riffle_perfect
0,22,21,2,45,0.489,24,0.533,2,1,0.667,2,2,28,17,13,16,16,0.289,0.356,0.356,17.551,22,riffle_perfect
0,19,21,4,44,0.432,23,0.523,3,0,1.0,1,1,30,14,8,18,18,0.182,0.409,0.409,17.571,23,riffle_perfect
0,19,19,6,44,0.432,25,0.568,4,0,1.0,1,3,25,19,13,16,15,0.295,0.364,0.341,17.579,24,riffle_perfect
0,27,15,3,45,0.6,30,0.667,4,0,1.0,3,2,31,14,8,10,27,0.178,0.222,0.6,17.575,25,riffle_perfect
0,20,23,3,46,0.435,23,0.5,2,1,0.667,2,1,28,18,10,12,24,0.217,0.261,0.522,17.575,26,riffle_perfect
0,20,24,2,46,0.435,22,0.478,0,1,0.0,4,2,30,16,6,15,25,0.13,0.326,0.543,17.587,27,riffle_perfect
0,18,23,6,47,0.383,24,0.511,5,4,0.556,3,2,32,15,7,15,25,0.149,0.319,0.532,17.615,28,riffle_perfect
0,19,23,4,46,0.413,23,0.5,4,1,0.8,1,5,34,12,13,9,24,0.283,0.196,0.522,17.618,29,riffle_perfect
0,26,14,7,47,0.553,33,0.702,3,0,1.0,1,2,25,22,17,13,17,0.362,0.277,0.362,17.619,30,riffle_perfect
0,22,20,3,45,0.489,25,0.556,3,2,0.6,2,2,27,18,12,12,21,0.267,0.267,0.467,17.65,31,riffle_perfect
0,18,29,1,48,0.375,19,0.396,5,2,0.714,2,1,27,21,10,15,23,0.208,0.312,0.479,17.672,32,riffle_perfect
0,18,24,3,45,0.4,21,0.467,4,2,0.667,0,5,31,14,11,13,21,0.244,0.289,0.467,17.674,33,riffle_perfect
0,21,18,5,44,0.477,26,0.591,4,1,0.8,1,3,29,15,12,12,20,0.273,0.273,0.455,17.678,34,riffle_perfect
0,26,19,3,48,0.542,29,0.604,4,0,1.0,0,2,32,16,16,16,16,0.333,0.333,0.333,17.689,35,riffle_perfect
0,18,24,2,44,0.409,20,0.455,1,4,0.2,2,1,30,14,8,15,21,0.182,0.341,0.477,17.699,36,riffle_perfect
0,21,17,5,43,0.488,26,0.605,2,2,0.5,3,1,26,17,15,11,17,0.349,0.256,0.395,17.697,37,riffle_perfect
0,20,22,2,44,0.455,22,0.5,1,0,1.0,1,2,25,19,13,14,17,0.295,0.318,0.386,17.679,38,riffle_perfect
0,16,25,5,46,0.348,21,0.457,4,1,0.8,1,1,30,16,9,19,18,0.196,0.413,0.391,17.688,39,riffle_perfect
0,20,20,5,45,0.444,25,0.556,2,4,0.333,3,1,29,16,11,8,26,0.244,0.178,0.578,17.694,40,riffle_perfect
0,18,24,4,46,0.391,22,0.478,4,2,0.667,1,0,26,20,10,17,19,0.217,0.37,0.413,17.72,41,riffle_perfect
0,25,13,7,45,0.556,32,0.711,5,0,1.0,3,1,27,18,12,14,19,0.267,0.311,0.422,17.722,42,riffle_perfect
0,22,19,4,45,0.489,26,0.578,1,2,0.333,1,4,27,18,13,11,21,0.289,0.244,0.467,17.719,43,riffle_perfect
0,21,22,2,45,0.467,23,0.511,6,2,0.75,3,4,33,12,11,9,25,0.244,0.2,0.556,17.718,44,riffle_perfect
0,20,21,7,48,0.417,27,0.562,2,1,0.667,2,1,25,23,9,14,25,0.188,0.292,0.521,17.72,45,riffle_perfect
0,25,19,1,45,0.556,26,0.578,4,3,0.571,1,0,29,16,15,12,18,0.333,0.267,0.4,17.729,46,riffle_perfect
0,20,23,2,45,0.444,22,0.489,3,2,0.6,3,1,23,22,8,16,21,0.178,0.356,0.467,17.721,47,riffle_perfect
0,22,21,6,49,0.449,28,0.571,5,3,0.625,3,2,31,18,9,16,24,0.184,0.327,0.49,17.714,48,riffle_perfect
0,19,26,1,46,0.413,20,0.435,5,1,0.833,0,2,28,18,8,22,16,0.174,0.478,0.348,17.714,49,riffle_perfect
0,21,17,5,43,0.488,26,0.605,1,1,0.5,3,4,26,17,13,10,20,0.302,0.233,0.465,17.713,50,riffle_perfect
0,17,24,2,43,0.395,19,0.442,4,2,0.667,2,1,31,12,8,14,21,0.186,0.326,0.488,17.695,51,riffle_perfect
0,16,25,5,46,0.348,21,0.457,1,0,1.0,3,3,27,19,8,17,21,0.174,0.37,0.457,17.691,52,riffle_perfect
0,18,23,4,45,0.4,22,0.489,0,3,0.0,3,2,26,19,9,19,17,0.2,0.422,0.378,17.696,53,riffle_perfect
0,22,24,3,49,0.449,25,0.51,4,2,0.667,2,0,25,24,13,18,18,0.265,0.367,0.367,17.697,54,riffle_perfect
0,14,25,6,45,0.311,20,0.444,0,2,0.0,0,3,30,15,8,14,23,0.178,0.311,0.511,17.711,55,riffle_perfect
0,18,21,6,45,0.4,24,0.533,3,4,0.429,3,2,27,18,8,17,20,0.178,0.378,0.444,17.696,56,riffle_perfect
0,18,22,4,44,0.409,22,0.5,2,4,0.333,2,2,27,17,7,16,21,0.159,0.364,0.477,17.697,57,riffle_perfect
0,15,24,4,43,0.349,19,0.442,1,1,0.5,2,3,30,13,10,14,19,0.233,0.326,0.442,17.697,58,riffle_perfect
0,18,23,3,44,0.409,21,0.477,4,3,0.571,2,1,26,18,10,17,17,0.227,0.386,0.386,17.702,59,riffle_perfect
0,22,21,3,46,0.478,25,0.543,3,0,1.0,0,2,31,15,9,15,22,0.196,0.326,0.478,17.686,60,riffle_perfect
0,14,26,4,44,0.318,18,0.409,1,0,1.0,0,2,32,12,8,15,21,0.182,0.341,0.477,17.702,61,riffle_perfect
0,16,28,2,46,0.348,18,0.391,3,2,0.6,1,1,28,18,12,19,15,0.261,0.413,0.326,17.707,62,riffle_perfect
0,23,19,5,47,0.489,28,0.596,0,1,0.0,1,2,24,23,15,18,14,0.319,0.383,0.298,17.718,63,riffle_perfect
0,23,20,2,45,0.511,25,0.556,4,2,0.667,3,1,28,17,17,9,19,0.378,0.2,0.422,17.713,64,riffle_perfect
0,24,14,6,44,0.545,30,0.682,2,1,0.667,3,0,28,16,13,18,13,0.295,0.409,0.295,17.714,65,riffle_perfect
0,21,18,4,43,0.488,25,0.581,4,2,0.667,1,2,26,17,16,12,15,0.372,0.279,0.349,17.713,66,riffle_perfect
0,20,24,2,46,0.435,22,0.478,2,4,0.333,3,3,25,21,8,17,21,0.174,0.37,0.457,17.715,67,riffle_perfect
0,20,20,6,46,0.435,26,0.565,1,1,0.5,1,4,31,15,13,13,20,0.283,0.283,0.435,17.72,68,riffle_perfect
0,21,21,4,46,0.457,25,0.543,4,3,0.571,4,0,31,15,12,16,18,0.261,0.348,0.391,17.719,69,riffle_perfect
0,19,22,5,46,0.413,24,0.522,4,3,0.571,0,3,28,18,13,13,20,0.283,0.283,0.435,17.724,70,riffle_perfect
0,21,18,5,44,0.477,26,0.591,3,2,0.6,2,0,28,16,7,14,23,0.159,0.318,0.523,17.731,71,riffle_perfect
0,23,21,3,47,0.489,26,0.553,3,2,0.6,2,1,26,21,14,9,24,0.298,0.191,0.511,17.726,72,riffle_perfect
0,13,29,2,44,0.295,15,0.341,1,2,0.333,2,1,29,15,7,18,19,0.159,0.409,0.432,17.727,73,riffle_perfect
0,19,22,3,44,0.432,22,0.5,5,2,0.714,2,1,22,22,8,17,19,0.182,0.386,0.432,17.728,74,riffle_perfect
0,27,17,2,46,0.587,29,0.63,4,2,0.667,2,0,28,18,14,12,20,0.304,0.261,0.435,17.727,75,riffle_perfect
0,21,23,1,45,0.467,22,0.489,2,1,0.667,4,1,31,14,7,11,27,0.156,0.244,0.6,17.721,76,riffle_perfect
0,26,20,2,48,0.542,28,0.583,6,2,0.75,2,4,30,18,19,7,22,0.396,0.146,0.458,17.713,77,riffle_perfect
0,17,26,5,48,0.354,22,0.458,3,3,0.5,2,2,29,19,7,16,25,0.146,0.333,0.521,17.71,78,riffle_perfect
0,24,19,2,45,0.533,26,0.578,3,1,0.75,3,1,25,20,13,12,20,0.289,0.267,0.444,17.71,79,riffle_perfect
0,20,23,2,45,0.444,22,0.489,0,2,0.0,1,4,30,15,12,17,16,0.267,0.378,0.356,17.712,80,riffle_perfect
0,19,22,4,45,0.422,23,0.511,0,1,0.0,0,2,28,17,12,15,18,0.267,0.333,0.4,17.716,81,riffle_perfect
0,17,23,4,44,0.386,21,0.477,0,2,0.0,1,3,31,13,11,13,20,0.25,0.295,0.455,17.709,82,riffle_perfect
0,20,21,6,47,0.426,26,0.553,4,2,0.667,1,2,27,20,14,12,21,0.298,0.255,0.447,17.707,83,riffle_perfect
0,22,18,4,44,0.5,26,0.591,9,1,0.9,1,0,25,19,16,8,20,0.364,0.182,0.455,17.701,84,riffle_perfect
0,17,23,4,44,0.386,21,0.477,6,2,0.75,2,1,29,15,9,13,22,0.205,0.295,0.5,17.691,85,riffle_perfect
0,25,19,5,49,0.51,30,0.612,4,0,1.0,5,2,25,24,12,17,20,0.245,0.347,0.408,17.686,86,riffle_perfect
0,26,17,5,48,0.542,31,0.646,3,1,0.75,3,1,29,19,15,8,25,0.312,0.167,0.521,17.68,87,riffle_perfect
0,19,24,3,46,0.413,22,0.478,5,0,1.0,1,4,28,18,11,15,20,0.239,0.326,0.435,17.677,88,riffle_perfect
0,22,20,4,46,0.478,26,0.565,2,3,0.4,3,1,28,18,7,13,26,0.152,0.283,0.565,17.674,89,riffle_perfect
0,18,24,4,46,0.391,22,0.478,4,1,0.8,1,2,24,22,9,17,20,0.196,0.37,0.435,17.68,90,riffle_perfect
0,16,20,7,43,0.372,23,0.535,3,2,0.6,2,3,31,12,13,9,21,0.302,0.209,0.488,17.685,91,riffle_perfect
0,17,26,2,45,0.378,19,0.422,3,1,0.75,1,3,31,14,9,12,24,0.2,0.267,0.533,17.685,92,riffle_perfect
0,18,24,3,45,0.4,21,0.467,3,1,0.75,1,2,23,22,13,8,24,0.289,0.178,0.533,17.676,93,riffle_perfect
0,21,24,4,49,0.429,25,0.51,5,1,0.833,3,2,26,23,15,15,19,0.306,0.306,0.388,17.675,94,riffle_perfect
0,25,17,5,47,0.532,30,0.638,5,0,1.0,4,3,25,22,13,9,25,0.277,0.191,0.532,17.661,95,riffle_perfect
0,21,18,6,45,0.467,27,0.6,2,2,0.5,2,2,30,15,12,13,20,0.267,0.289,0.444,17.663,96,riffle_perfect
0,21,21,3,45,0.467,24,0.533,4,2,0.667,3,3,29,16,13,11,21,0.289,0.244,0.467,17.667,1,riffle_perfect
0,16,24,4,44,0.364,20,0.455,2,0,1.0,1,2,30,14,6,16,22,0.136,0.364,0.5,17.966,2,riffle_perfect
0,21,23,0,44,0.477,21,0.477,1,0,1.0,3,3,24,20,11,14,19,0.25,0.318,0.432,17.798,3,riffle_perfect
0,16,21,7,44,0.364,23,0.523,2,3,0.4,3,1,33,11,8,16,20,0.182,0.364,0.455,18.043,4,riffle_perfect
0,21,20,2,43,0.488,23,0.535,4,1,0.8,2,2,27,16,11,18,14,0.256,0.419,0.326,17.944,5,riffle_perfect
0,19,18,6,43,0.442,25,0.581,2,2,0.5,1,1,26,17,11,16,16,0.256,0.372,0.372,17.983,6,riffle_perfect
0,20,17,6,43,0.465,26,0.605,7,1,0.875,2,0,27,16,7,20,16,0.163,0.465,0.372,17.99,7,riffle_perfect
0,21,21,3,45,0.467,24,0.533,0,3,0.0,2,2,26,19,15,14,16,0.333,0.311,0.356,18.062,8,riffle_perfect
0,14,26,4,44,0.318,18,0.409,2,5,0.286,2,2,23,21,10,18,16,0.227,0.409,0.364,17.972,9,riffle_perfect
0,19,23,3,45,0.422,22,0.489,5,3,0.625,2,4,30,15,14,10,21,0.311,0.222,0.467,17.953,10,riffle_perfect
0,20,21,3,44,0.455,23,0.523,4,0,1.0,2,0,29,15,7,15,22,0.159,0.341,0.5,17.936,11,riffle_perfect
0,23,21,1,45,0.511,24,0.533,3,2,0.6,2,0,23,22,12,15,18,0.267,0.333,0.4,17.932,12,riffle_perfect
0,15,29,2,46,0.326,17,0.37,4,3,0.571,4,3,34,12,5,15,26,0.109,0.326,0.565,17.944,13,riffle_perfect
0,20,17,7,44,0.455,27,0.614,3,0,1.0,6,3,27,17,8,15,21,0.182,0.341,0.477,17.859,14,riffle_perfect
0,19,21,5,45,0.422,24,0.533,2,0,1.0,2,5,30,15,9,14,22,0.2,0.311,0.489,17.838,15,riffle_perfect
0,18,22,4,44,0.409,22,0.5,2,4,0.333,2,1,28,16,9,12,23,0.205,0.273,0.523,17.78,16,riffle_perfect
0,21,22,3,46,0.457,24,0.522,3,3,0.5,5,2,32,14,8,11,27,0.174,0.239,0.587,17.738,17,riffle_perfect
0,19,28,1,48,0.396,20,0.417,7,4,0.636,3,3,25,23,12,13,23,0.25,0.271,0.479,17.746,18,riffle_perfect
0,22,17,8,47,0.468,30,0.638,1,0,1.0,2,2,29,18,10,19,18,0.213,0.404,0.383,17.781,19,riffle_perfect
0,16,25,5,46,0.348,21,0.457,4,5,0.444,1,2,24,22,12,17,17,0.261,0.37,0.37,17.785,20,riffle_perfect
0,18,22,6,46,0.391,24,0.522,3,2,0.6,3,3,26,20,12,13,21,0.261,0.283,0.457,17.793,21,riffle_perfect
0,24,16,3,43,0.558,27,0.628,5,1,0.833,3,4,27,16,14,12,17,0.326,0.279,0.395,17.797,22,riffle_perfect
0,22,22,3,47,0.468,25,0.532,3,2,0.6,3,3,31,16,11,15,21,0.234,0.319,0.447,17.793,23,riffle_perfect
0,16,25,2,43,0.372,18,0.419,4,1,0.8,2,2,27,16,9,17,17,0.209,0.395,0.395,17.801,24,riffle_perfect
0,25,17,2,44,0.568,27,0.614,5,3,0.625,1,3,24,20,11,14,19,0.25,0.318,0.432,17.802,25,riffle_perfect
0,15,25,4,44,0.341,19,0.432,2,3,0.4,0,3,27,17,10,13,21,0.227,0.295,0.477,17.79,26,riffle_perfect
0,21,22,3,46,0.457,24,0.522,1,0,1.0,1,4,29,17,11,10,25,0.239,0.217,0.543,17.786,27,riffle_perfect
0,14,25,5,44,0.318,19,0.432,1,2,0.333,0,1,26,18,7,18,19,0.159,0.409,0.432,17.791,28,riffle_perfect
0,19,22,6,47,0.404,25,0.532,1,3,0.25,1,3,31,16,13,15,19,0.277,0.319,0.404,17.782,29,riffle_perfect
0,22,15,6,43,0.512,28,0.651,5,1,0.833,0,0,28,15,12,11,20,0.279,0.256,0.465,17.776,30,riffle_perfect
0,19,22,3,44,0.432,22,0.5,4,1,0.8,2,3,24,20,11,17,16,0.25,0.386,0.364,17.767,31,riffle_perfect
0,26,17,4,47,0.553,30,0.638,3,3,0.5,1,2,29,18,18,13,16,0.383,0.277,0.34,17.769,32,riffle_perfect
0,15,22,6,43,0.349,21,0.488,5,2,0.714,1,0,25,18,9,14,20,0.209,0.326,0.465,17.755,33,riffle_perfect
0,18,24,3,45,0.4,21,0.467,1,0,1.0,1,4,27,18,7,14,24,0.156,0.311,0.533,17.762,34,riffle_perfect
0,21,20,5,46,0.457,26,0.565,5,1,0.833,2,6,29,17,10,14,22,0.217,0.304,0.478,17.778,35,riffle_perfect
0,25,17,2,44,0.568,27,0.614,2,4,0.333,1,1,28,16,9,16,19,0.205,0.364,0.432,17.774,36,riffle_perfect
0,22,17,4,43,0.512,26,0.605,5,3,0.625,0,2,28,15,11,17,15,0.256,0.395,0.349,17.755,37,riffle_perfect
0,25,19,4,48,0.521,29,0.604,3,2,0.6,5,0,29,19,11,20,17,0.229,0.417,0.354,17.753,38,riffle_perfect
0,25,16,6,47,0.532,31,0.66,6,3,0.667,2,3,30,17,12,13,22,0.255,0.277,0.468,17.752,39,riffle_perfect
0,24,14,7,45,0.533,31,0.689,7,0,1.0,1,1,22,23,12,18,15,0.267,0.4,0.333,17.763,40,riffle_perfect
0,20,23,2,45,0.444,22,0.489,6,1,0.857,3,3,24,21,7,19,19,0.156,0.422,0.422,17.76,41,riffle_perfect
0,20,21,5,46,0.435,25,0.543,3,1,0.75,4,4,27,19,11,11,24,0.239,0.239,0.522,17.752,42,riffle_perfect
0,18,21,6,45,0.4,24,0.533,5,3,0.625,0,0,23,22,12,15,18,0.267,0.333,0.4,17.775,43,riffle_perfect
0,13,30,3,46,0.283,16,0.348,3,1,0.75,1,4,36,10,9,11,26,0.196,0.239,0.565,17.792,44,riffle_perfect
0,27,16,3,46,0.587,30,0.652,6,2,0.75,4,2,29,17,14,10,22,0.304,0.217,0.478,17.771,45,riffle_perfect
0,26,18,1,45,0.578,27,0.6,1,3,0.25,5,1,23,22,11,17,17,0.244,0.378,0.378,17.752,46,riffle_perfect
0,16,25,2,43,0.372,18,0.419,2,1,0.667,1,1,23,20,8,18,17,0.186,0.419,0.395,17.759,47,riffle_perfect
0,23,16,6,45,0.511,29,0.644,4,0,1.0,2,0,25,20,14,12,19,0.311,0.267,0.422,17.763,48,riffle_perfect
0,27,19,3,49,0.551,30,0.612,3,1,0.75,2,1,30,19,18,16,15,0.367,0.327,0.306,17.768,49,riffle_perfect
0,20,22,3,45,0.444,23,0.511,2,0,1.0,1,2,29,16,9,15,21,0.2,0.333,0.467,17.77,50,riffle_perfect
0,15,29,1,45,0.333,16,0.356,4,3,0.571,1,2,30,15,10,15,20,0.222,0.333,0.444,17.764,51,riffle_perfect
0,20,24,1,45,0.444,21,0.467,2,4,0.333,0,1,26,19,17,15,13,0.378,0.333,0.289,17.763,52,riffle_perfect
0,25,19,1,45,0.556,26,0.578,2,1,0.667,3,0,22,23,15,14,16,0.333,0.311,0.356,17.752,53,riffle_perfect
0,28,17,6,51,0.549,34,0.667,7,2,0.778,5,2,25,26,17,16,18,0.333,0.314,0.353,17.744,54,riffle_perfect
0,14,24,7,45,0.311,21,0.467,4,5,0.444,2,3,28,17,8,16,21,0.178,0.356,0.467,17.751,55,riffle_perfect
0,22,19,4,45,0.489,26,0.578,8,1,0.889,2,4,27,18,8,13,24,0.178,0.289,0.533,17.76,56,riffle_perfect
0,19,20,5,44,0.432,24,0.545,0,0,0,1,1,27,17,11,17,16,0.25,0.386,0.364,17.762,57,riffle_perfect
0,31,16,0,47,0.66,31,0.66,4,0,1.0,3,2,26,21,19,9,19,0.404,0.191,0.404,17.751,58,riffle_perfect
0,21,19,6,46,0.457,27,0.587,2,1,0.667,3,1,28,18,10,15,21,0.217,0.326,0.457,17.756,59,riffle_perfect
0,24,15,5,44,0.545,29,0.659,4,0,1.0,2,1,30,14,9,11,24,0.205,0.25,0.545,17.743,60,riffle_perfect
0,21,21,4,46,0.457,25,0.543,2,1,0.667,1,3,31,15,10,11,25,0.217,0.239,0.543,17.754,61,riffle_perfect
0,23,20,3,46,0.5,26,0.565,5,2,0.714,3,1,30,16,11,15,20,0.239,0.326,0.435,17.755,62,riffle_perfect
0,22,17,5,44,0.5,27,0.614,3,1,0.75,3,2,31,13,11,12,21,0.25,0.273,0.477,17.752,63,riffle_perfect
0,17,24,3,44,0.386,20,0.455,4,4,0.5,1,0,27,17,11,14,19,0.25,0.318,0.432,17.751,64,riffle_perfect
0,23,17,5,45,0.511,28,0.622,4,2,0.667,1,1,24,21,12,14,19,0.267,0.311,0.422,17.756,65,riffle_perfect
0,12,27,6,45,0.267,18,0.4,1,4,0.2,0,4,35,10,6,13,26,0.133,0.289,0.578,17.758,66,riffle_perfect
0,19,24,3,46,0.413,22,0.478,6,1,0.857,2,1,28,18,11,12,23,0.239,0.261,0.5,17.749,67,riffle_perfect
0,17,21,6,44,0.386,23,0.523,3,4,0.429,2,3,28,16,3,20,21,0.068,0.455,0.477,17.758,68,riffle_perfect
0,21,21,2,44,0.477,23,0.523,3,1,0.75,2,2,29,15,11,12,21,0.25,0.273,0.477,17.758,69,riffle_perfect
0,18,20,7,45,0.4,25,0.556,2,0,1.0,2,2,26,19,10,15,20,0.222,0.333,0.444,17.759,70,riffle_perfect
0,28,16,2,46,0.609,30,0.652,2,0,1.0,4,0,28,18,17,11,18,0.37,0.239,0.391,17.752,71,riffle_perfect
0,23,22,5,50,0.46,28,0.56,2,5,0.286,2,1,21,29,15,18,17,0.3,0.36,0.34,17.756,72,riffle_perfect
0,20,22,6,48,0.417,26,0.542,1,0,1.0,3,3,27,21,13,12,23,0.271,0.25,0.479,17.751,73,riffle_perfect
0,19,18,7,44,0.432,26,0.591,3,1,0.75,0,2,22,22,12,14,18,0.273,0.318,0.409,17.748,74,riffle_perfect
0,23,20,3,46,0.5,26,0.565,2,3,0.4,2,1,22,24,14,15,17,0.304,0.326,0.37,17.753,75,riffle_perfect
0,12,24,9,45,0.267,21,0.467,3,2,0.6,1,1,27,18,9,14,22,0.2,0.311,0.489,17.762,76,riffle_perfect
0,21,20,3,44,0.477,24,0.545,3,2,0.6,2,2,26,18,14,7,23,0.318,0.159,0.523,17.769,77,riffle_perfect
0,21,18,5,44,0.477,26,0.591,0,0,0,1,0,24,20,10,17,17,0.227,0.386,0.386,17.766,78,riffle_perfect
0,22,20,3,45,0.489,25,0.556,3,1,0.75,2,1,28,17,11,12,22,0.244,0.267,0.489,17.777,79,riffle_perfect
0,14,17,12,43,0.326,26,0.605,3,0,1.0,2,0,28,15,8,16,19,0.186,0.372,0.442,17.776,80,riffle_perfect
0,18,22,6,46,0.391,24,0.522,1,4,0.2,1,0,26,20,9,18,19,0.196,0.391,0.413,17.785,81,riffle_perfect
0,18,25,2,45,0.4,20,0.444,3,1,0.75,0,4,31,14,12,13,20,0.267,0.289,0.444,17.785,82,riffle_perfect
0,19,19,5,43,0.442,24,0.558,3,1,0.75,2,3,27,16,10,15,18,0.233,0.349,0.419,17.789,83,riffle_perfect
0,28,16,0,44,0.636,28,0.636,3,3,0.5,0,0,25,19,19,9,16,0.432,0.205,0.364,17.792,84,riffle_perfect
0,22,20,5,47,0.468,27,0.574,3,7,0.3,2,0,27,20,11,19,17,0.234,0.404,0.362,17.796,85,riffle_perfect
0,20,23,1,44,0.455,21,0.477,1,5,0.167,1,2,26,18,11,13,20,0.25,0.295,0.455,17.79,86,riffle_perfect
0,19,24,3,46,0.413,22,0.478,1,2,0.333,2,4,36,10,12,12,22,0.261,0.261,0.478,17.787,87,riffle_perfect
0,21,24,3,48,0.438,24,0.5,6,5,0.545,1,3,23,25,13,18,17,0.271,0.375,0.354,17.782,88,riffle_perfect
0,19,20,7,46,0.413,26,0.565,3,2,0.6,2,2,27,19,9,19,18,0.196,0.413,0.391,17.79,89,riffle_perfect
0,22,20,3,45,0.489,25,0.556,2,1,0.667,1,2,25,20,10,17,18,0.222,0.378,0.4,17.791,90,riffle_perfect
0,20,17,5,42,0.476,25,0.595,7,1,0.875,2,2,27,15,13,14,15,0.31,0.333,0.357,17.794,91,riffle_perfect
0,17,25,4,46,0.37,21,0.457,0,3,0.0,2,3,32,14,6,17,23,0.13,0.37,0.5,17.79,92,riffle_perfect
0,18,23,5,46,0.391,23,0.5,0,2,0.0,6,2,32,14,5,11,30,0.109,0.239,0.652,17.777,93,riffle_perfect
0,23,21,3,47,0.489,26,0.553,2,3,0.4,4,1,29,18,10,17,20,0.213,0.362,0.426,17.776,94,riffle_perfect
0,28,18,4,50,0.56,32,0.64,5,1,0.833,5,2,28,22,13,16,21,0.26,0.32,0.42,17.767,95,riffle_perfect
0,12,27,4,43,0.279,16,0.372,2,5,0.286,2,2,28,15,5,15,23,0.116,0.349,0.535,17.768,96,riffle_perfect
0,22,20,1,43,0.512,23,0.535,3,2,0.6,4,3,18,25,11,15,17,0.256,0.349,0.395,16.808,1,riffle_perfect
0,24,20,2,46,0.522,26,0.565,3,3,0.5,2,0,27,19,12,18,16,0.261,0.391,0.348,17.37,2,riffle_perfect
0,30,13,2,45,0.667,32,0.711,5,1,0.833,4,2,29,16,12,9,24,0.267,0.2,0.533,17.619,3,riffle_perfect
0,18,24,3,45,0.4,21,0.467,0,5,0.0,5,1,24,21,10,16,19,0.222,0.356,0.422,17.43,4,riffle_perfect
0,21,23,2,46,0.457,23,0.5,2,2,0.5,3,3,32,14,9,13,24,0.196,0.283,0.522,17.486,5,riffle_perfect
0,22,20,3,45,0.489,25,0.556,3,2,0.6,1,2,30,15,9,14,22,0.2,0.311,0.489,17.477,6,riffle_perfect
0,17,24,3,44,0.386,20,0.455,0,2,0.0,2,1,30,14,11,14,19,0.25,0.318,0.432,17.534,7,riffle_perfect
0,17,23,6,46,0.37,23,0.5,3,5,0.375,2,3,28,18,10,20,16,0.217,0.435,0.348,17.584,8,riffle_perfect
0,28,14,5,47,0.596,33,0.702,3,1,0.75,3,1,25,22,16,14,17,0.34,0.298,0.362,17.548,9,riffle_perfect
0,19,23,3,45,0.422,22,0.489,2,2,0.5,3,4,34,11,7,13,25,0.156,0.289,0.556,17.526,10,riffle_perfect
0,18,19,7,44,0.409,25,0.568,0,1,0.0,1,4,29,15,11,18,15,0.25,0.409,0.341,17.567,11,riffle_perfect
0,18,24,4,46,0.391,22,0.478,2,4,0.333,0,3,27,19,10,15,21,0.217,0.326,0.457,17.633,12,riffle_perfect
0,26,18,4,48,0.542,30,0.625,1,0,1.0,2,2,29,19,16,10,22,0.333,0.208,0.458,17.607,13,riffle_perfect
0,20,19,5,44,0.455,25,0.568,1,1,0.5,2,3,24,20,17,12,15,0.386,0.273,0.341,17.613,14,riffle_perfect
0,26,14,5,45,0.578,31,0.689,3,2,0.6,3,3,27,18,16,12,17,0.356,0.267,0.378,17.632,15,riffle_perfect
0,10,32,4,46,0.217,14,0.304,2,1,0.667,1,6,31,15,7,14,25,0.152,0.304,0.543,17.659,16,riffle_perfect
0,27,18,2,47,0.574,29,0.617,5,3,0.625,2,0,25,22,15,15,17,0.319,0.319,0.362,17.628,17,riffle_perfect
0,22,23,0,45,0.489,22,0.489,0,2,0.0,2,3,24,21,14,13,18,0.311,0.289,0.4,17.598,18,riffle_perfect
0,19,22,3,44,0.432,22,0.5,6,3,0.667,0,2,30,14,11,9,24,0.25,0.205,0.545,17.626,19,riffle_perfect
0,18,23,4,45,0.4,22,0.489,4,3,0.571,2,6,35,10,6,10,29,0.133,0.222,0.644,17.623,20,riffle_perfect
0,18,26,1,45,0.4,19,0.422,4,2,0.667,0,3,25,20,12,13,20,0.267,0.289,0.444,17.599,21,riffle_perfect
0,14,27,5,46,0.304,19,0.413,5,5,0.5,2,1,26,20,5,19,22,0.109,0.413,0.478,17.635,22,riffle_perfect
0,15,29,0,44,0.341,15,0.341,3,1,0.75,0,3,27,17,9,15,20,0.205,0.341,0.455,17.658,23,riffle_perfect
0,21,18,5,44,0.477,26,0.591,0,0,0,0,1,36,8,12,10,22,0.273,0.227,0.5,17.657,24,riffle_perfect
0,16,27,5,48,0.333,21,0.438,4,2,0.667,3,2,33,15,10,15,23,0.208,0.312,0.479,17.656,25,riffle_perfect
0,19,21,5,45,0.422,24,0.533,5,1,0.833,3,2,24,21,10,19,16,0.222,0.422,0.356,17.667,26,riffle_perfect
0,29,19,4,52,0.558,33,0.635,7,5,0.583,3,2,27,25,20,15,17,0.385,0.288,0.327,17.663,27,riffle_perfect
0,19,24,3,46,0.413,22,0.478,3,5,0.375,1,3,30,16,8,18,20,0.174,0.391,0.435,17.679,28,riffle_perfect
0,19,19,5,43,0.442,24,0.558,2,2,0.5,1,2,25,18,10,16,17,0.233,0.372,0.395,17.685,29,riffle_perfect
0,25,21,1,47,0.532,26,0.553,4,1,0.8,4,3,29,18,12,10,25,0.255,0.213,0.532,17.656,30,riffle_perfect
0,29,15,3,47,0.617,32,0.681,6,1,0.857,3,3,28,19,14,14,19,0.298,0.298,0.404,17.667,31,riffle_perfect
0,15,25,6,46,0.326,21,0.457,5,2,0.714,1,2,33,13,9,11,26,0.196,0.239,0.565,17.682,32,riffle_perfect
0,15,26,2,43,0.349,17,0.395,2,0,1.0,0,3,25,18,9,17,17,0.209,0.395,0.395,17.678,33,riffle_perfect
0,18,23,1,42,0.429,19,0.452,3,0,1.0,1,0,23,19,11,16,15,0.262,0.381,0.357,17.677,34,riffle_perfect
0,23,18,3,44,0.523,26,0.591,4,2,0.667,3,2,27,17,14,10,20,0.318,0.227,0.455,17.68,35,riffle_perfect
0,21,24,4,49,0.429,25,0.51,2,2,0.5,2,2,25,24,12,17,20,0.245,0.347,0.408,17.698,36,riffle_perfect
0,27,19,3,49,0.551,30,0.612,2,2,0.5,3,3,30,19,13,14,22,0.265,0.286,0.449,17.69,37,riffle_perfect
0,24,21,4,49,0.49,28,0.571,2,4,0.333,1,0,15,34,18,17,14,0.367,0.347,0.286,17.679,38,riffle_perfect
0,24,20,4,48,0.5,28,0.583,4,3,0.571,4,4,26,22,10,13,25,0.208,0.271,0.521,17.69,39,riffle_perfect
0,22,20,3,45,0.489,25,0.556,2,1,0.667,5,2,29,16,9,12,24,0.2,0.267,0.533,17.651,40,riffle_perfect
0,24,19,2,45,0.533,26,0.578,2,0,1.0,5,2,29,16,9,12,24,0.2,0.267,0.533,17.648,41,riffle_perfect
0,20,20,6,46,0.435,26,0.565,4,1,0.8,1,5,27,19,15,10,21,0.326,0.217,0.457,17.653,42,riffle_perfect
0,15,24,4,43,0.349,19,0.442,2,1,0.667,1,6,34,9,9,7,27,0.209,0.163,0.628,17.65,43,riffle_perfect
0,18,25,2,45,0.4,20,0.444,3,5,0.375,3,4,30,15,9,11,25,0.2,0.244,0.556,17.653,44,riffle_perfect
0,24,18,3,45,0.533,27,0.6,3,3,0.5,3,1,22,23,13,16,16,0.289,0.356,0.356,17.639,45,riffle_perfect
0,22,22,3,47,0.468,25,0.532,2,5,0.286,3,3,27,20,11,14,22,0.234,0.298,0.468,17.633,46,riffle_perfect
0,20,25,5,50,0.4,25,0.5,4,2,0.667,1,4,27,23,10,16,24,0.2,0.32,0.48,17.633,47,riffle_perfect
0,21,25,1,47,0.447,22,0.468,5,1,0.833,1,4,29,18,9,10,28,0.191,0.213,0.596,17.624,48,riffle_perfect
0,19,19,8,46,0.413,27,0.587,1,2,0.333,1,2,26,20,9,18,19,0.196,0.391,0.413,17.632,49,riffle_perfect
0,18,25,3,46,0.391,21,0.457,3,1,0.75,2,2,28,18,11,14,21,0.239,0.304,0.457,17.615,50,riffle_perfect
0,18,21,8,47,0.383,26,0.553,1,1,0.5,4,4,30,17,10,13,24,0.213,0.277,0.511,17.613,51,riffle_perfect
0,18,25,5,48,0.375,23,0.479,1,2,0.333,1,4,27,21,10,18,20,0.208,0.375,0.417,17.631,52,riffle_perfect
0,18,24,3,45,0.4,21,0.467,2,4,0.333,1,1,28,17,9,16,20,0.2,0.356,0.444,17.639,53,riffle_perfect
0,19,23,1,43,0.442,20,0.465,2,1,0.667,1,1,30,13,8,13,22,0.186,0.302,0.512,17.634,54,riffle_perfect
0,21,23,2,46,0.457,23,0.5,7,1,0.875,4,3,28,18,8,14,24,0.174,0.304,0.522,17.632,55,riffle_perfect
0,21,23,1,45,0.467,22,0.489,2,2,0.5,4,2,30,15,11,12,22,0.244,0.267,0.489,17.625,56,riffle_perfect
0,20,22,1,43,0.465,21,0.488,1,2,0.333,1,1,25,18,9,15,19,0.209,0.349,0.442,17.621,57,riffle_perfect
0,17,25,5,47,0.362,22,0.468,4,0,1.0,1,3,31,16,11,13,23,0.234,0.277,0.489,17.63,58,riffle_perfect
0,23,20,4,47,0.489,27,0.574,4,2,0.667,2,3,31,16,9,16,22,0.191,0.34,0.468,17.629,59,riffle_perfect
0,21,20,4,45,0.467,25,0.556,3,4,0.429,1,1,30,15,10,19,16,0.222,0.422,0.356,17.636,60,riffle_perfect
0,17,20,6,43,0.395,23,0.535,2,4,0.333,1,1,20,23,10,18,15,0.233,0.419,0.349,17.646,61,riffle_perfect
0,21,20,4,45,0.467,25,0.556,3,2,0.6,1,2,27,18,14,13,18,0.311,0.289,0.4,17.637,62,riffle_perfect
0,16,25,6,47,0.34,22,0.468,3,3,0.5,1,3,35,12,11,14,22,0.234,0.298,0.468,17.644,63,riffle_perfect
0,26,21,2,49,0.531,28,0.571,3,3,0.5,4,1,27,22,13,15,21,0.265,0.306,0.429,17.644,64,riffle_perfect
0,15,25,4,44,0.341,19,0.432,4,3,0.571,1,2,29,15,5,18,21,0.114,0.409,0.477,17.64,65,riffle_perfect
0,18,27,2,47,0.383,20,0.426,1,2,0.333,2,1,30,17,11,13,23,0.234,0.277,0.489,17.637,66,riffle_perfect
0,18,26,1,45,0.4,19,0.422,3,3,0.5,1,2,26,19,11,21,13,0.244,0.467,0.289,17.641,67,riffle_perfect
0,18,20,5,43,0.419,23,0.535,0,5,0.0,1,0,23,20,10,14,19,0.233,0.326,0.442,17.65,68,riffle_perfect
0,21,22,2,45,0.467,23,0.511,2,3,0.4,4,2,27,18,10,14,21,0.222,0.311,0.467,17.649,69,riffle_perfect
0,19,20,6,45,0.422,25,0.556,3,2,0.6,4,3,24,21,9,15,21,0.2,0.333,0.467,17.652,70,riffle_perfect
0,24,19,1,44,0.545,25,0.568,5,3,0.625,4,1,22,22,12,10,22,0.273,0.227,0.5,17.65,71,riffle_perfect
0,18,24,2,44,0.409,20,0.455,2,3,0.4,2,0,29,15,11,13,20,0.25,0.295,0.455,17.65,72,riffle_perfect
0,15,25,4,44,0.341,19,0.432,4,4,0.5,0,1,25,19,9,17,18,0.205,0.386,0.409,17.659,73,riffle_perfect
0,24,16,4,44,0.545,28,0.636,2,3,0.4,1,1,20,24,15,16,13,0.341,0.364,0.295,17.658,74,riffle_perfect
0,20,24,2,46,0.435,22,0.478,4,4,0.5,1,6,30,16,11,13,22,0.239,0.283,0.478,17.663,75,riffle_perfect
0,22,19,5,46,0.478,27,0.587,3,1,0.75,3,4,29,17,10,14,22,0.217,0.304,0.478,17.666,76,riffle_perfect
0,24,19,0,43,0.558,24,0.558,3,1,0.75,3,2,22,21,16,8,19,0.372,0.186,0.442,17.67,77,riffle_perfect
0,23,17,6,46,0.5,29,0.63,2,0,1.0,3,2,30,16,13,14,19,0.283,0.304,0.413,17.672,78,riffle_perfect
0,20,19,3,42,0.476,23,0.548,2,1,0.667,1,0,35,7,10,14,18,0.238,0.333,0.429,17.677,79,riffle_perfect
0,16,25,4,45,0.356,20,0.444,2,1,0.667,2,2,29,16,3,20,22,0.067,0.444,0.489,17.683,80,riffle_perfect
0,15,26,3,44,0.341,18,0.409,1,3,0.25,3,1,23,21,7,21,16,0.159,0.477,0.364,17.677,81,riffle_perfect
0,24,22,2,48,0.5,26,0.542,3,3,0.5,3,2,28,20,13,12,23,0.271,0.25,0.479,17.669,82,riffle_perfect
0,23,20,2,45,0.511,25,0.556,4,3,0.571,1,1,29,16,12,14,19,0.267,0.311,0.422,17.678,83,riffle_perfect
0,20,19,4,43,0.465,24,0.558,1,1,0.5,2,0,31,12,14,7,22,0.326,0.163,0.512,17.681,84,riffle_perfect
0,18,27,3,48,0.375,21,0.438,5,6,0.455,3,3,27,21,9,16,23,0.188,0.333,0.479,17.685,85,riffle_perfect
0,20,23,2,45,0.444,22,0.489,2,1,0.667,2,2,24,21,12,14,19,0.267,0.311,0.422,17.681,86,riffle_perfect
0,20,19,8,47,0.426,28,0.596,2,0,1.0,1,5,31,16,11,12,24,0.234,0.255,0.511,17.675,87,riffle_perfect
0,18,18,8,44,0.409,26,0.591,3,1,0.75,3,3,24,20,13,13,18,0.295,0.295,0.409,17.673,88,riffle_perfect
0,22,19,3,44,0.5,25,0.568,5,2,0.714,3,0,22,22,11,17,16,0.25,0.386,0.364,17.673,89,riffle_perfect
0,20,22,4,46,0.435,24,0.522,2,1,0.667,1,2,30,16,9,15,22,0.196,0.326,0.478,17.679,90,riffle_perfect
0,21,20,3,44,0.477,24,0.545,5,1,0.833,1,2,26,18,14,15,15,0.318,0.341,0.341,17.683,91,riffle_perfect
0,17,31,3,51,0.333,20,0.392,5,1,0.833,1,5,32,19,11,18,22,0.216,0.353,0.431,17.685,92,riffle_perfect
0,20,20,3,43,0.465,23,0.535,5,1,0.833,3,0,27,16,11,12,20,0.256,0.279,0.465,17.682,93,riffle_perfect
0,22,22,2,46,0.478,24,0.522,3,3,0.5,3,2,19,27,12,17,17,0.261,0.37,0.37,17.68,94,riffle_perfect
0,20,22,2,44,0.455,22,0.5,2,1,0.667,2,3,24,20,14,11,19,0.318,0.25,0.432,17.68,95,riffle_perfect
0,19,20,6,45,0.422,25,0.556,3,2,0.6,2,1,25,20,10,15,20,0.222,0.333,0.444,17.685,96,riffle_perfect
0,16,25,5,46,0.348,21,0.457,1,2,0.333,1,1,23,23,11,21,14,0.239,0.457,0.304,17.806,1,riffle_clumpy
0,17,27,4,48,0.354,21,0.438,3,2,0.6,2,2,34,14,8,9,31,0.167,0.188,0.646,17.492,2,riffle_clumpy
0,17,21,6,44,0.386,23,0.523,3,3,0.5,1,3,31,13,11,13,20,0.25,0.295,0.455,17.667,3,riffle_clumpy
0,16,20,8,44,0.364,24,0.545,4,3,0.571,0,1,29,15,10,12,22,0.227,0.273,0.5,17.685,4,riffle_clumpy
0,20,24,2,46,0.435,22,0.478,4,1,0.8,2,5,27,19,14,10,22,0.304,0.217,0.478,17.593,5,riffle_clumpy
0,21,23,3,47,0.447,24,0.511,6,4,0.6,1,2,25,22,11,18,18,0.234,0.383,0.383,17.528,6,riffle_clumpy
0,17,27,4,48,0.354,21,0.438,4,3,0.571,0,5,26,22,10,18,20,0.208,0.375,0.417,17.576,7,riffle_clumpy
0,19,22,5,46,0.413,24,0.522,0,4,0.0,2,1,26,20,11,14,21,0.239,0.304,0.457,17.579,8,riffle_clumpy
0,20,18,6,44,0.455,26,0.591,5,1,0.833,2,0,25,19,10,15,19,0.227,0.341,0.432,17.614,9,riffle_clumpy
0,24,21,2,47,0.511,26,0.553,3,5,0.375,1,1,25,22,15,12,20,0.319,0.255,0.426,17.605,10,riffle_clumpy
0,13,31,3,47,0.277,16,0.34,3,3,0.5,2,4,29,18,5,19,23,0.106,0.404,0.489,17.694,11,riffle_clumpy
0,23,19,2,44,0.523,25,0.568,5,3,0.625,2,1,23,21,16,8,20,0.364,0.182,0.455,17.682,12,riffle_clumpy
0,16,27,3,46,0.348,19,0.413,2,2,0.5,2,5,29,17,9,13,24,0.196,0.283,0.522,17.668,13,riffle_clumpy
0,12,30,3,45,0.267,15,0.333,3,4,0.429,1,4,30,15,6,13,26,0.133,0.289,0.578,17.699,14,riffle_clumpy
0,21,16,8,45,0.467,29,0.644,3,1,0.75,3,3,32,13,10,13,22,0.222,0.289,0.489,17.698,15,riffle_clumpy
0,20,23,4,47,0.426,24,0.511,1,2,0.333,2,1,30,17,13,13,21,0.277,0.277,0.447,17.706,16,riffle_clumpy
0,14,34,1,49,0.286,15,0.306,3,6,0.333,1,5,26,23,8,16,25,0.163,0.327,0.51,17.635,17,riffle_clumpy
0,15,29,1,45,0.333,16,0.356,1,2,0.333,2,3,29,16,9,11,25,0.2,0.244,0.556,17.604,18,riffle_clumpy
0,23,19,4,46,0.5,27,0.587,3,1,0.75,2,4,28,18,15,11,20,0.326,0.239,0.435,17.574,19,riffle_clumpy
0,19,23,4,46,0.413,23,0.5,4,1,0.8,2,3,28,18,6,18,22,0.13,0.391,0.478,17.58,20,riffle_clumpy
0,17,20,6,43,0.395,23,0.535,2,1,0.667,1,0,28,15,11,14,18,0.256,0.326,0.419,17.63,21,riffle_clumpy
0,20,17,7,44,0.455,27,0.614,4,1,0.8,1,2,30,14,10,14,20,0.227,0.318,0.455,17.666,22,riffle_clumpy
0,23,15,6,44,0.523,29,0.659,4,2,0.667,2,2,24,20,15,11,18,0.341,0.25,0.409,17.677,23,riffle_clumpy
0,19,24,4,47,0.404,23,0.489,3,1,0.75,1,5,31,16,14,10,23,0.298,0.213,0.489,17.664,24,riffle_clumpy
0,19,20,6,45,0.422,25,0.556,2,1,0.667,0,1,28,17,12,15,18,0.267,0.333,0.4,17.68,25,riffle_clumpy
0,22,21,2,45,0.489,24,0.533,4,3,0.571,0,3,26,19,11,17,17,0.244,0.378,0.378,17.687,26,riffle_clumpy
0,22,18,4,44,0.5,26,0.591,5,0,1.0,2,2,25,19,9,14,21,0.205,0.318,0.477,17.697,27,riffle_clumpy
0,20,24,4,48,0.417,24,0.5,3,2,0.6,3,3,29,19,8,15,25,0.167,0.312,0.521,17.697,28,riffle_clumpy
0,12,29,4,45,0.267,16,0.356,2,1,0.667,3,5,27,18,3,21,21,0.067,0.467,0.467,17.719,29,riffle_clumpy
0,21,18,5,44,0.477,26,0.591,1,1,0.5,4,1,23,21,11,13,20,0.25,0.295,0.455,17.696,30,riffle_clumpy
0,17,23,4,44,0.386,21,0.477,2,2,0.5,0,2,30,14,12,14,18,0.273,0.318,0.409,17.692,31,riffle_clumpy
0,19,23,1,43,0.442,20,0.465,2,3,0.4,1,2,28,15,9,15,19,0.209,0.349,0.442,17.714,32,riffle_clumpy
0,16,27,2,45,0.356,18,0.4,1,3,0.25,1,2,34,11,6,9,30,0.133,0.2,0.667,17.709,33,riffle_clumpy
0,17,25,2,44,0.386,19,0.432,5,1,0.833,2,2,25,19,10,18,16,0.227,0.409,0.364,17.705,34,riffle_clumpy
0,14,24,6,44,0.318,20,0.455,2,1,0.667,1,1,29,15,7,15,22,0.159,0.341,0.5,17.707,35,riffle_clumpy
0,21,21,4,46,0.457,25,0.543,1,3,0.25,4,2,27,19,8,15,23,0.174,0.326,0.5,17.69,36,riffle_clumpy
0,20,20,6,46,0.435,26,0.565,3,3,0.5,0,2,24,22,13,19,14,0.283,0.413,0.304,17.696,37,riffle_clumpy
0,20,22,2,44,0.455,22,0.5,3,2,0.6,3,1,28,16,8,14,22,0.182,0.318,0.5,17.689,38,riffle_clumpy
0,16,24,4,44,0.364,20,0.455,3,3,0.5,2,3,27,17,7,15,22,0.159,0.341,0.5,17.686,39,riffle_clumpy
0,19,19,5,43,0.442,24,0.558,3,5,0.375,2,1,27,16,11,9,23,0.256,0.209,0.535,17.683,40,riffle_clumpy
0,21,21,4,46,0.457,25,0.543,1,3,0.25,1,1,28,18,9,12,25,0.196,0.261,0.543,17.682,41,riffle_clumpy
0,12,32,7,51,0.235,19,0.373,0,5,0.0,1,2,30,21,3,21,27,0.059,0.412,0.529,17.679,42,riffle_clumpy
0,19,24,4,47,0.404,23,0.489,3,2,0.6,2,1,26,21,6,20,21,0.128,0.426,0.447,17.68,43,riffle_clumpy
0,17,24,6,47,0.362,23,0.489,6,2,0.75,2,5,33,14,11,13,23,0.234,0.277,0.489,17.693,44,riffle_clumpy
0,21,20,6,47,0.447,27,0.574,1,3,0.25,4,2,30,17,8,22,17,0.17,0.468,0.362,17.695,45,riffle_clumpy
0,20,24,1,45,0.444,21,0.467,1,3,0.25,4,1,28,17,14,14,17,0.311,0.311,0.378,17.697,46,riffle_clumpy
0,27,19,2,48,0.562,29,0.604,3,3,0.5,4,2,30,18,10,12,26,0.208,0.25,0.542,17.694,47,riffle_clumpy
0,22,18,7,47,0.468,29,0.617,4,0,1.0,2,1,26,21,11,15,21,0.234,0.319,0.447,17.681,48,riffle_clumpy
0,20,21,4,45,0.444,24,0.533,5,1,0.833,3,1,27,18,12,13,20,0.267,0.289,0.444,17.673,49,riffle_clumpy
0,20,21,4,45,0.444,24,0.533,1,2,0.333,2,0,27,18,11,16,18,0.244,0.356,0.4,17.672,50,riffle_clumpy
0,24,19,3,46,0.522,27,0.587,5,4,0.556,1,3,23,23,15,13,18,0.326,0.283,0.391,17.668,51,riffle_clumpy
0,17,30,0,47,0.362,17,0.362,0,3,0.0,3,2,35,12,4,16,27,0.085,0.34,0.574,17.653,52,riffle_clumpy
0,16,27,2,45,0.356,18,0.4,4,0,1.0,3,3,30,15,7,11,27,0.156,0.244,0.6,17.649,53,riffle_clumpy
0,20,23,2,45,0.444,22,0.489,1,2,0.333,0,1,31,14,14,12,19,0.311,0.267,0.422,17.658,54,riffle_clumpy
0,18,23,5,46,0.391,23,0.5,8,2,0.8,1,4,27,19,10,17,19,0.217,0.37,0.413,17.65,55,riffle_clumpy
0,27,13,3,43,0.628,30,0.698,5,2,0.714,2,3,25,18,18,9,16,0.419,0.209,0.372,17.647,56,riffle_clumpy
0,19,25,2,46,0.413,21,0.457,3,1,0.75,3,2,25,21,10,17,19,0.217,0.37,0.413,17.642,57,riffle_clumpy
0,23,19,4,46,0.5,27,0.587,1,2,0.333,2,0,26,20,12,16,18,0.261,0.348,0.391,17.642,58,riffle_clumpy
0,14,24,6,44,0.318,20,0.455,3,3,0.5,2,3,23,21,10,18,16,0.227,0.409,0.364,17.64,59,riffle_clumpy
0,18,21,6,45,0.4,24,0.533,0,2,0.0,2,2,29,16,7,16,22,0.156,0.356,0.489,17.634,60,riffle_clumpy
0,20,19,6,45,0.444,26,0.578,2,2,0.5,2,2,28,17,8,17,20,0.178,0.378,0.444,17.632,61,riffle_clumpy
0,18,24,2,44,0.409,20,0.455,2,2,0.5,3,1,26,18,6,15,23,0.136,0.341,0.523,17.626,62,riffle_clumpy
0,25,20,1,46,0.543,26,0.565,4,2,0.667,4,3,23,23,15,13,18,0.326,0.283,0.391,17.621,63,riffle_clumpy
0,17,24,4,45,0.378,21,0.467,3,2,0.6,2,2,24,21,7,16,22,0.156,0.356,0.489,17.621,64,riffle_clumpy
0,14,32,3,49,0.286,17,0.347,2,4,0.333,1,2,29,20,8,18,23,0.163,0.367,0.469,17.628,65,riffle_clumpy
0,20,23,3,46,0.435,23,0.5,3,2,0.6,5,1,25,21,10,18,18,0.217,0.391,0.391,17.63,66,riffle_clumpy
0,20,19,7,46,0.435,27,0.587,2,1,0.667,1,0,21,25,12,20,14,0.261,0.435,0.304,17.628,67,riffle_clumpy
0,22,15,5,42,0.524,27,0.643,5,2,0.714,1,0,26,16,14,12,16,0.333,0.286,0.381,17.633,68,riffle_clumpy
0,17,26,2,45,0.378,19,0.422,1,2,0.333,1,1,28,17,11,10,24,0.244,0.222,0.533,17.626,69,riffle_clumpy
0,18,20,4,42,0.429,22,0.524,3,1,0.75,2,1,26,16,9,17,16,0.214,0.405,0.381,17.629,70,riffle_clumpy
0,20,23,6,49,0.408,26,0.531,6,4,0.6,2,2,33,16,12,12,25,0.245,0.245,0.51,17.64,71,riffle_clumpy
0,23,17,5,45,0.511,28,0.622,4,2,0.667,3,1,27,18,13,11,21,0.289,0.244,0.467,17.649,72,riffle_clumpy
0,25,14,4,43,0.581,29,0.674,2,3,0.4,2,1,25,18,18,14,11,0.419,0.326,0.256,17.65,73,riffle_clumpy
0,28,17,3,48,0.583,31,0.646,6,3,0.667,2,2,27,21,17,15,16,0.354,0.312,0.333,17.644,74,riffle_clumpy
0,23,17,4,44,0.523,27,0.614,2,0,1.0,4,1,25,19,11,16,17,0.25,0.364,0.386,17.646,75,riffle_clumpy
0,24,19,3,46,0.522,27,0.587,4,2,0.667,4,0,29,17,12,16,18,0.261,0.348,0.391,17.652,76,riffle_clumpy
0,21,22,2,45,0.467,23,0.511,2,4,0.333,4,1,31,14,8,13,24,0.178,0.289,0.533,17.644,77,riffle_clumpy
0,27,19,1,47,0.574,28,0.596,4,5,0.444,3,1,23,24,16,16,15,0.34,0.34,0.319,17.647,78,riffle_clumpy
0,18,24,3,45,0.4,21,0.467,2,5,0.286,1,2,30,15,11,12,22,0.244,0.267,0.489,17.645,79,riffle_clumpy
0,19,24,3,46,0.413,22,0.478,2,1,0.667,3,6,28,18,14,13,19,0.304,0.283,0.413,17.643,80,riffle_clumpy
0,24,15,6,45,0.533,30,0.667,2,3,0.4,3,2,23,22,11,17,17,0.244,0.378,0.378,17.647,81,riffle_clumpy
0,22,21,2,45,0.489,24,0.533,1,5,0.167,3,3,23,22,12,16,17,0.267,0.356,0.378,17.646,82,riffle_clumpy
0,22,21,2,45,0.489,24,0.533,2,1,0.667,3,1,27,18,9,18,18,0.2,0.4,0.4,17.645,83,riffle_clumpy
0,23,19,4,46,0.5,27,0.587,3,6,0.333,2,2,30,16,10,20,16,0.217,0.435,0.348,17.653,84,riffle_clumpy
0,18,25,3,46,0.391,21,0.457,5,2,0.714,1,1,25,21,12,20,14,0.261,0.435,0.304,17.662,85,riffle_clumpy
0,15,25,4,44,0.341,19,0.432,1,1,0.5,2,1,30,14,8,12,24,0.182,0.273,0.545,17.667,86,riffle_clumpy
0,23,19,2,44,0.523,25,0.568,3,0,1.0,3,0,27,17,15,9,20,0.341,0.205,0.455,17.673,87,riffle_clumpy
0,22,23,2,47,0.468,24,0.511,4,2,0.667,1,4,35,12,13,13,21,0.277,0.277,0.447,17.676,88,riffle_clumpy
0,18,25,3,46,0.391,21,0.457,8,1,0.889,1,1,24,22,13,18,15,0.283,0.391,0.326,17.681,89,riffle_clumpy
0,17,27,3,47,0.362,20,0.426,2,1,0.667,4,2,28,19,10,13,24,0.213,0.277,0.511,17.672,90,riffle_clumpy
0,16,23,6,45,0.356,22,0.489,2,1,0.667,0,2,24,21,13,14,18,0.289,0.311,0.4,17.672,91,riffle_clumpy
0,20,22,3,45,0.444,23,0.511,3,3,0.5,3,1,29,16,9,16,20,0.2,0.356,0.444,17.671,92,riffle_clumpy
0,13,28,4,45,0.289,17,0.378,1,0,1.0,1,4,27,18,5,19,21,0.111,0.422,0.467,17.671,93,riffle_clumpy
0,18,24,2,44,0.409,20,0.455,0,3,0.0,3,3,27,17,8,14,22,0.182,0.318,0.5,17.676,94,riffle_clumpy
0,21,20,3,44,0.477,24,0.545,1,0,1.0,0,2,26,18,14,12,18,0.318,0.273,0.409,17.678,95,riffle_clumpy
0,18,23,7,48,0.375,25,0.521,4,1,0.8,1,2,25,23,12,15,21,0.25,0.312,0.438,17.682,96,riffle_clumpy
0,20,19,5,44,0.455,25,0.568,2,5,0.286,0,2,28,16,11,14,19,0.25,0.318,0.432,18.1,1,riffle_clumpy
0,19,24,3,46,0.413,22,0.478,3,5,0.375,3,6,30,16,11,13,22,0.239,0.283,0.478,17.554,2,riffle_clumpy
0,22,19,3,44,0.5,25,0.568,1,3,0.25,4,0,27,17,10,16,18,0.227,0.364,0.409,17.598,3,riffle_clumpy
0,17,26,2,45,0.378,19,0.422,6,3,0.667,3,2,28,17,9,12,24,0.2,0.267,0.533,17.735,4,riffle_clumpy
0,18,26,4,48,0.375,22,0.458,4,4,0.5,1,4,30,18,10,16,22,0.208,0.333,0.458,17.75,5,riffle_clumpy
0,20,21,3,44,0.455,23,0.523,3,1,0.75,1,4,33,11,9,10,25,0.205,0.227,0.568,17.676,6,riffle_clumpy
0,23,20,2,45,0.511,25,0.556,3,0,1.0,5,1,22,23,10,14,21,0.222,0.311,0.467,17.552,7,riffle_clumpy
0,17,20,6,43,0.395,23,0.535,2,3,0.4,0,0,23,20,14,15,14,0.326,0.349,0.326,17.639,8,riffle_clumpy
0,26,15,5,46,0.565,31,0.674,1,1,0.5,3,1,27,19,10,20,16,0.217,0.435,0.348,17.653,9,riffle_clumpy
0,16,22,5,43,0.372,21,0.488,3,4,0.429,2,1,28,15,7,16,20,0.163,0.372,0.465,17.701,10,riffle_clumpy
0,21,18,6,45,0.467,27,0.6,3,1,0.75,3,3,27,18,10,13,22,0.222,0.289,0.489,17.655,11,riffle_clumpy
0,17,23,3,43,0.395,20,0.465,3,4,0.429,1,3,24,19,9,22,12,0.209,0.512,0.279,17.733,12,riffle_clumpy
0,20,16,9,45,0.444,29,0.644,2,1,0.667,4,0,22,23,7,19,19,0.156,0.422,0.422,17.734,13,riffle_clumpy
0,24,20,3,47,0.511,27,0.574,2,1,0.667,2,3,28,19,12,12,23,0.255,0.255,0.489,17.653,14,riffle_clumpy
0,24,16,5,45,0.533,29,0.644,6,0,1.0,4,1,26,19,17,10,18,0.378,0.222,0.4,17.651,15,riffle_clumpy
0,17,21,5,43,0.395,22,0.512,2,3,0.4,3,2,21,22,11,13,19,0.256,0.302,0.442,17.59,16,riffle_clumpy
0,18,19,5,42,0.429,23,0.548,1,1,0.5,1,1,26,16,11,11,20,0.262,0.262,0.476,17.633,17,riffle_clumpy
0,21,20,3,44,0.477,24,0.545,3,6,0.333,3,3,25,19,15,12,17,0.341,0.273,0.386,17.619,18,riffle_clumpy
0,24,16,3,43,0.558,27,0.628,2,1,0.667,1,1,26,17,16,10,17,0.372,0.233,0.395,17.593,19,riffle_clumpy
0,16,24,5,45,0.356,21,0.467,3,2,0.6,2,3,26,19,7,14,24,0.156,0.311,0.533,17.596,20,riffle_clumpy
0,24,15,4,43,0.558,28,0.651,1,1,0.5,2,1,26,17,16,12,15,0.372,0.279,0.349,17.596,21,riffle_clumpy
0,22,20,1,43,0.512,23,0.535,4,2,0.667,1,0,24,19,10,19,14,0.233,0.442,0.326,17.626,22,riffle_clumpy
0,22,21,2,45,0.489,24,0.533,6,3,0.667,1,1,29,16,11,14,20,0.244,0.311,0.444,17.648,23,riffle_clumpy
0,16,30,1,47,0.34,17,0.362,3,0,1.0,2,3,27,20,11,15,21,0.234,0.319,0.447,17.635,24,riffle_clumpy
0,20,19,5,44,0.455,25,0.568,3,1,0.75,3,1,28,16,11,13,20,0.25,0.295,0.455,17.632,25,riffle_clumpy
0,21,21,9,51,0.412,30,0.588,2,2,0.5,3,2,32,19,10,19,22,0.196,0.373,0.431,17.663,26,riffle_clumpy
0,19,23,3,45,0.422,22,0.489,3,2,0.6,2,1,23,22,10,17,18,0.222,0.378,0.4,17.66,27,riffle_clumpy
0,18,25,4,47,0.383,22,0.468,3,1,0.75,0,3,30,17,9,15,23,0.191,0.319,0.489,17.67,28,riffle_clumpy
0,17,26,6,49,0.347,23,0.469,4,3,0.571,2,5,33,16,6,17,26,0.122,0.347,0.531,17.684,29,riffle_clumpy
0,20,24,4,48,0.417,24,0.5,1,3,0.25,2,3,26,22,10,15,23,0.208,0.312,0.479,17.667,30,riffle_clumpy
0,28,16,5,49,0.571,33,0.673,2,3,0.4,1,1,25,24,18,13,18,0.367,0.265,0.367,17.677,31,riffle_clumpy
0,17,27,0,44,0.386,17,0.386,4,3,0.571,1,2,28,16,9,15,20,0.205,0.341,0.455,17.682,32,riffle_clumpy
0,15,24,6,45,0.333,21,0.467,5,2,0.714,2,3,27,18,12,16,17,0.267,0.356,0.378,17.687,33,riffle_clumpy
0,13,31,4,48,0.271,17,0.354,4,6,0.4,1,5,30,18,8,18,22,0.167,0.375,0.458,17.688,34,riffle_clumpy
0,18,24,3,45,0.4,21,0.467,2,2,0.5,1,4,28,17,12,13,20,0.267,0.289,0.444,17.689,35,riffle_clumpy
0,21,21,4,46,0.457,25,0.543,3,5,0.375,3,2,29,17,9,14,23,0.196,0.304,0.5,17.701,36,riffle_clumpy
0,17,24,3,44,0.386,20,0.455,1,4,0.2,2,1,29,15,8,11,25,0.182,0.25,0.568,17.697,37,riffle_clumpy
0,17,30,1,48,0.354,18,0.375,3,3,0.5,0,5,32,16,7,19,22,0.146,0.396,0.458,17.694,38,riffle_clumpy
0,16,23,6,45,0.356,22,0.489,0,2,0.0,2,3,24,21,11,18,16,0.244,0.4,0.356,17.704,39,riffle_clumpy
0,24,20,4,48,0.5,28,0.583,2,2,0.5,4,4,28,20,14,14,20,0.292,0.292,0.417,17.694,40,riffle_clumpy
0,22,17,6,45,0.489,28,0.622,2,3,0.4,6,2,27,18,7,11,27,0.156,0.244,0.6,17.684,41,riffle_clumpy
0,19,18,6,43,0.442,25,0.581,2,2,0.5,1,2,26,17,13,14,16,0.302,0.326,0.372,17.696,42,riffle_clumpy
0,19,20,5,44,0.432,24,0.545,4,5,0.444,5,2,25,19,8,19,17,0.182,0.432,0.386,17.679,43,riffle_clumpy
0,21,20,4,45,0.467,25,0.556,5,1,0.833,1,1,28,17,10,14,21,0.222,0.311,0.467,17.679,44,riffle_clumpy
0,18,21,8,47,0.383,26,0.553,3,2,0.6,4,1,28,19,8,16,23,0.17,0.34,0.489,17.662,45,riffle_clumpy
0,25,13,5,43,0.581,30,0.698,4,1,0.8,0,1,25,18,16,7,20,0.372,0.163,0.465,17.66,46,riffle_clumpy
0,26,15,3,44,0.591,29,0.659,5,2,0.714,4,2,25,19,14,9,21,0.318,0.205,0.477,17.665,47,riffle_clumpy
0,22,21,5,48,0.458,27,0.562,6,3,0.667,3,1,31,17,16,12,20,0.333,0.25,0.417,17.674,48,riffle_clumpy
0,15,28,2,45,0.333,17,0.378,2,3,0.4,2,4,23,22,7,21,17,0.156,0.467,0.378,17.702,49,riffle_clumpy
0,14,26,4,44,0.318,18,0.409,2,4,0.333,3,2,28,16,6,13,25,0.136,0.295,0.568,17.697,50,riffle_clumpy
0,14,28,2,44,0.318,16,0.364,3,4,0.429,1,1,28,16,8,18,18,0.182,0.409,0.409,17.702,51,riffle_clumpy
0,23,18,3,44,0.523,26,0.591,1,5,0.167,3,2,28,16,15,13,16,0.341,0.295,0.364,17.699,52,riffle_clumpy
0,15,27,4,46,0.326,19,0.413,3,2,0.6,2,2,25,21,10,15,21,0.217,0.326,0.457,17.71,53,riffle_clumpy
0,18,23,4,45,0.4,22,0.489,1,2,0.333,2,2,27,18,11,14,20,0.244,0.311,0.444,17.713,54,riffle_clumpy
0,22,22,3,47,0.468,25,0.532,4,3,0.571,0,4,25,22,16,15,16,0.34,0.319,0.34,17.725,55,riffle_clumpy
0,20,20,4,44,0.455,24,0.545,3,0,1.0,1,2,27,17,8,16,20,0.182,0.364,0.455,17.724,56,riffle_clumpy
0,21,22,3,46,0.457,24,0.522,1,1,0.5,1,2,28,18,9,18,19,0.196,0.391,0.413,17.733,57,riffle_clumpy
0,17,25,5,47,0.362,22,0.468,4,1,0.8,3,3,32,15,8,14,25,0.17,0.298,0.532,17.737,58,riffle_clumpy
0,15,26,5,46,0.326,20,0.435,0,3,0.0,2,2,24,22,11,21,14,0.239,0.457,0.304,17.734,59,riffle_clumpy
0,21,18,5,44,0.477,26,0.591,3,0,1.0,2,1,29,15,13,10,21,0.295,0.227,0.477,17.737,60,riffle_clumpy
0,22,17,6,45,0.489,28,0.622,4,4,0.5,3,0,22,23,12,14,19,0.267,0.311,0.422,17.732,61,riffle_clumpy
0,21,23,3,47,0.447,24,0.511,2,3,0.4,2,1,28,19,12,19,16,0.255,0.404,0.34,17.726,62,riffle_clumpy
0,20,22,3,45,0.444,23,0.511,0,1,0.0,1,0,23,22,12,15,18,0.267,0.333,0.4,17.734,63,riffle_clumpy
0,16,26,3,45,0.356,19,0.422,4,3,0.571,1,3,29,16,8,17,20,0.178,0.378,0.444,17.75,64,riffle_clumpy
0,25,18,0,43,0.581,25,0.581,3,1,0.75,0,2,26,17,12,11,20,0.279,0.256,0.465,17.754,65,riffle_clumpy
0,19,21,4,44,0.432,23,0.523,3,1,0.75,2,0,25,19,12,18,14,0.273,0.409,0.318,17.763,66,riffle_clumpy
0,19,19,5,43,0.442,24,0.558,2,0,1.0,1,1,29,14,10,15,18,0.233,0.349,0.419,17.777,67,riffle_clumpy
0,18,21,6,45,0.4,24,0.533,3,3,0.5,1,2,26,19,10,17,18,0.222,0.378,0.4,17.778,68,riffle_clumpy
0,28,17,0,45,0.622,28,0.622,3,2,0.6,1,0,23,22,16,12,17,0.356,0.267,0.378,17.777,69,riffle_clumpy
0,22,19,5,46,0.478,27,0.587,2,5,0.286,2,1,27,19,10,12,24,0.217,0.261,0.522,17.767,70,riffle_clumpy
0,18,21,5,44,0.409,23,0.523,2,1,0.667,2,2,27,17,12,11,21,0.273,0.25,0.477,17.759,71,riffle_clumpy
0,25,17,3,45,0.556,28,0.622,6,0,1.0,2,3,27,18,13,13,19,0.289,0.289,0.422,17.756,72,riffle_clumpy
0,21,19,6,46,0.457,27,0.587,2,2,0.5,3,1,23,23,14,13,19,0.304,0.283,0.413,17.741,73,riffle_clumpy
0,21,19,6,46,0.457,27,0.587,2,1,0.667,0,3,28,18,13,16,17,0.283,0.348,0.37,17.74,74,riffle_clumpy
0,20,16,9,45,0.444,29,0.644,4,0,1.0,3,0,27,18,12,15,18,0.267,0.333,0.4,17.742,75,riffle_clumpy
0,18,31,1,50,0.36,19,0.38,6,3,0.667,2,4,30,20,11,15,24,0.22,0.3,0.48,17.74,76,riffle_clumpy
0,22,19,4,45,0.489,26,0.578,7,2,0.778,1,3,29,16,12,11,22,0.267,0.244,0.489,17.74,77,riffle_clumpy
0,20,24,4,48,0.417,24,0.5,2,1,0.667,2,4,30,18,14,13,21,0.292,0.271,0.438,17.745,78,riffle_clumpy
0,14,28,6,48,0.292,20,0.417,3,5,0.375,4,1,30,18,6,14,28,0.125,0.292,0.583,17.74,79,riffle_clumpy
0,22,21,4,47,0.468,26,0.553,5,4,0.556,1,2,26,21,9,22,16,0.191,0.468,0.34,17.752,80,riffle_clumpy
0,20,21,3,44,0.455,23,0.523,3,1,0.75,3,2,24,20,10,16,18,0.227,0.364,0.409,17.745,81,riffle_clumpy
0,25,18,3,46,0.543,28,0.609,7,1,0.875,1,2,25,21,19,10,17,0.413,0.217,0.37,17.747,82,riffle_clumpy
0,17,22,4,43,0.395,21,0.488,8,2,0.8,0,2,26,17,10,11,22,0.233,0.256,0.512,17.757,83,riffle_clumpy
0,16,31,2,49,0.327,18,0.367,0,5,0.0,0,5,30,19,9,17,23,0.184,0.347,0.469,17.764,84,riffle_clumpy
0,23,16,6,45,0.511,29,0.644,4,1,0.8,1,1,26,19,15,10,20,0.333,0.222,0.444,17.763,85,riffle_clumpy
0,18,26,3,47,0.383,21,0.447,1,4,0.2,2,7,34,13,9,11,27,0.191,0.234,0.574,17.757,86,riffle_clumpy
0,23,21,2,46,0.5,25,0.543,4,4,0.5,5,3,24,22,13,13,20,0.283,0.283,0.435,17.751,87,riffle_clumpy
0,20,24,3,47,0.426,23,0.489,3,9,0.25,3,0,29,18,7,17,23,0.149,0.362,0.489,17.748,88,riffle_clumpy
0,17,23,4,44,0.386,21,0.477,3,3,0.5,3,1,30,14,8,15,21,0.182,0.341,0.477,17.743,89,riffle_clumpy
0,18,17,9,44,0.409,27,0.614,3,2,0.6,2,1,29,15,11,11,22,0.25,0.25,0.5,17.739,90,riffle_clumpy
0,16,21,6,43,0.372,22,0.512,1,2,0.333,1,1,30,13,11,10,22,0.256,0.233,0.512,17.738,91,riffle_clumpy
0,18,19,6,43,0.419,24,0.558,0,1,0.0,2,0,28,15,10,13,20,0.233,0.302,0.465,17.738,92,riffle_clumpy
0,18,25,1,44,0.409,19,0.432,5,1,0.833,1,2,26,18,11,16,17,0.25,0.364,0.386,17.73,93,riffle_clumpy
0,23,17,5,45,0.511,28,0.622,3,1,0.75,4,4,24,21,11,15,19,0.244,0.333,0.422,17.727,94,riffle_clumpy
0,16,25,5,46,0.348,21,0.457,1,0,1.0,0,1,28,18,10,18,18,0.217,0.391,0.391,17.732,95,riffle_clumpy
0,18,23,6,47,0.383,24,0.511,4,5,0.444,3,4,34,13,7,13,27,0.149,0.277,0.574,17.724,96,riffle_clumpy
0,23,18,5,46,0.5,28,0.609,6,2,0.75,5,0,27,19,13,14,19,0.283,0.304,0.413,16.75,1,riffle_clumpy
0,26,18,3,47,0.553,29,0.617,5,2,0.714,4,0,30,17,13,15,19,0.277,0.319,0.404,17.138,2,riffle_clumpy
0,16,27,3,46,0.348,19,0.413,2,6,0.25,3,1,33,13,8,14,24,0.174,0.304,0.522,17.467,3,riffle_clumpy
0,20,18,5,43,0.465,25,0.581,2,1,0.667,3,1,25,18,11,15,17,0.256,0.349,0.395,17.487,4,riffle_clumpy
0,26,16,3,45,0.578,29,0.644,3,1,0.75,0,2,32,13,11,15,19,0.244,0.333,0.422,17.646,5,riffle_clumpy
0,11,30,3,44,0.25,14,0.318,1,6,0.143,2,3,27,17,7,16,21,0.159,0.364,0.477,17.601,6,riffle_clumpy
0,17,24,7,48,0.354,24,0.5,2,3,0.4,1,3,30,18,9,13,26,0.188,0.271,0.542,17.62,7,riffle_clumpy
0,22,23,1,46,0.478,23,0.5,1,2,0.333,3,0,31,15,10,13,23,0.217,0.283,0.5,17.683,8,riffle_clumpy
0,16,23,6,45,0.356,22,0.489,2,3,0.4,4,2,31,14,10,10,25,0.222,0.222,0.556,17.676,9,riffle_clumpy
0,23,19,5,47,0.489,28,0.596,3,0,1.0,0,4,34,13,12,10,25,0.255,0.213,0.532,17.67,10,riffle_clumpy
0,15,27,3,45,0.333,18,0.4,1,1,0.5,0,1,25,20,9,13,23,0.2,0.289,0.511,17.647,11,riffle_clumpy
0,20,20,4,44,0.455,24,0.545,3,3,0.5,1,0,26,18,7,11,26,0.159,0.25,0.591,17.659,12,riffle_clumpy
0,21,21,3,45,0.467,24,0.533,4,3,0.571,2,4,27,18,11,14,20,0.244,0.311,0.444,17.655,13,riffle_clumpy
0,20,20,5,45,0.444,25,0.556,4,2,0.667,4,1,22,23,12,17,16,0.267,0.378,0.356,17.652,14,riffle_clumpy
0,25,18,2,45,0.556,27,0.6,3,3,0.5,0,2,24,21,11,18,16,0.244,0.4,0.356,17.667,15,riffle_clumpy
0,25,18,3,46,0.543,28,0.609,2,1,0.667,1,4,26,20,16,11,19,0.348,0.239,0.413,17.682,16,riffle_clumpy
0,18,22,5,45,0.4,23,0.511,4,1,0.8,3,2,27,18,11,16,18,0.244,0.356,0.4,17.678,17,riffle_clumpy
0,19,21,4,44,0.432,23,0.523,1,2,0.333,2,2,29,15,9,15,20,0.205,0.341,0.455,17.728,18,riffle_clumpy
0,17,21,7,45,0.378,24,0.533,2,0,1.0,1,4,30,15,9,15,21,0.2,0.333,0.467,17.748,19,riffle_clumpy
0,21,22,3,46,0.457,24,0.522,3,3,0.5,2,2,27,19,9,16,21,0.196,0.348,0.457,17.739,20,riffle_clumpy
0,23,18,3,44,0.523,26,0.591,4,1,0.8,2,3,30,14,10,16,18,0.227,0.364,0.409,17.751,21,riffle_clumpy
0,19,25,2,46,0.413,21,0.457,1,4,0.2,1,6,26,20,11,16,19,0.239,0.348,0.413,17.763,22,riffle_clumpy
0,23,21,1,45,0.511,24,0.533,4,2,0.667,3,1,28,17,14,14,17,0.311,0.311,0.378,17.771,23,riffle_clumpy
0,18,23,5,46,0.391,23,0.5,4,1,0.8,4,2,28,18,9,17,20,0.196,0.37,0.435,17.773,24,riffle_clumpy
0,26,20,2,48,0.542,28,0.583,3,2,0.6,4,1,28,20,15,12,21,0.312,0.25,0.438,17.794,25,riffle_clumpy
0,20,19,5,44,0.455,25,0.568,6,1,0.857,2,3,30,14,11,11,22,0.25,0.25,0.5,17.806,26,riffle_clumpy
0,18,28,1,47,0.383,19,0.404,1,4,0.2,1,5,30,17,13,12,22,0.277,0.255,0.468,17.799,27,riffle_clumpy
0,24,22,1,47,0.511,25,0.532,4,1,0.8,3,0,31,16,12,13,22,0.255,0.277,0.468,17.805,28,riffle_clumpy
0,24,20,3,47,0.511,27,0.574,5,1,0.833,1,3,25,22,9,20,18,0.191,0.426,0.383,17.805,29,riffle_clumpy
0,19,21,5,45,0.422,24,0.533,4,2,0.667,3,0,27,18,9,12,24,0.2,0.267,0.533,17.771,30,riffle_clumpy
0,24,17,3,44,0.545,27,0.614,2,1,0.667,2,2,23,21,15,15,14,0.341,0.341,0.318,17.768,31,riffle_clumpy
0,19,23,3,45,0.422,22,0.489,4,1,0.8,1,2,22,23,12,16,17,0.267,0.356,0.378,17.787,32,riffle_clumpy
0,19,21,3,43,0.442,22,0.512,3,3,0.5,0,1,29,14,7,15,21,0.163,0.349,0.488,17.772,33,riffle_clumpy
0,15,28,4,47,0.319,19,0.404,4,0,1.0,0,3,26,21,10,15,22,0.213,0.319,0.468,17.768,34,riffle_clumpy
0,18,25,4,47,0.383,22,0.468,4,5,0.444,2,3,17,30,11,17,19,0.234,0.362,0.404,17.757,35,riffle_clumpy
0,24,25,2,51,0.471,26,0.51,4,0,1.0,3,2,27,24,14,17,20,0.275,0.333,0.392,17.765,36,riffle_clumpy
0,16,24,4,44,0.364,20,0.455,6,1,0.857,1,3,25,19,10,11,23,0.227,0.25,0.523,17.76,37,riffle_clumpy
0,20,22,1,43,0.465,21,0.488,4,2,0.667,3,1,30,13,11,13,19,0.256,0.302,0.442,17.737,38,riffle_clumpy
0,23,20,2,45,0.511,25,0.556,3,2,0.6,2,0,28,17,12,12,21,0.267,0.267,0.467,17.733,39,riffle_clumpy
0,21,19,4,44,0.477,25,0.568,2,2,0.5,2,1,27,17,13,16,15,0.295,0.364,0.341,17.725,40,riffle_clumpy
0,15,27,4,46,0.326,19,0.413,0,2,0.0,2,3,27,19,9,15,22,0.196,0.326,0.478,17.728,41,riffle_clumpy
0,19,23,5,47,0.404,24,0.511,4,0,1.0,2,1,29,18,10,13,24,0.213,0.277,0.511,17.706,42,riffle_clumpy
0,16,22,7,45,0.356,23,0.511,2,2,0.5,0,3,28,17,11,16,18,0.244,0.356,0.4,17.709,43,riffle_clumpy
0,19,19,5,43,0.442,24,0.558,4,3,0.571,3,0,26,17,8,17,18,0.186,0.395,0.419,17.717,44,riffle_clumpy
0,19,25,4,48,0.396,23,0.479,2,3,0.4,2,3,28,20,10,14,24,0.208,0.292,0.5,17.703,45,riffle_clumpy
0,24,21,1,46,0.522,25,0.543,6,2,0.75,2,1,28,18,13,12,21,0.283,0.261,0.457,17.677,46,riffle_clumpy
0,32,13,3,48,0.667,35,0.729,6,1,0.857,4,1,25,23,18,13,17,0.375,0.271,0.354,17.673,47,riffle_clumpy
0,19,22,6,47,0.404,25,0.532,3,1,0.75,1,2,32,15,11,13,23,0.234,0.277,0.489,17.678,48,riffle_clumpy
0,19,18,6,43,0.442,25,0.581,4,0,1.0,1,1,28,15,12,13,18,0.279,0.302,0.419,17.682,49,riffle_clumpy
0,19,24,5,48,0.396,24,0.5,1,4,0.2,1,1,27,21,10,17,21,0.208,0.354,0.438,17.681,50,riffle_clumpy
0,15,27,4,46,0.326,19,0.413,2,3,0.4,1,4,22,24,8,15,23,0.174,0.326,0.5,17.67,51,riffle_clumpy
0,24,19,2,45,0.533,26,0.578,4,1,0.8,4,3,31,14,11,13,21,0.244,0.289,0.467,17.651,52,riffle_clumpy
0,22,20,4,46,0.478,26,0.565,2,1,0.667,2,2,25,21,10,20,16,0.217,0.435,0.348,17.66,53,riffle_clumpy
0,19,22,4,45,0.422,23,0.511,0,1,0.0,3,2,30,15,7,10,28,0.156,0.222,0.622,17.644,54,riffle_clumpy
0,19,19,7,45,0.422,26,0.578,3,1,0.75,1,4,27,18,12,13,20,0.267,0.289,0.444,17.645,55,riffle_clumpy
0,20,20,4,44,0.455,24,0.545,2,1,0.667,2,0,27,17,11,11,22,0.25,0.25,0.5,17.646,56,riffle_clumpy
0,17,22,8,47,0.362,25,0.532,2,1,0.667,2,5,34,13,10,10,27,0.213,0.213,0.574,17.634,57,riffle_clumpy
0,24,20,2,46,0.522,26,0.565,4,5,0.444,4,0,30,16,15,11,20,0.326,0.239,0.435,17.624,58,riffle_clumpy
0,23,22,5,50,0.46,28,0.56,5,7,0.417,4,2,29,21,13,17,20,0.26,0.34,0.4,17.621,59,riffle_clumpy
0,19,26,3,48,0.396,22,0.458,4,3,0.571,2,3,26,22,8,15,25,0.167,0.312,0.521,17.614,60,riffle_clumpy
0,19,22,4,45,0.422,23,0.511,2,2,0.5,0,0,23,22,15,13,17,0.333,0.289,0.378,17.616,61,riffle_clumpy
0,21,17,7,45,0.467,28,0.622,3,3,0.5,0,3,25,20,9,19,17,0.2,0.422,0.378,17.627,62,riffle_clumpy
0,17,23,5,45,0.378,22,0.489,2,1,0.667,0,3,28,17,12,13,20,0.267,0.289,0.444,17.631,63,riffle_clumpy
0,18,23,2,43,0.419,20,0.465,3,2,0.6,1,3,27,16,11,15,17,0.256,0.349,0.395,17.641,64,riffle_clumpy
0,19,23,3,45,0.422,22,0.489,2,1,0.667,1,2,29,16,8,13,24,0.178,0.289,0.533,17.641,65,riffle_clumpy
0,16,26,3,45,0.356,19,0.422,1,1,0.5,3,3,27,18,7,17,21,0.156,0.378,0.467,17.647,66,riffle_clumpy
0,26,19,3,48,0.542,29,0.604,7,0,1.0,4,3,25,23,15,15,18,0.312,0.312,0.375,17.645,67,riffle_clumpy
0,17,25,4,46,0.37,21,0.457,1,1,0.5,3,1,30,16,6,17,23,0.13,0.37,0.5,17.641,68,riffle_clumpy
0,18,24,2,44,0.409,20,0.455,3,4,0.429,1,2,25,19,13,15,16,0.295,0.341,0.364,17.656,69,riffle_clumpy
0,18,19,6,43,0.419,24,0.558,5,2,0.714,1,2,27,16,9,16,18,0.209,0.372,0.419,17.667,70,riffle_clumpy
0,21,20,3,44,0.477,24,0.545,4,0,1.0,2,0,27,17,12,10,22,0.273,0.227,0.5,17.65,71,riffle_clumpy
0,17,22,5,44,0.386,22,0.5,1,4,0.2,1,2,26,18,9,16,19,0.205,0.364,0.432,17.655,72,riffle_clumpy
0,22,23,1,46,0.478,23,0.5,2,1,0.667,1,2,27,19,16,11,19,0.348,0.239,0.413,17.647,73,riffle_clumpy
0,13,26,6,45,0.289,19,0.422,0,2,0.0,3,3,29,16,8,14,23,0.178,0.311,0.511,17.652,74,riffle_clumpy
0,20,20,5,45,0.444,25,0.556,3,2,0.6,1,0,24,21,12,14,19,0.267,0.311,0.422,17.647,75,riffle_clumpy
0,16,24,4,44,0.364,20,0.455,2,4,0.333,1,5,23,21,13,11,20,0.295,0.25,0.455,17.651,76,riffle_clumpy
0,13,31,4,48,0.271,17,0.354,3,2,0.6,2,3,27,21,6,22,20,0.125,0.458,0.417,17.655,77,riffle_clumpy
0,24,22,3,49,0.49,27,0.551,5,2,0.714,1,3,27,22,15,13,21,0.306,0.265,0.429,17.653,78,riffle_clumpy
0,18,22,8,48,0.375,26,0.542,3,3,0.5,2,2,37,11,6,18,24,0.125,0.375,0.5,17.658,79,riffle_clumpy
0,20,18,6,44,0.455,26,0.591,4,1,0.8,1,0,22,22,15,12,17,0.341,0.273,0.386,17.666,80,riffle_clumpy
0,16,24,5,45,0.356,21,0.467,6,2,0.75,2,1,26,19,9,18,18,0.2,0.4,0.4,17.668,81,riffle_clumpy
0,26,15,3,44,0.591,29,0.659,4,1,0.8,1,1,32,12,18,8,18,0.409,0.182,0.409,17.665,82,riffle_clumpy
0,20,21,4,45,0.444,24,0.533,4,1,0.8,1,3,29,16,10,15,20,0.222,0.333,0.444,17.661,83,riffle_clumpy
0,21,23,1,45,0.467,22,0.489,0,3,0.0,3,2,30,15,9,9,27,0.2,0.2,0.6,17.653,84,riffle_clumpy
0,21,22,3,46,0.457,24,0.522,7,1,0.875,1,2,23,23,14,9,23,0.304,0.196,0.5,17.655,85,riffle_clumpy
0,24,16,5,45,0.533,29,0.644,4,1,0.8,4,1,23,22,11,17,17,0.244,0.378,0.378,17.653,86,riffle_clumpy
0,17,25,5,47,0.362,22,0.468,2,2,0.5,1,2,29,18,9,16,22,0.191,0.34,0.468,17.658,87,riffle_clumpy
0,18,23,3,44,0.409,21,0.477,2,1,0.667,2,2,29,15,7,17,20,0.159,0.386,0.455,17.661,88,riffle_clumpy
0,16,26,4,46,0.348,20,0.435,2,3,0.4,1,1,29,17,6,18,22,0.13,0.391,0.478,17.664,89,riffle_clumpy
0,26,17,3,46,0.565,29,0.63,2,2,0.5,1,1,19,27,15,15,16,0.326,0.326,0.348,17.661,90,riffle_clumpy
0,24,21,1,46,0.522,25,0.543,5,3,0.625,3,1,27,19,13,11,22,0.283,0.239,0.478,17.657,91,riffle_clumpy
0,28,19,1,48,0.583,29,0.604,4,1,0.8,6,3,26,22,12,13,23,0.25,0.271,0.479,17.643,92,riffle_clumpy
0,15,23,6,44,0.341,21,0.477,3,4,0.429,3,2,27,17,9,16,19,0.205,0.364,0.432,17.637,93,riffle_clumpy
0,22,20,6,48,0.458,28,0.583,1,3,0.25,5,1,28,20,12,12,24,0.25,0.25,0.5,17.625,94,riffle_clumpy
0,23,24,1,48,0.479,24,0.5,5,1,0.833,4,5,30,18,7,16,25,0.146,0.333,0.521,17.62,95,riffle_clumpy
0,15,25,5,45,0.333,20,0.444,2,1,0.667,1,3,28,17,9,13,23,0.2,0.289,0.511,17.617,96,riffle_clumpy
0,31,16,2,49,0.633,33,0.673,3,3,0.5,3,3,34,15,17,11,21,0.347,0.224,0.429,18.333,1,riffle_clumpy
0,17,22,4,43,0.395,21,0.488,1,4,0.2,1,1,26,17,10,14,19,0.233,0.326,0.442,18.192,2,riffle_clumpy
0,21,13,9,43,0.488,30,0.698,5,2,0.714,2,2,22,21,11,15,17,0.256,0.349,0.395,18.203,3,riffle_clumpy
0,19,24,4,47,0.404,23,0.489,2,4,0.333,1,3,32,15,7,18,22,0.149,0.383,0.468,18.099,4,riffle_clumpy
0,20,23,5,48,0.417,25,0.521,2,4,0.333,5,2,27,21,10,15,23,0.208,0.312,0.479,17.828,5,riffle_clumpy
0,23,20,2,45,0.511,25,0.556,2,2,0.5,2,2,24,21,19,11,15,0.422,0.244,0.333,17.754,6,riffle_clumpy
0,19,23,2,44,0.432,21,0.477,2,2,0.5,3,3,36,8,8,14,22,0.182,0.318,0.5,17.843,7,riffle_clumpy
0,25,18,2,45,0.556,27,0.6,3,3,0.5,5,3,22,23,12,16,17,0.267,0.356,0.378,17.817,8,riffle_clumpy
0,16,22,6,44,0.364,22,0.5,1,2,0.333,2,1,28,16,8,14,22,0.182,0.318,0.5,17.803,9,riffle_clumpy
0,16,26,2,44,0.364,18,0.409,3,1,0.75,3,2,32,12,9,9,26,0.205,0.205,0.591,17.766,10,riffle_clumpy
0,24,18,2,44,0.545,26,0.591,2,2,0.5,6,2,24,20,11,12,21,0.25,0.273,0.477,17.705,11,riffle_clumpy
0,19,24,2,45,0.422,21,0.467,4,1,0.8,1,2,34,11,13,9,23,0.289,0.2,0.511,17.747,12,riffle_clumpy
0,16,22,5,43,0.372,21,0.488,4,1,0.8,0,1,27,16,7,18,18,0.163,0.419,0.419,17.764,13,riffle_clumpy
0,20,22,2,44,0.455,22,0.5,0,1,0.0,2,2,24,20,13,12,19,0.295,0.273,0.432,17.741,14,riffle_clumpy
0,22,16,5,43,0.512,27,0.628,7,0,1.0,2,1,26,17,14,13,16,0.326,0.302,0.372,17.707,15,riffle_clumpy
0,24,20,0,44,0.545,24,0.545,3,2,0.6,0,4,24,20,13,16,15,0.295,0.364,0.341,17.654,16,riffle_clumpy
0,27,19,0,46,0.587,27,0.587,5,1,0.833,5,0,25,21,14,13,19,0.304,0.283,0.413,17.581,17,riffle_clumpy
0,18,23,7,48,0.375,25,0.521,1,3,0.25,5,3,25,23,8,20,20,0.167,0.417,0.417,17.602,18,riffle_clumpy
0,18,21,5,44,0.409,23,0.523,3,2,0.6,3,1,26,18,6,16,22,0.136,0.364,0.5,17.633,19,riffle_clumpy
0,26,16,3,45,0.578,29,0.644,3,0,1.0,3,3,26,19,15,11,19,0.333,0.244,0.422,17.648,20,riffle_clumpy
0,21,19,3,43,0.488,24,0.558,3,2,0.6,1,1,26,17,11,12,20,0.256,0.279,0.465,17.645,21,riffle_clumpy
0,20,21,3,44,0.455,23,0.523,5,4,0.556,1,1,27,17,7,15,22,0.159,0.341,0.5,17.674,22,riffle_clumpy
0,21,20,5,46,0.457,26,0.565,2,4,0.333,4,1,25,21,12,18,16,0.261,0.391,0.348,17.713,23,riffle_clumpy
0,18,26,6,50,0.36,24,0.48,2,1,0.667,3,2,26,24,11,18,21,0.22,0.36,0.42,17.703,24,riffle_clumpy
0,20,24,4,48,0.417,24,0.5,4,0,1.0,0,5,29,19,12,14,22,0.25,0.292,0.458,17.725,25,riffle_clumpy
0,17,26,4,47,0.362,21,0.447,1,5,0.167,2,3,25,22,10,14,23,0.213,0.298,0.489,17.699,26,riffle_clumpy
0,17,27,1,45,0.378,18,0.4,1,2,0.333,2,4,27,18,8,15,22,0.178,0.333,0.489,17.693,27,riffle_clumpy
0,20,19,6,45,0.444,26,0.578,4,0,1.0,1,2,26,19,13,13,19,0.289,0.289,0.422,17.702,28,riffle_clumpy
0,22,16,4,42,0.524,26,0.619,3,0,1.0,2,2,27,15,15,15,12,0.357,0.357,0.286,17.709,29,riffle_clumpy
0,25,21,1,47,0.532,26,0.553,6,1,0.857,2,1,25,22,10,20,17,0.213,0.426,0.362,17.713,30,riffle_clumpy
0,17,26,4,47,0.362,21,0.447,2,2,0.5,1,2,28,19,7,18,22,0.149,0.383,0.468,17.721,31,riffle_clumpy
0,16,26,3,45,0.356,19,0.422,1,3,0.25,1,2,25,20,7,20,18,0.156,0.444,0.4,17.73,32,riffle_clumpy
0,23,21,4,48,0.479,27,0.562,3,4,0.429,5,0,26,22,9,17,22,0.188,0.354,0.458,17.706,33,riffle_clumpy
0,17,26,6,49,0.347,23,0.469,2,2,0.5,2,1,31,18,12,12,25,0.245,0.245,0.51,17.672,34,riffle_clumpy
0,16,25,3,44,0.364,19,0.432,3,2,0.6,4,0,23,21,8,17,19,0.182,0.386,0.432,17.67,35,riffle_clumpy
0,18,21,6,45,0.4,24,0.533,5,2,0.714,0,1,30,15,13,13,19,0.289,0.289,0.422,17.681,36,riffle_clumpy
0,20,21,3,44,0.455,23,0.523,4,1,0.8,2,3,28,16,12,9,23,0.273,0.205,0.523,17.67,37,riffle_clumpy
0,20,18,5,43,0.465,25,0.581,4,1,0.8,1,0,26,17,9,13,21,0.209,0.302,0.488,17.675,38,riffle_clumpy
0,16,28,3,47,0.34,19,0.404,1,3,0.25,0,3,24,23,7,19,21,0.149,0.404,0.447,17.67,39,riffle_clumpy
0,20,25,1,46,0.435,21,0.457,3,3,0.5,3,4,31,15,10,15,21,0.217,0.326,0.457,17.662,40,riffle_clumpy
0,18,25,4,47,0.383,22,0.468,1,1,0.5,3,1,34,13,6,11,30,0.128,0.234,0.638,17.656,41,riffle_clumpy
0,22,21,3,46,0.478,25,0.543,2,2,0.5,3,3,32,14,9,10,27,0.196,0.217,0.587,17.662,42,riffle_clumpy
0,18,23,4,45,0.4,22,0.489,2,0,1.0,0,5,30,15,6,20,19,0.133,0.444,0.422,17.667,43,riffle_clumpy
0,21,22,1,44,0.477,22,0.5,4,5,0.444,1,4,29,15,13,10,21,0.295,0.227,0.477,17.672,44,riffle_clumpy
0,20,20,3,43,0.465,23,0.535,3,3,0.5,1,0,19,24,17,11,15,0.395,0.256,0.349,17.689,45,riffle_clumpy
0,23,20,2,45,0.511,25,0.556,1,0,1.0,5,1,29,16,12,11,22,0.267,0.244,0.489,17.698,46,riffle_clumpy
0,23,21,2,46,0.5,25,0.543,2,1,0.667,3,2,30,16,9,15,22,0.196,0.326,0.478,17.695,47,riffle_clumpy
0,23,21,3,47,0.489,26,0.553,1,1,0.5,3,2,27,20,17,12,18,0.362,0.255,0.383,17.696,48,riffle_clumpy
0,22,23,1,46,0.478,23,0.5,2,3,0.4,2,2,28,18,9,13,24,0.196,0.283,0.522,17.713,49,riffle_clumpy
0,21,19,4,44,0.477,25,0.568,0,3,0.0,4,2,32,12,10,14,20,0.227,0.318,0.455,17.705,50,riffle_clumpy
0,16,24,6,46,0.348,22,0.478,1,2,0.333,2,2,28,18,7,16,23,0.152,0.348,0.5,17.702,51,riffle_clumpy
0,14,29,2,45,0.311,16,0.356,2,1,0.667,0,2,31,14,6,14,25,0.133,0.311,0.556,17.712,52,riffle_clumpy
0,23,18,5,46,0.5,28,0.609,1,2,0.333,4,3,28,18,11,12,23,0.239,0.261,0.5,17.7,53,riffle_clumpy
0,18,22,4,44,0.409,22,0.5,2,1,0.667,0,2,30,14,10,11,23,0.227,0.25,0.523,17.694,54,riffle_clumpy
0,25,18,3,46,0.543,28,0.609,7,2,0.778,1,2,28,18,14,13,19,0.304,0.283,0.413,17.701,55,riffle_clumpy
0,21,20,4,45,0.467,25,0.556,4,3,0.571,1,2,29,16,9,17,19,0.2,0.378,0.422,17.712,56,riffle_clumpy
0,18,24,5,47,0.383,23,0.489,1,5,0.167,2,1,25,22,9,18,20,0.191,0.383,0.426,17.719,57,riffle_clumpy
0,16,24,5,45,0.356,21,0.467,5,2,0.714,1,5,28,17,8,15,22,0.178,0.333,0.489,17.718,58,riffle_clumpy
0,19,25,2,46,0.413,21,0.457,1,4,0.2,3,5,32,14,13,7,26,0.283,0.152,0.565,17.708,59,riffle_clumpy
0,20,19,4,43,0.465,24,0.558,3,3,0.5,0,0,21,22,13,18,12,0.302,0.419,0.279,17.707,60,riffle_clumpy
0,16,23,4,43,0.372,20,0.465,4,1,0.8,1,1,30,13,9,16,18,0.209,0.372,0.419,17.703,61,riffle_clumpy
0,22,17,4,43,0.512,26,0.605,2,3,0.4,2,0,26,17,11,15,17,0.256,0.349,0.395,17.712,62,riffle_clumpy
0,22,18,5,45,0.489,27,0.6,1,1,0.5,3,3,26,19,13,17,15,0.289,0.378,0.333,17.711,63,riffle_clumpy
0,19,20,4,43,0.442,23,0.535,5,5,0.5,1,1,24,19,15,16,12,0.349,0.372,0.279,17.717,64,riffle_clumpy
0,25,17,4,46,0.543,29,0.63,2,0,1.0,1,2,30,16,15,12,19,0.326,0.261,0.413,17.72,65,riffle_clumpy
0,15,28,3,46,0.326,18,0.391,2,3,0.4,3,2,26,20,6,16,24,0.13,0.348,0.522,17.716,66,riffle_clumpy
0,15,28,2,45,0.333,17,0.378,1,1,0.5,2,2,25,20,7,17,21,0.156,0.378,0.467,17.706,67,riffle_clumpy
0,13,29,3,45,0.289,16,0.356,3,2,0.6,0,3,30,15,4,17,24,0.089,0.378,0.533,17.705,68,riffle_clumpy
0,17,28,2,47,0.362,19,0.404,1,2,0.333,4,2,29,18,7,20,20,0.149,0.426,0.426,17.706,69,riffle_clumpy
0,20,24,1,45,0.444,21,0.467,0,3,0.0,2,1,29,16,8,19,18,0.178,0.422,0.4,17.702,70,riffle_clumpy
0,18,21,6,45,0.4,24,0.533,1,2,0.333,2,0,26,19,8,17,20,0.178,0.378,0.444,17.701,71,riffle_clumpy
0,22,24,2,48,0.458,24,0.5,4,1,0.8,1,5,31,17,13,13,22,0.271,0.271,0.458,17.705,72,riffle_clumpy
0,26,16,3,45,0.578,29,0.644,3,1,0.75,0,3,28,17,15,13,17,0.333,0.289,0.378,17.711,73,riffle_clumpy
0,26,17,4,47,0.553,30,0.638,3,5,0.375,3,5,26,21,13,14,20,0.277,0.298,0.426,17.705,74,riffle_clumpy
0,12,25,8,45,0.267,20,0.444,0,1,0.0,1,3,34,11,4,16,25,0.089,0.356,0.556,17.712,75,riffle_clumpy
0,15,26,4,45,0.333,19,0.422,2,0,1.0,1,5,25,20,10,15,20,0.222,0.333,0.444,17.713,76,riffle_clumpy
0,18,23,5,46,0.391,23,0.5,3,1,0.75,3,3,25,21,7,18,21,0.152,0.391,0.457,17.707,77,riffle_clumpy
0,18,22,5,45,0.4,23,0.511,4,2,0.667,2,1,28,17,11,13,21,0.244,0.289,0.467,17.717,78,riffle_clumpy
0,15,24,8,47,0.319,23,0.489,0,4,0.0,1,4,33,14,5,15,27,0.106,0.319,0.574,17.711,79,riffle_clumpy
0,13,28,4,45,0.289,17,0.378,2,0,1.0,0,2,32,13,8,12,25,0.178,0.267,0.556,17.7,80,riffle_clumpy
0,21,19,4,44,0.477,25,0.568,4,2,0.667,0,2,28,16,15,10,19,0.341,0.227,0.432,17.694,81,riffle_clumpy
0,17,22,6,45,0.378,23,0.511,4,1,0.8,1,2,20,25,14,17,14,0.311,0.378,0.311,17.701,82,riffle_clumpy
0,15,25,3,43,0.349,18,0.419,1,3,0.25,3,1,28,15,8,15,20,0.186,0.349,0.465,17.697,83,riffle_clumpy
0,21,20,2,43,0.488,23,0.535,5,0,1.0,2,3,31,12,13,10,20,0.302,0.233,0.465,17.701,84,riffle_clumpy
0,22,23,3,48,0.458,25,0.521,5,7,0.417,3,0,21,27,10,17,21,0.208,0.354,0.438,17.702,85,riffle_clumpy
0,18,23,4,45,0.4,22,0.489,5,3,0.625,2,1,27,18,12,15,18,0.267,0.333,0.4,17.697,86,riffle_clumpy
0,19,20,5,44,0.432,24,0.545,1,2,0.333,2,1,28,16,10,12,22,0.227,0.273,0.5,17.704,87,riffle_clumpy
0,22,16,5,43,0.512,27,0.628,3,1,0.75,2,3,29,14,11,13,19,0.256,0.302,0.442,17.706,88,riffle_clumpy
0,21,23,3,47,0.447,24,0.511,4,1,0.8,3,6,28,19,11,13,23,0.234,0.277,0.489,17.698,89,riffle_clumpy
0,22,22,2,46,0.478,24,0.522,2,2,0.5,2,1,32,14,10,12,24,0.217,0.261,0.522,17.696,90,riffle_clumpy
0,18,20,5,43,0.419,23,0.535,2,4,0.333,1,3,26,17,10,13,20,0.233,0.302,0.465,17.696,91,riffle_clumpy
0,17,23,5,45,0.378,22,0.489,5,1,0.833,3,1,30,15,7,14,24,0.156,0.311,0.533,17.702,92,riffle_clumpy
0,18,26,2,46,0.391,20,0.435,4,3,0.571,0,5,28,18,12,16,18,0.261,0.348,0.391,17.706,93,riffle_clumpy
0,27,16,2,45,0.6,29,0.644,3,1,0.75,2,3,25,20,17,8,20,0.378,0.178,0.444,17.708,94,riffle_clumpy
0,17,22,5,44,0.386,22,0.5,3,0,1.0,1,2,27,17,11,15,18,0.25,0.341,0.409,17.709,95,riffle_clumpy
0,24,21,2,47,0.511,26,0.553,5,2,0.714,4,1,30,17,13,9,25,0.277,0.191,0.532,17.704,96,riffle_clumpy
0,18,18,9,45,0.4,27,0.6,4,3,0.571,0,0,27,18,9,19,17,0.2,0.422,0.378,18.562,1,riffle_clumpy
0,20,24,3,47,0.426,23,0.489,1,5,0.167,2,2,30,17,11,16,20,0.234,0.34,0.426,17.969,2,riffle_clumpy
0,16,24,6,46,0.348,22,0.478,0,3,0.0,5,0,28,18,8,15,23,0.174,0.326,0.5,17.686,3,riffle_clumpy
0,18,23,3,44,0.409,21,0.477,0,1,0.0,5,1,26,18,11,8,25,0.25,0.182,0.568,17.611,4,riffle_clumpy
0,21,21,4,46,0.457,25,0.543,5,1,0.833,2,3,27,19,9,16,21,0.196,0.348,0.457,17.636,5,riffle_clumpy
0,15,29,5,49,0.306,20,0.408,2,1,0.667,4,3,30,19,9,13,27,0.184,0.265,0.551,17.591,6,riffle_clumpy
0,25,17,5,47,0.532,30,0.638,5,1,0.833,2,2,31,16,15,10,22,0.319,0.213,0.468,17.627,7,riffle_clumpy
0,19,24,3,46,0.413,22,0.478,4,2,0.667,3,2,29,17,6,12,28,0.13,0.261,0.609,17.584,8,riffle_clumpy
0,18,22,3,43,0.419,21,0.488,3,1,0.75,1,3,25,18,8,16,19,0.186,0.372,0.442,17.583,9,riffle_clumpy
0,19,21,4,44,0.432,23,0.523,3,0,1.0,3,6,27,17,12,12,20,0.273,0.273,0.455,17.583,10,riffle_clumpy
0,15,27,2,44,0.341,17,0.386,5,1,0.833,1,2,27,17,8,14,22,0.182,0.318,0.5,17.561,11,riffle_clumpy
0,17,23,7,47,0.362,24,0.511,3,2,0.6,2,5,27,20,8,16,23,0.17,0.34,0.489,17.528,12,riffle_clumpy
0,17,23,3,43,0.395,20,0.465,4,6,0.4,3,1,25,18,9,17,17,0.209,0.395,0.395,17.565,13,riffle_clumpy
0,16,28,3,47,0.34,19,0.404,4,5,0.444,2,2,31,16,3,19,25,0.064,0.404,0.532,17.544,14,riffle_clumpy
0,25,15,2,42,0.595,27,0.643,4,1,0.8,0,0,31,11,13,6,23,0.31,0.143,0.548,17.572,15,riffle_clumpy
0,24,18,3,45,0.533,27,0.6,3,1,0.75,1,2,23,22,9,18,18,0.2,0.4,0.4,17.577,16,riffle_clumpy
0,14,29,2,45,0.311,16,0.356,1,1,0.5,1,3,24,21,9,19,17,0.2,0.422,0.378,17.582,17,riffle_clumpy
0,23,19,3,45,0.511,26,0.578,1,2,0.333,1,3,28,17,14,12,19,0.311,0.267,0.422,17.575,18,riffle_clumpy
0,15,29,1,45,0.333,16,0.356,1,1,0.5,2,2,28,17,9,14,22,0.2,0.311,0.489,17.538,19,riffle_clumpy
0,30,12,3,45,0.667,33,0.733,6,0,1.0,4,0,26,19,15,13,17,0.333,0.289,0.378,17.546,20,riffle_clumpy
0,18,20,6,44,0.409,24,0.545,4,2,0.667,2,3,29,15,9,14,21,0.205,0.318,0.477,17.578,21,riffle_clumpy
0,25,16,4,45,0.556,29,0.644,5,0,1.0,2,1,26,19,15,13,17,0.333,0.289,0.378,17.587,22,riffle_clumpy
0,21,22,1,44,0.477,22,0.5,2,2,0.5,2,0,28,16,14,14,16,0.318,0.318,0.364,17.621,23,riffle_clumpy
0,21,23,3,47,0.447,24,0.511,5,5,0.5,3,0,27,20,10,15,22,0.213,0.319,0.468,17.601,24,riffle_clumpy
0,24,19,1,44,0.545,25,0.568,4,3,0.571,5,3,27,17,12,11,21,0.273,0.25,0.477,17.589,25,riffle_clumpy
0,15,27,5,47,0.319,20,0.426,3,6,0.333,3,1,33,14,6,15,26,0.128,0.319,0.553,17.59,26,riffle_clumpy
0,20,20,5,45,0.444,25,0.556,4,4,0.5,0,1,28,17,10,15,20,0.222,0.333,0.444,17.597,27,riffle_clumpy
0,22,19,3,44,0.5,25,0.568,3,2,0.6,3,4,28,16,13,14,17,0.295,0.318,0.386,17.596,28,riffle_clumpy
0,21,25,3,49,0.429,24,0.49,5,3,0.625,4,3,30,19,12,13,24,0.245,0.265,0.49,17.602,29,riffle_clumpy
0,27,16,4,47,0.574,31,0.66,3,2,0.6,2,1,27,20,13,16,18,0.277,0.34,0.383,17.621,30,riffle_clumpy
0,22,22,3,47,0.468,25,0.532,4,1,0.8,4,3,31,16,7,12,28,0.149,0.255,0.596,17.592,31,riffle_clumpy
0,18,19,8,45,0.4,26,0.578,2,1,0.667,3,2,31,14,6,15,24,0.133,0.333,0.533,17.604,32,riffle_clumpy
0,15,23,5,43,0.349,20,0.465,3,2,0.6,1,2,31,12,7,15,21,0.163,0.349,0.488,17.618,33,riffle_clumpy
0,27,15,2,44,0.614,29,0.659,5,1,0.833,4,0,22,22,11,14,19,0.25,0.318,0.432,17.607,34,riffle_clumpy
0,15,23,5,43,0.349,20,0.465,2,1,0.667,0,2,25,18,7,15,21,0.163,0.349,0.488,17.607,35,riffle_clumpy
0,26,14,5,45,0.578,31,0.689,2,1,0.667,1,1,27,18,17,6,22,0.378,0.133,0.489,17.603,36,riffle_clumpy
0,17,26,4,47,0.362,21,0.447,3,0,1.0,3,0,28,19,11,15,21,0.234,0.319,0.447,17.587,37,riffle_clumpy
0,14,28,4,46,0.304,18,0.391,0,4,0.0,2,2,33,13,8,14,24,0.174,0.304,0.522,17.595,38,riffle_clumpy
0,14,26,7,47,0.298,21,0.447,2,2,0.5,1,1,34,13,7,16,24,0.149,0.34,0.511,17.615,39,riffle_clumpy
0,27,16,3,46,0.587,30,0.652,4,4,0.5,3,1,29,17,19,9,18,0.413,0.196,0.391,17.618,40,riffle_clumpy
0,24,17,5,46,0.522,29,0.63,7,1,0.875,1,3,30,16,7,14,25,0.152,0.304,0.543,17.62,41,riffle_clumpy
0,22,17,6,45,0.489,28,0.622,6,3,0.667,0,0,24,21,10,18,17,0.222,0.4,0.378,17.653,42,riffle_clumpy
0,24,18,3,45,0.533,27,0.6,3,1,0.75,2,1,22,23,15,16,14,0.333,0.356,0.311,17.645,43,riffle_clumpy
0,15,24,6,45,0.333,21,0.467,2,2,0.5,2,0,30,15,6,16,23,0.133,0.356,0.511,17.649,44,riffle_clumpy
0,19,21,4,44,0.432,23,0.523,5,1,0.833,1,1,26,18,14,15,15,0.318,0.341,0.341,17.657,45,riffle_clumpy
0,18,20,5,43,0.419,23,0.535,2,1,0.667,1,2,27,16,11,10,22,0.256,0.233,0.512,17.644,46,riffle_clumpy
0,29,14,2,45,0.644,31,0.689,4,0,1.0,4,2,23,22,19,13,13,0.422,0.289,0.289,17.636,47,riffle_clumpy
0,19,26,3,48,0.396,22,0.458,3,4,0.429,3,3,29,19,14,12,22,0.292,0.25,0.458,17.634,48,riffle_clumpy
0,18,23,5,46,0.391,23,0.5,1,1,0.5,4,4,28,18,7,9,30,0.152,0.196,0.652,17.612,49,riffle_clumpy
0,21,28,2,51,0.412,23,0.451,1,1,0.5,4,1,30,21,11,17,23,0.216,0.333,0.451,17.602,50,riffle_clumpy
0,17,27,1,45,0.378,18,0.4,3,2,0.6,2,2,29,16,11,13,21,0.244,0.289,0.467,17.613,51,riffle_clumpy
0,18,25,3,46,0.391,21,0.457,4,2,0.667,0,2,30,16,10,12,24,0.217,0.261,0.522,17.614,52,riffle_clumpy
0,19,22,5,46,0.413,24,0.522,2,1,0.667,2,0,31,15,12,15,19,0.261,0.326,0.413,17.607,53,riffle_clumpy
0,14,29,4,47,0.298,18,0.383,0,5,0.0,2,4,30,17,8,13,26,0.17,0.277,0.553,17.607,54,riffle_clumpy
0,21,20,3,44,0.477,24,0.545,1,5,0.167,0,1,26,18,14,14,16,0.318,0.318,0.364,17.622,55,riffle_clumpy
0,16,27,2,45,0.356,18,0.4,6,2,0.75,0,6,24,21,8,17,20,0.178,0.378,0.444,17.632,56,riffle_clumpy
0,21,20,5,46,0.457,26,0.565,4,2,0.667,2,6,31,15,9,11,26,0.196,0.239,0.565,17.633,57,riffle_clumpy
0,24,20,5,49,0.49,29,0.592,4,3,0.571,4,1,32,17,9,18,22,0.184,0.367,0.449,17.621,58,riffle_clumpy
0,20,21,5,46,0.435,25,0.543,4,3,0.571,0,1,32,14,14,12,20,0.304,0.261,0.435,17.633,59,riffle_clumpy
0,20,21,4,45,0.444,24,0.533,1,1,0.5,2,2,29,16,7,16,22,0.156,0.356,0.489,17.631,60,riffle_clumpy
0,18,20,6,44,0.409,24,0.545,2,2,0.5,4,2,24,20,9,17,18,0.205,0.386,0.409,17.627,61,riffle_clumpy
0,22,24,1,47,0.468,23,0.489,4,4,0.5,3,1,29,18,9,13,25,0.191,0.277,0.532,17.626,62,riffle_clumpy
0,25,17,3,45,0.556,28,0.622,4,5,0.444,4,1,28,17,9,13,23,0.2,0.289,0.511,17.628,63,riffle_clumpy
0,20,19,6,45,0.444,26,0.578,3,1,0.75,3,2,26,19,8,14,23,0.178,0.311,0.511,17.629,64,riffle_clumpy
0,19,24,5,48,0.396,24,0.5,2,3,0.4,2,6,38,10,7,14,27,0.146,0.292,0.562,17.631,65,riffle_clumpy
0,21,26,1,48,0.438,22,0.458,3,2,0.6,0,1,26,22,10,21,17,0.208,0.438,0.354,17.63,66,riffle_clumpy
0,21,23,1,45,0.467,22,0.489,4,4,0.5,3,1,26,19,10,12,23,0.222,0.267,0.511,17.619,67,riffle_clumpy
0,18,21,5,44,0.409,23,0.523,1,3,0.25,3,2,26,18,11,14,19,0.25,0.318,0.432,17.611,68,riffle_clumpy
0,19,25,1,45,0.422,20,0.444,3,4,0.429,3,2,31,14,9,10,26,0.2,0.222,0.578,17.607,69,riffle_clumpy
0,20,21,9,50,0.4,29,0.58,2,0,1.0,0,4,28,22,16,17,17,0.32,0.34,0.34,17.609,70,riffle_clumpy
0,15,22,8,45,0.333,23,0.511,4,2,0.667,0,3,29,16,9,17,19,0.2,0.378,0.422,17.613,71,riffle_clumpy
0,17,26,4,47,0.362,21,0.447,2,2,0.5,1,2,23,24,11,18,18,0.234,0.383,0.383,17.623,72,riffle_clumpy
0,23,22,0,45,0.511,23,0.511,3,2,0.6,2,2,29,16,12,13,20,0.267,0.289,0.444,17.616,73,riffle_clumpy
0,20,24,1,45,0.444,21,0.467,0,3,0.0,2,3,26,19,15,12,18,0.333,0.267,0.4,17.621,74,riffle_clumpy
0,24,13,6,43,0.558,30,0.698,6,1,0.857,2,1,20,23,15,14,14,0.349,0.326,0.326,17.625,75,riffle_clumpy
0,21,17,7,45,0.467,28,0.622,1,1,0.5,3,3,31,14,10,14,21,0.222,0.311,0.467,17.621,76,riffle_clumpy
0,15,27,6,48,0.312,21,0.438,5,4,0.556,0,2,35,13,7,14,27,0.146,0.292,0.562,17.634,77,riffle_clumpy
0,17,26,1,44,0.386,18,0.409,3,1,0.75,4,4,31,13,7,15,22,0.159,0.341,0.5,17.632,78,riffle_clumpy
0,24,21,2,47,0.511,26,0.553,6,1,0.857,2,4,29,18,14,13,20,0.298,0.277,0.426,17.633,79,riffle_clumpy
0,25,16,5,46,0.543,30,0.652,5,2,0.714,2,0,28,18,19,7,20,0.413,0.152,0.435,17.634,80,riffle_clumpy
0,22,20,5,47,0.468,27,0.574,1,1,0.5,2,3,28,19,15,13,19,0.319,0.277,0.404,17.63,81,riffle_clumpy
0,24,20,1,45,0.533,25,0.556,2,1,0.667,3,1,25,20,16,13,16,0.356,0.289,0.356,17.63,82,riffle_clumpy
0,17,25,4,46,0.37,21,0.457,1,2,0.333,2,1,28,18,11,13,22,0.239,0.283,0.478,17.627,83,riffle_clumpy
0,23,18,4,45,0.511,27,0.6,3,3,0.5,3,3,25,20,13,14,18,0.289,0.311,0.4,17.627,84,riffle_clumpy
0,22,19,3,44,0.5,25,0.568,4,3,0.571,1,4,30,14,14,11,19,0.318,0.25,0.432,17.629,85,riffle_clumpy
0,23,23,3,49,0.469,26,0.531,1,2,0.333,4,0,30,19,14,11,24,0.286,0.224,0.49,17.619,86,riffle_clumpy
0,18,25,1,44,0.409,19,0.432,0,5,0.0,2,2,25,19,8,16,20,0.182,0.364,0.455,17.624,87,riffle_clumpy
0,18,23,5,46,0.391,23,0.5,2,2,0.5,2,3,27,19,7,22,17,0.152,0.478,0.37,17.633,88,riffle_clumpy
0,18,22,4,44,0.409,22,0.5,4,3,0.571,2,4,27,17,6,20,18,0.136,0.455,0.409,17.636,89,riffle_clumpy
0,17,18,8,43,0.395,25,0.581,1,0,1.0,1,1,25,18,12,18,13,0.279,0.419,0.302,17.638,90,riffle_clumpy
0,21,19,6,46,0.457,27,0.587,2,2,0.5,5,4,31,15,14,11,21,0.304,0.239,0.457,17.636,91,riffle_clumpy
0,22,22,1,45,0.489,23,0.511,2,3,0.4,2,2,32,13,11,13,21,0.244,0.289,0.467,17.638,92,riffle_clumpy
0,21,19,4,44,0.477,25,0.568,3,1,0.75,2,1,24,20,8,16,20,0.182,0.364,0.455,17.638,93,riffle_clumpy
0,17,25,2,44,0.386,19,0.432,3,1,0.75,0,3,29,15,7,14,23,0.159,0.318,0.523,17.644,94,riffle_clumpy
0,16,23,8,47,0.34,24,0.511,0,2,0.0,1,4,32,15,8,14,25,0.17,0.298,0.532,17.646,95,riffle_clumpy
0,18,23,3,44,0.409,21,0.477,3,2,0.6,2,2,29,15,9,11,24,0.205,0.25,0.545,17.644,96,riffle_clumpy
0,13,24,9,46,0.283,22,0.478,0,2,0.0,3,1,30,16,7,14,25,0.152,0.304,0.543,18.447,1,riffle_clumpy
0,21,18,5,44,0.477,26,0.591,2,3,0.4,3,2,30,14,12,9,23,0.273,0.205,0.523,17.824,2,riffle_clumpy
0,11,25,5,41,0.268,16,0.39,3,5,0.375,1,1,26,15,9,15,17,0.22,0.366,0.415,17.915,3,riffle_clumpy
0,20,24,5,49,0.408,25,0.51,4,2,0.667,3,4,33,16,13,11,25,0.265,0.224,0.51,17.849,4,riffle_clumpy
0,21,24,0,45,0.467,21,0.467,2,0,1.0,3,2,26,19,14,12,19,0.311,0.267,0.422,17.785,5,riffle_clumpy
0,17,22,4,43,0.395,21,0.488,2,3,0.4,1,3,29,14,8,15,20,0.186,0.349,0.465,17.839,6,riffle_clumpy
0,18,22,4,44,0.409,22,0.5,2,2,0.5,1,1,28,16,11,13,20,0.25,0.295,0.455,17.863,7,riffle_clumpy
0,19,23,4,46,0.413,23,0.5,2,1,0.667,0,3,27,19,11,13,22,0.239,0.283,0.478,17.787,8,riffle_clumpy
0,19,17,8,44,0.432,27,0.614,5,3,0.625,1,2,29,15,10,15,19,0.227,0.341,0.432,17.808,9,riffle_clumpy
0,16,26,6,48,0.333,22,0.458,1,1,0.5,2,3,32,16,7,15,26,0.146,0.312,0.542,17.754,10,riffle_clumpy
0,28,16,3,47,0.596,31,0.66,3,0,1.0,2,2,22,25,19,10,18,0.404,0.213,0.383,17.675,11,riffle_clumpy
0,18,22,9,49,0.367,27,0.551,2,4,0.333,1,2,25,24,10,21,18,0.204,0.429,0.367,17.687,12,riffle_clumpy
0,24,27,2,53,0.453,26,0.491,3,2,0.6,0,3,29,24,13,19,21,0.245,0.358,0.396,17.676,13,riffle_clumpy
0,20,25,2,47,0.426,22,0.468,3,1,0.75,1,2,26,21,13,14,20,0.277,0.298,0.426,17.69,14,riffle_clumpy
0,22,21,3,46,0.478,25,0.543,3,3,0.5,5,3,27,19,9,18,19,0.196,0.391,0.413,17.691,15,riffle_clumpy
0,14,30,3,47,0.298,17,0.362,0,4,0.0,3,4,34,13,9,16,22,0.191,0.34,0.468,17.683,16,riffle_clumpy
0,20,21,4,45,0.444,24,0.533,3,3,0.5,3,3,29,16,10,13,22,0.222,0.289,0.489,17.676,17,riffle_clumpy
0,16,23,5,44,0.364,21,0.477,2,3,0.4,1,4,29,15,11,16,17,0.25,0.364,0.386,17.703,18,riffle_clumpy
0,25,15,1,41,0.61,26,0.634,4,1,0.8,1,1,25,16,16,9,16,0.39,0.22,0.39,17.674,19,riffle_clumpy
0,18,19,8,45,0.4,26,0.578,3,1,0.75,1,3,33,12,9,14,22,0.2,0.311,0.489,17.704,20,riffle_clumpy
0,23,20,4,47,0.489,27,0.574,3,2,0.6,4,0,28,19,5,14,28,0.106,0.298,0.596,17.648,21,riffle_clumpy
0,14,24,8,46,0.304,22,0.478,2,1,0.667,1,1,28,18,9,16,21,0.196,0.348,0.457,17.648,22,riffle_clumpy
0,21,21,4,46,0.457,25,0.543,1,2,0.333,1,2,32,14,10,15,21,0.217,0.326,0.457,17.675,23,riffle_clumpy
0,20,23,2,45,0.444,22,0.489,4,3,0.571,4,3,24,21,10,15,20,0.222,0.333,0.444,17.673,24,riffle_clumpy
0,17,25,5,47,0.362,22,0.468,3,1,0.75,1,2,33,14,4,15,28,0.085,0.319,0.596,17.699,25,riffle_clumpy
0,21,23,2,46,0.457,23,0.5,4,5,0.444,5,1,24,22,9,20,17,0.196,0.435,0.37,17.68,26,riffle_clumpy
0,13,26,7,46,0.283,20,0.435,1,1,0.5,3,1,27,19,5,16,25,0.109,0.348,0.543,17.652,27,riffle_clumpy
0,23,20,3,46,0.5,26,0.565,3,3,0.5,1,3,29,17,14,14,18,0.304,0.304,0.391,17.665,28,riffle_clumpy
0,23,17,3,43,0.535,26,0.605,4,1,0.8,2,1,29,14,14,12,17,0.326,0.279,0.395,17.647,29,riffle_clumpy
0,19,25,2,46,0.413,21,0.457,1,3,0.25,1,4,29,17,10,13,23,0.217,0.283,0.5,17.642,30,riffle_clumpy
0,16,25,3,44,0.364,19,0.432,2,0,1.0,2,3,27,17,12,18,14,0.273,0.409,0.318,17.656,31,riffle_clumpy
0,14,27,3,44,0.318,17,0.386,3,4,0.429,4,4,33,11,7,13,24,0.159,0.295,0.545,17.66,32,riffle_clumpy
0,22,21,2,45,0.489,24,0.533,1,1,0.5,3,2,25,20,11,13,21,0.244,0.289,0.467,17.645,33,riffle_clumpy
0,22,19,4,45,0.489,26,0.578,0,2,0.0,3,3,24,21,16,10,19,0.356,0.222,0.422,17.647,34,riffle_clumpy
0,21,20,2,43,0.488,23,0.535,2,4,0.333,3,1,27,16,13,11,19,0.302,0.256,0.442,17.643,35,riffle_clumpy
0,16,28,3,47,0.34,19,0.404,6,3,0.667,0,1,24,23,12,12,23,0.255,0.255,0.489,17.649,36,riffle_clumpy
0,26,16,4,46,0.565,30,0.652,4,1,0.8,3,1,27,19,13,13,20,0.283,0.283,0.435,17.672,37,riffle_clumpy
0,17,24,5,46,0.37,22,0.478,5,0,1.0,1,6,36,10,12,13,21,0.261,0.283,0.457,17.678,38,riffle_clumpy
0,23,23,4,50,0.46,27,0.54,1,4,0.2,4,1,28,22,10,16,24,0.2,0.32,0.48,17.673,39,riffle_clumpy
0,17,25,3,45,0.378,20,0.444,1,3,0.25,4,3,30,15,8,16,21,0.178,0.356,0.467,17.673,40,riffle_clumpy
0,16,22,6,44,0.364,22,0.5,2,3,0.4,1,2,28,16,8,13,23,0.182,0.295,0.523,17.685,41,riffle_clumpy
0,24,19,2,45,0.533,26,0.578,3,3,0.5,5,2,28,17,12,16,17,0.267,0.356,0.378,17.682,42,riffle_clumpy
0,25,19,3,47,0.532,28,0.596,4,1,0.8,4,3,27,20,13,14,20,0.277,0.298,0.426,17.686,43,riffle_clumpy
0,19,22,4,45,0.422,23,0.511,3,1,0.75,2,3,28,17,11,10,24,0.244,0.222,0.533,17.678,44,riffle_clumpy
0,22,20,5,47,0.468,27,0.574,6,1,0.857,4,0,19,28,6,19,22,0.128,0.404,0.468,17.661,45,riffle_clumpy
0,27,18,2,47,0.574,29,0.617,4,1,0.8,3,4,28,19,17,11,19,0.362,0.234,0.404,17.643,46,riffle_clumpy
0,22,16,5,43,0.512,27,0.628,2,1,0.667,2,2,21,22,16,14,13,0.372,0.326,0.302,17.646,47,riffle_clumpy
0,20,23,4,47,0.426,24,0.511,2,1,0.667,4,2,28,19,12,13,22,0.255,0.277,0.468,17.645,48,riffle_clumpy
0,18,26,5,49,0.367,23,0.469,1,0,1.0,3,3,25,24,9,17,23,0.184,0.347,0.469,17.64,49,riffle_clumpy
0,21,22,3,46,0.457,24,0.522,1,0,1.0,3,2,34,12,9,10,27,0.196,0.217,0.587,17.631,50,riffle_clumpy
0,18,24,3,45,0.4,21,0.467,3,4,0.429,2,3,24,21,10,15,20,0.222,0.333,0.444,17.612,51,riffle_clumpy
0,23,16,6,45,0.511,29,0.644,7,1,0.875,1,2,26,19,13,16,16,0.289,0.356,0.356,17.623,52,riffle_clumpy
0,19,25,3,47,0.404,22,0.468,2,2,0.5,2,3,27,20,11,16,20,0.234,0.34,0.426,17.627,53,riffle_clumpy
0,19,24,3,46,0.413,22,0.478,3,2,0.6,1,3,29,17,15,7,24,0.326,0.152,0.522,17.637,54,riffle_clumpy
0,14,27,6,47,0.298,20,0.426,2,7,0.222,0,2,28,19,11,19,17,0.234,0.404,0.362,17.64,55,riffle_clumpy
0,19,19,5,43,0.442,24,0.558,1,2,0.333,1,2,24,19,13,12,18,0.302,0.279,0.419,17.639,56,riffle_clumpy
0,19,30,2,51,0.373,21,0.412,1,3,0.25,3,4,27,24,8,19,24,0.157,0.373,0.471,17.622,57,riffle_clumpy
0,19,23,2,44,0.432,21,0.477,2,2,0.5,2,3,29,15,15,11,18,0.341,0.25,0.409,17.618,58,riffle_clumpy
0,21,18,4,43,0.488,25,0.581,3,1,0.75,1,3,25,18,16,9,18,0.372,0.209,0.419,17.625,59,riffle_clumpy
0,17,23,6,46,0.37,23,0.5,3,1,0.75,2,3,30,16,8,14,24,0.174,0.304,0.522,17.63,60,riffle_clumpy
0,19,26,1,46,0.413,20,0.435,1,3,0.25,1,4,23,23,12,19,15,0.261,0.413,0.326,17.635,61,riffle_clumpy
0,18,23,6,47,0.383,24,0.511,2,1,0.667,4,2,29,18,8,12,27,0.17,0.255,0.574,17.631,62,riffle_clumpy
0,21,17,5,43,0.488,26,0.605,6,1,0.857,1,0,29,14,13,17,13,0.302,0.395,0.302,17.64,63,riffle_clumpy
0,19,24,5,48,0.396,24,0.5,2,4,0.333,6,2,27,21,6,18,24,0.125,0.375,0.5,17.631,64,riffle_clumpy
0,24,25,4,53,0.453,28,0.528,1,1,0.5,3,3,26,27,17,20,16,0.321,0.377,0.302,17.629,65,riffle_clumpy
0,21,20,5,46,0.457,26,0.565,4,1,0.8,3,3,31,15,7,15,24,0.152,0.326,0.522,17.623,66,riffle_clumpy
0,24,19,5,48,0.5,29,0.604,5,0,1.0,3,2,27,21,12,18,18,0.25,0.375,0.375,17.62,67,riffle_clumpy
0,20,22,5,47,0.426,25,0.532,3,3,0.5,5,4,29,18,8,12,27,0.17,0.255,0.574,17.605,68,riffle_clumpy
0,22,20,2,44,0.5,24,0.545,6,3,0.667,0,3,24,20,14,15,15,0.318,0.341,0.341,17.613,69,riffle_clumpy
0,24,13,7,44,0.545,31,0.705,4,1,0.8,2,0,24,20,12,12,20,0.273,0.273,0.455,17.603,70,riffle_clumpy
0,21,18,5,44,0.477,26,0.591,4,2,0.667,0,6,30,14,13,11,20,0.295,0.25,0.455,17.61,71,riffle_clumpy
0,20,22,4,46,0.435,24,0.522,1,2,0.333,3,2,28,18,11,14,21,0.239,0.304,0.457,17.6,72,riffle_clumpy
0,19,25,1,45,0.422,20,0.444,3,2,0.6,0,3,28,17,9,15,21,0.2,0.333,0.467,17.611,73,riffle_clumpy
0,26,17,3,46,0.565,29,0.63,1,5,0.167,2,2,28,18,17,12,17,0.37,0.261,0.37,17.619,74,riffle_clumpy
0,24,18,2,44,0.545,26,0.591,3,1,0.75,0,0,30,14,12,14,18,0.273,0.318,0.409,17.619,75,riffle_clumpy
0,16,26,3,45,0.356,19,0.422,1,2,0.333,0,3,28,17,13,14,18,0.289,0.311,0.4,17.63,76,riffle_clumpy
0,17,24,5,46,0.37,22,0.478,2,2,0.5,1,1,26,20,13,15,18,0.283,0.326,0.391,17.64,77,riffle_clumpy
0,25,17,4,46,0.543,29,0.63,5,2,0.714,2,3,27,19,15,12,19,0.326,0.261,0.413,17.637,78,riffle_clumpy
0,21,24,2,47,0.447,23,0.489,3,3,0.5,0,0,26,21,11,19,17,0.234,0.404,0.362,17.632,79,riffle_clumpy
0,21,24,1,46,0.457,22,0.478,5,2,0.714,0,3,34,12,14,9,23,0.304,0.196,0.5,17.629,80,riffle_clumpy
0,22,18,4,44,0.5,26,0.591,5,1,0.833,3,0,24,20,7,18,19,0.159,0.409,0.432,17.632,81,riffle_clumpy
0,15,26,8,49,0.306,23,0.469,2,3,0.4,4,5,30,19,5,17,27,0.102,0.347,0.551,17.626,82,riffle_clumpy
0,26,13,3,42,0.619,29,0.69,7,0,1.0,1,1,28,14,13,6,23,0.31,0.143,0.548,17.624,83,riffle_clumpy
0,28,21,1,50,0.56,29,0.58,4,1,0.8,1,4,32,18,16,16,18,0.32,0.32,0.36,17.632,84,riffle_clumpy
0,23,17,4,44,0.523,27,0.614,1,2,0.333,3,2,28,16,9,12,23,0.205,0.273,0.523,17.637,85,riffle_clumpy
0,15,27,3,45,0.333,18,0.4,2,2,0.5,2,5,32,13,6,16,23,0.133,0.356,0.511,17.639,86,riffle_clumpy
0,12,26,7,45,0.267,19,0.422,2,6,0.25,1,2,34,11,6,11,28,0.133,0.244,0.622,17.644,87,riffle_clumpy
0,21,18,9,48,0.438,30,0.625,3,0,1.0,2,0,35,13,10,13,25,0.208,0.271,0.521,17.636,88,riffle_clumpy
0,19,22,4,45,0.422,23,0.511,4,3,0.571,1,4,29,16,12,13,20,0.267,0.289,0.444,17.639,89,riffle_clumpy
0,14,27,5,46,0.304,19,0.413,1,4,0.2,3,4,33,13,5,15,26,0.109,0.326,0.565,17.65,90,riffle_clumpy
0,21,19,3,43,0.488,24,0.558,6,0,1.0,3,1,20,23,9,18,16,0.209,0.419,0.372,17.654,91,riffle_clumpy
0,16,24,4,44,0.364,20,0.455,2,3,0.4,0,4,32,12,9,10,25,0.205,0.227,0.568,17.665,92,riffle_clumpy
0,21,25,3,49,0.429,24,0.49,3,2,0.6,2,2,27,22,9,16,24,0.184,0.327,0.49,17.663,93,riffle_clumpy
0,21,22,2,45,0.467,23,0.511,3,0,1.0,3,3,27,18,10,15,20,0.222,0.333,0.444,17.673,94,riffle_clumpy
0,17,26,2,45,0.378,19,0.422,3,1,0.75,4,1,27,18,7,15,23,0.156,0.333,0.511,17.674,95,riffle_clumpy
0,21,20,5,46,0.457,26,0.565,2,1,0.667,2,2,24,22,14,13,19,0.304,0.283,0.413,17.669,96,riffle_clumpy
0,25,15,6,46,0.543,31,0.674,4,1,0.8,3,0,25,21,16,15,15,0.348,0.326,0.326,17.556,1,riffle_clumpy
0,23,18,5,46,0.5,28,0.609,3,1,0.75,5,2,25,21,15,12,19,0.326,0.261,0.413,17.327,2,riffle_clumpy
0,20,22,2,44,0.455,22,0.5,3,1,0.75,3,2,29,15,11,12,21,0.25,0.273,0.477,17.457,3,riffle_clumpy
0,14,23,10,47,0.298,24,0.511,3,1,0.75,2,1,27,20,5,20,22,0.106,0.426,0.468,17.444,4,riffle_clumpy
0,24,16,4,44,0.545,28,0.636,4,0,1.0,3,3,26,18,10,14,20,0.227,0.318,0.455,17.265,5,riffle_clumpy
0,25,12,6,43,0.581,31,0.721,3,2,0.6,0,0,22,21,15,15,13,0.349,0.349,0.302,17.372,6,riffle_clumpy
0,23,18,1,42,0.548,24,0.571,7,0,1.0,3,1,24,18,13,12,17,0.31,0.286,0.405,17.276,7,riffle_clumpy
0,14,28,1,43,0.326,15,0.349,3,0,1.0,1,2,28,15,9,10,24,0.209,0.233,0.558,17.291,8,riffle_clumpy
0,20,23,3,46,0.435,23,0.5,4,3,0.571,5,2,22,24,12,15,19,0.261,0.326,0.413,17.342,9,riffle_clumpy
0,18,22,6,46,0.391,24,0.522,0,3,0.0,1,2,23,23,11,16,19,0.239,0.348,0.413,17.412,10,riffle_clumpy
0,17,26,1,44,0.386,18,0.409,2,2,0.5,2,3,32,12,9,12,23,0.205,0.273,0.523,17.443,11,riffle_clumpy
0,28,14,2,44,0.636,30,0.682,5,2,0.714,3,0,25,19,15,7,22,0.341,0.159,0.5,17.309,12,riffle_clumpy
0,21,20,3,44,0.477,24,0.545,3,1,0.75,1,3,30,14,13,8,23,0.295,0.182,0.523,17.344,13,riffle_clumpy
0,23,13,7,43,0.535,30,0.698,1,4,0.2,1,4,28,15,16,11,16,0.372,0.256,0.372,17.418,14,riffle_clumpy
0,22,17,6,45,0.489,28,0.622,2,1,0.667,3,2,28,17,12,11,22,0.267,0.244,0.489,17.425,15,riffle_clumpy
0,18,22,4,44,0.409,22,0.5,1,5,0.167,1,0,26,18,8,20,16,0.182,0.455,0.364,17.435,16,riffle_clumpy
0,23,16,5,44,0.523,28,0.636,4,2,0.667,4,2,24,20,11,15,18,0.25,0.341,0.409,17.425,17,riffle_clumpy
0,19,20,6,45,0.422,25,0.556,2,2,0.5,3,1,27,18,8,14,23,0.178,0.311,0.511,17.447,18,riffle_clumpy
0,21,19,3,43,0.488,24,0.558,2,2,0.5,1,1,25,18,13,14,16,0.302,0.326,0.372,17.476,19,riffle_clumpy
0,26,21,1,48,0.542,27,0.562,2,3,0.4,3,2,25,23,16,11,21,0.333,0.229,0.438,17.521,20,riffle_clumpy
0,18,20,6,44,0.409,24,0.545,3,0,1.0,1,2,32,12,11,12,21,0.25,0.273,0.477,17.528,21,riffle_clumpy
0,18,26,2,46,0.391,20,0.435,4,3,0.571,1,3,26,20,9,15,22,0.196,0.326,0.478,17.541,22,riffle_clumpy
0,14,28,3,45,0.311,17,0.378,4,1,0.8,2,4,31,14,7,12,26,0.156,0.267,0.578,17.532,23,riffle_clumpy
0,15,21,7,43,0.349,22,0.512,2,2,0.5,1,1,30,13,6,14,23,0.14,0.326,0.535,17.524,24,riffle_clumpy
0,19,21,5,45,0.422,24,0.533,2,2,0.5,3,4,23,22,8,16,21,0.178,0.356,0.467,17.515,25,riffle_clumpy
0,25,16,4,45,0.556,29,0.644,1,4,0.2,3,1,19,26,8,20,17,0.178,0.444,0.378,17.511,26,riffle_clumpy
0,22,19,5,46,0.478,27,0.587,2,1,0.667,2,2,27,19,15,9,22,0.326,0.196,0.478,17.495,27,riffle_clumpy
0,22,21,3,46,0.478,25,0.543,4,1,0.8,1,1,26,20,12,15,19,0.261,0.326,0.413,17.489,28,riffle_clumpy
0,25,13,6,44,0.568,31,0.705,5,1,0.833,2,2,26,18,14,12,18,0.318,0.273,0.409,17.482,29,riffle_clumpy
0,20,18,5,43,0.465,25,0.581,1,4,0.2,1,2,23,20,11,15,17,0.256,0.349,0.395,17.484,30,riffle_clumpy
0,21,22,2,45,0.467,23,0.511,2,3,0.4,2,3,27,18,15,8,22,0.333,0.178,0.489,17.461,31,riffle_clumpy
0,21,25,2,48,0.438,23,0.479,1,1,0.5,2,2,28,20,10,18,20,0.208,0.375,0.417,17.486,32,riffle_clumpy
0,22,18,3,43,0.512,25,0.581,5,1,0.833,4,3,19,24,14,16,13,0.326,0.372,0.302,17.492,33,riffle_clumpy
0,17,22,6,45,0.378,23,0.511,3,2,0.6,1,3,28,17,9,14,22,0.2,0.311,0.489,17.492,34,riffle_clumpy
0,21,21,5,47,0.447,26,0.553,1,3,0.25,2,3,26,21,11,13,23,0.234,0.277,0.489,17.49,35,riffle_clumpy
0,17,30,2,49,0.347,19,0.388,4,3,0.571,1,3,33,16,9,20,20,0.184,0.408,0.408,17.514,36,riffle_clumpy
0,30,15,0,45,0.667,30,0.667,4,3,0.571,5,3,21,24,16,11,18,0.356,0.244,0.4,17.506,37,riffle_clumpy
0,18,27,1,46,0.391,19,0.413,0,4,0.0,3,4,27,19,10,17,19,0.217,0.37,0.413,17.532,38,riffle_clumpy
0,12,31,3,46,0.261,15,0.326,2,6,0.25,2,2,29,17,5,16,25,0.109,0.348,0.543,17.567,39,riffle_clumpy
0,19,22,3,44,0.432,22,0.5,3,3,0.5,1,3,25,19,13,11,20,0.295,0.25,0.455,17.587,40,riffle_clumpy
0,24,17,3,44,0.545,27,0.614,3,3,0.5,2,2,28,16,13,11,20,0.295,0.25,0.455,17.598,41,riffle_clumpy
0,15,28,3,46,0.326,18,0.391,1,4,0.2,2,2,25,21,11,15,20,0.239,0.326,0.435,17.612,42,riffle_clumpy
0,20,17,7,44,0.455,27,0.614,2,1,0.667,1,0,32,12,9,18,17,0.205,0.409,0.386,17.64,43,riffle_clumpy
0,19,20,5,44,0.432,24,0.545,4,0,1.0,2,4,28,16,11,11,22,0.25,0.25,0.5,17.658,44,riffle_clumpy
0,26,16,3,45,0.578,29,0.644,3,2,0.6,4,2,28,17,14,14,17,0.311,0.311,0.378,17.645,45,riffle_clumpy
0,20,23,4,47,0.426,24,0.511,4,3,0.571,3,5,31,16,7,18,22,0.149,0.383,0.468,17.656,46,riffle_clumpy
0,19,17,9,45,0.422,28,0.622,3,1,0.75,0,1,27,18,10,18,17,0.222,0.4,0.378,17.665,47,riffle_clumpy
0,20,27,1,48,0.417,21,0.438,2,4,0.333,1,2,21,27,14,16,18,0.292,0.333,0.375,17.651,48,riffle_clumpy
0,17,24,3,44,0.386,20,0.455,2,1,0.667,1,3,29,15,13,8,23,0.295,0.182,0.523,17.637,49,riffle_clumpy
0,24,22,1,47,0.511,25,0.532,3,1,0.75,4,4,30,17,12,14,21,0.255,0.298,0.447,17.646,50,riffle_clumpy
0,21,17,6,44,0.477,27,0.614,0,3,0.0,5,1,23,21,13,10,21,0.295,0.227,0.477,17.639,51,riffle_clumpy
0,24,20,0,44,0.545,24,0.545,5,2,0.714,2,2,31,13,17,8,19,0.386,0.182,0.432,17.642,52,riffle_clumpy
0,22,25,0,47,0.468,22,0.468,3,1,0.75,3,2,29,18,6,17,24,0.128,0.362,0.511,17.628,53,riffle_clumpy
0,20,25,2,47,0.426,22,0.468,3,0,1.0,1,5,28,19,7,18,22,0.149,0.383,0.468,17.635,54,riffle_clumpy
0,17,26,6,49,0.347,23,0.469,4,2,0.667,3,6,30,19,8,11,30,0.163,0.224,0.612,17.64,55,riffle_clumpy
0,22,19,5,46,0.478,27,0.587,1,0,1.0,3,1,26,20,9,21,16,0.196,0.457,0.348,17.653,56,riffle_clumpy
0,21,19,5,45,0.467,26,0.578,4,0,1.0,0,3,24,21,13,15,17,0.289,0.333,0.378,17.651,57,riffle_clumpy
0,14,27,3,44,0.318,17,0.386,2,3,0.4,0,0,32,12,7,15,22,0.159,0.341,0.5,17.648,58,riffle_clumpy
0,21,19,2,42,0.5,23,0.548,3,2,0.6,0,0,25,17,16,14,12,0.381,0.333,0.286,17.66,59,riffle_clumpy
0,15,27,4,46,0.326,19,0.413,1,4,0.2,1,3,31,15,9,14,23,0.196,0.304,0.5,17.668,60,riffle_clumpy
0,25,17,2,44,0.568,27,0.614,4,3,0.571,1,2,26,18,13,13,18,0.295,0.295,0.409,17.67,61,riffle_clumpy
0,21,24,2,47,0.447,23,0.489,4,2,0.667,3,3,30,17,6,22,19,0.128,0.468,0.404,17.671,62,riffle_clumpy
0,19,24,3,46,0.413,22,0.478,3,4,0.429,1,3,28,18,11,15,20,0.239,0.326,0.435,17.685,63,riffle_clumpy
0,25,15,3,43,0.581,28,0.651,6,2,0.75,3,1,23,20,11,15,17,0.256,0.349,0.395,17.684,64,riffle_clumpy
0,15,29,2,46,0.326,17,0.37,1,0,1.0,3,4,27,19,9,12,25,0.196,0.261,0.543,17.669,65,riffle_clumpy
0,24,21,2,47,0.511,26,0.553,1,0,1.0,3,2,31,16,12,12,23,0.255,0.255,0.489,17.679,66,riffle_clumpy
0,18,25,2,45,0.4,20,0.444,4,1,0.8,2,3,32,13,12,9,24,0.267,0.2,0.533,17.679,67,riffle_clumpy
0,22,20,4,46,0.478,26,0.565,6,1,0.857,5,2,23,23,12,8,26,0.261,0.174,0.565,17.671,68,riffle_clumpy
0,25,20,1,46,0.543,26,0.565,4,2,0.667,6,2,29,17,9,12,25,0.196,0.261,0.543,17.655,69,riffle_clumpy
0,18,24,5,47,0.383,23,0.489,2,5,0.286,1,2,26,21,8,17,22,0.17,0.362,0.468,17.652,70,riffle_clumpy
0,16,26,4,46,0.348,20,0.435,2,4,0.333,0,1,26,20,6,21,19,0.13,0.457,0.413,17.661,71,riffle_clumpy
0,13,27,3,43,0.302,16,0.372,2,1,0.667,1,2,25,18,8,17,18,0.186,0.395,0.419,17.672,72,riffle_clumpy
0,20,18,7,45,0.444,27,0.6,2,1,0.667,1,1,29,16,12,15,18,0.267,0.333,0.4,17.674,73,riffle_clumpy
0,18,24,4,46,0.391,22,0.478,4,2,0.667,3,2,29,17,6,19,21,0.13,0.413,0.457,17.674,74,riffle_clumpy
0,19,23,2,44,0.432,21,0.477,6,1,0.857,2,2,28,16,11,12,21,0.25,0.273,0.477,17.683,75,riffle_clumpy
0,21,18,5,44,0.477,26,0.591,4,2,0.667,3,2,26,18,10,14,20,0.227,0.318,0.455,17.688,76,riffle_clumpy
0,24,21,2,47,0.511,26,0.553,3,2,0.6,4,1,31,16,12,10,25,0.255,0.213,0.532,17.695,77,riffle_clumpy
0,18,24,4,46,0.391,22,0.478,1,5,0.167,2,1,31,15,8,17,21,0.174,0.37,0.457,17.693,78,riffle_clumpy
0,22,22,2,46,0.478,24,0.522,2,0,1.0,5,1,28,18,11,13,22,0.239,0.283,0.478,17.686,79,riffle_clumpy
0,19,24,3,46,0.413,22,0.478,3,2,0.6,1,6,29,17,13,15,18,0.283,0.326,0.391,17.688,80,riffle_clumpy
0,16,24,8,48,0.333,24,0.5,3,2,0.6,1,0,29,19,10,19,19,0.208,0.396,0.396,17.698,81,riffle_clumpy
0,16,27,7,50,0.32,23,0.46,4,4,0.5,1,2,30,20,10,14,26,0.2,0.28,0.52,17.694,82,riffle_clumpy
0,24,22,3,49,0.49,27,0.551,3,4,0.429,0,1,35,14,14,12,23,0.286,0.245,0.469,17.702,83,riffle_clumpy
0,28,21,5,54,0.519,33,0.611,3,4,0.429,4,2,24,30,15,20,19,0.278,0.37,0.352,17.703,84,riffle_clumpy
0,17,25,3,45,0.378,20,0.444,2,0,1.0,0,4,31,14,8,14,23,0.178,0.311,0.511,17.696,85,riffle_clumpy
0,16,28,3,47,0.34,19,0.404,5,3,0.625,3,3,27,20,7,16,24,0.149,0.34,0.511,17.693,86,riffle_clumpy
0,20,20,4,44,0.455,24,0.545,3,4,0.429,4,1,23,21,9,16,19,0.205,0.364,0.432,17.693,87,riffle_clumpy
0,25,17,4,46,0.543,29,0.63,7,2,0.778,1,0,27,19,18,7,21,0.391,0.152,0.457,17.694,88,riffle_clumpy
0,21,22,3,46,0.457,24,0.522,2,2,0.5,3,3,28,18,7,14,25,0.152,0.304,0.543,17.685,89,riffle_clumpy
0,16,24,2,42,0.381,18,0.429,1,2,0.333,1,0,31,11,12,10,20,0.286,0.238,0.476,17.687,90,riffle_clumpy
0,26,18,0,44,0.591,26,0.591,2,0,1.0,2,0,20,24,19,9,16,0.432,0.205,0.364,17.68,91,riffle_clumpy
0,18,24,5,47,0.383,23,0.489,3,5,0.375,2,1,30,17,12,14,21,0.255,0.298,0.447,17.676,92,riffle_clumpy
0,22,25,3,50,0.44,25,0.5,5,4,0.556,4,3,26,24,12,18,20,0.24,0.36,0.4,17.677,93,riffle_clumpy
0,23,17,5,45,0.511,28,0.622,4,5,0.444,2,3,27,18,13,16,16,0.289,0.356,0.356,17.684,94,riffle_clumpy
0,17,27,4,48,0.354,21,0.438,3,4,0.429,1,1,30,18,7,20,21,0.146,0.417,0.438,17.673,95,riffle_clumpy
0,18,23,5,46,0.391,23,0.5,1,5,0.167,1,3,26,20,10,17,19,0.217,0.37,0.413,17.671,96,riffle_clumpy
0,21,21,5,47,0.447,26,0.553,3,2,0.6,2,0,27,20,15,15,17,0.319,0.319,0.362,18.583,1,riffle_clumpy
0,18,23,5,46,0.391,23,0.5,2,2,0.5,1,2,30,16,11,16,19,0.239,0.348,0.413,18.245,2,riffle_clumpy
0,18,24,2,44,0.409,20,0.455,3,2,0.6,1,3,26,18,11,12,21,0.25,0.273,0.477,18.123,3,riffle_clumpy
0,19,25,2,46,0.413,21,0.457,2,7,0.222,1,2,26,20,10,16,20,0.217,0.348,0.435,18.282,4,riffle_clumpy
0,23,19,2,44,0.523,25,0.568,2,1,0.667,0,3,26,18,15,11,18,0.341,0.25,0.409,18.154,5,riffle_clumpy
0,19,20,5,44,0.432,24,0.545,3,1,0.75,0,3,26,18,11,15,18,0.25,0.341,0.409,18.182,6,riffle_clumpy
0,19,22,1,42,0.452,20,0.476,3,2,0.6,0,1,21,21,14,12,16,0.333,0.286,0.381,18.237,7,riffle_clumpy
0,20,21,4,45,0.444,24,0.533,2,1,0.667,3,1,27,18,11,12,22,0.244,0.267,0.489,18.122,8,riffle_clumpy
0,15,25,4,44,0.341,19,0.432,3,2,0.6,2,1,32,12,7,10,27,0.159,0.227,0.614,17.996,9,riffle_clumpy
0,12,32,3,47,0.255,15,0.319,1,3,0.25,1,2,28,19,5,22,20,0.106,0.468,0.426,18.045,10,riffle_clumpy
0,18,23,5,46,0.391,23,0.5,1,1,0.5,2,1,31,15,9,19,18,0.196,0.413,0.391,17.968,11,riffle_clumpy
0,18,24,3,45,0.4,21,0.467,6,3,0.667,3,1,29,16,7,12,26,0.156,0.267,0.578,17.957,12,riffle_clumpy
0,25,17,3,45,0.556,28,0.622,2,2,0.5,4,2,28,17,13,12,20,0.289,0.267,0.444,17.957,13,riffle_clumpy
0,19,21,4,44,0.432,23,0.523,2,0,1.0,2,3,29,15,10,10,24,0.227,0.227,0.545,17.938,14,riffle_clumpy
0,20,19,3,42,0.476,23,0.548,2,3,0.4,1,0,23,19,13,10,19,0.31,0.238,0.452,17.912,15,riffle_clumpy
0,17,25,5,47,0.362,22,0.468,1,1,0.5,0,0,30,17,8,19,20,0.17,0.404,0.426,17.884,16,riffle_clumpy
0,20,22,4,46,0.435,24,0.522,5,1,0.833,2,2,31,15,10,11,25,0.217,0.239,0.543,17.859,17,riffle_clumpy
0,14,27,5,46,0.304,19,0.413,2,2,0.5,1,3,27,19,10,15,21,0.217,0.326,0.457,17.88,18,riffle_clumpy
0,19,21,3,43,0.442,22,0.512,5,5,0.5,3,1,28,15,10,12,21,0.233,0.279,0.488,17.89,19,riffle_clumpy
0,24,16,5,45,0.533,29,0.644,2,4,0.333,2,1,28,17,14,14,17,0.311,0.311,0.378,17.856,20,riffle_clumpy
0,14,23,7,44,0.318,21,0.477,2,0,1.0,2,2,31,13,7,17,20,0.159,0.386,0.455,17.847,21,riffle_clumpy
0,20,21,4,45,0.444,24,0.533,1,4,0.2,2,1,32,13,11,14,20,0.244,0.311,0.444,17.857,22,riffle_clumpy
0,20,19,5,44,0.455,25,0.568,1,2,0.333,2,2,22,22,15,15,14,0.341,0.341,0.318,17.87,23,riffle_clumpy
0,21,22,4,47,0.447,25,0.532,7,2,0.778,1,3,25,22,12,14,21,0.255,0.298,0.447,17.9,24,riffle_clumpy
0,23,20,3,46,0.5,26,0.565,4,4,0.5,2,4,27,19,17,11,18,0.37,0.239,0.391,17.907,25,riffle_clumpy
0,21,20,5,46,0.457,26,0.565,0,5,0.0,4,2,28,18,12,17,17,0.261,0.37,0.37,17.917,26,riffle_clumpy
0,20,20,5,45,0.444,25,0.556,3,3,0.5,0,3,27,18,15,13,17,0.333,0.289,0.378,17.911,27,riffle_clumpy
0,16,28,1,45,0.356,17,0.378,2,0,1.0,1,2,35,10,6,16,23,0.133,0.356,0.511,17.882,28,riffle_clumpy
0,22,19,4,45,0.489,26,0.578,4,4,0.5,1,0,26,19,15,14,16,0.333,0.311,0.356,17.909,29,riffle_clumpy
0,19,24,3,46,0.413,22,0.478,1,1,0.5,1,2,30,16,4,17,25,0.087,0.37,0.543,17.893,30,riffle_clumpy
0,20,21,3,44,0.455,23,0.523,5,2,0.714,2,0,28,16,13,13,18,0.295,0.295,0.409,17.892,31,riffle_clumpy
0,20,18,7,45,0.444,27,0.6,4,1,0.8,2,3,27,18,9,13,23,0.2,0.289,0.511,17.901,32,riffle_clumpy
0,21,19,3,43,0.488,24,0.558,5,2,0.714,1,2,24,19,15,14,14,0.349,0.326,0.326,17.883,33,riffle_clumpy
0,25,19,3,47,0.532,28,0.596,4,2,0.667,5,1,30,17,10,19,18,0.213,0.404,0.383,17.867,34,riffle_clumpy
0,18,24,2,44,0.409,20,0.455,5,3,0.625,1,2,28,16,13,9,22,0.295,0.205,0.5,17.869,35,riffle_clumpy
0,21,21,4,46,0.457,25,0.543,3,2,0.6,4,4,35,11,11,12,23,0.239,0.261,0.5,17.86,36,riffle_clumpy
0,16,22,6,44,0.364,22,0.5,3,4,0.429,1,3,27,17,11,17,16,0.25,0.386,0.364,17.86,37,riffle_clumpy
0,12,27,5,44,0.273,17,0.386,1,0,1.0,1,0,32,12,7,14,23,0.159,0.318,0.523,17.864,38,riffle_clumpy
0,16,26,3,45,0.356,19,0.422,2,2,0.5,1,2,26,19,8,17,20,0.178,0.378,0.444,17.871,39,riffle_clumpy
0,20,20,4,44,0.455,24,0.545,5,1,0.833,2,1,28,16,13,10,21,0.295,0.227,0.477,17.851,40,riffle_clumpy
0,17,25,4,46,0.37,21,0.457,1,0,1.0,2,2,27,19,7,22,17,0.152,0.478,0.37,17.835,41,riffle_clumpy
0,26,16,2,44,0.591,28,0.636,4,1,0.8,0,4,26,18,15,15,14,0.341,0.341,0.318,17.842,42,riffle_clumpy
0,18,23,3,44,0.409,21,0.477,4,2,0.667,1,2,26,18,10,16,18,0.227,0.364,0.409,17.848,43,riffle_clumpy
0,21,20,5,46,0.457,26,0.565,2,2,0.5,4,1,30,16,10,12,24,0.217,0.261,0.522,17.842,44,riffle_clumpy
0,16,24,4,44,0.364,20,0.455,3,3,0.5,0,4,20,24,10,15,19,0.227,0.341,0.432,17.826,45,riffle_clumpy
0,15,27,6,48,0.312,21,0.438,1,2,0.333,4,4,29,19,7,16,25,0.146,0.333,0.521,17.798,46,riffle_clumpy
0,21,19,4,44,0.477,25,0.568,5,1,0.833,1,3,30,14,15,10,19,0.341,0.227,0.432,17.804,47,riffle_clumpy
0,20,20,4,44,0.455,24,0.545,3,3,0.5,4,0,24,20,11,12,21,0.25,0.273,0.477,17.787,48,riffle_clumpy
0,23,21,1,45,0.511,24,0.533,4,3,0.571,4,0,32,13,8,14,23,0.178,0.311,0.511,17.791,49,riffle_clumpy
0,14,23,8,45,0.311,22,0.489,2,6,0.25,1,1,26,19,7,21,17,0.156,0.467,0.378,17.802,50,riffle_clumpy
0,18,23,3,44,0.409,21,0.477,5,5,0.5,1,3,29,15,12,9,23,0.273,0.205,0.523,17.808,51,riffle_clumpy
0,27,18,2,47,0.574,29,0.617,6,0,1.0,4,2,33,14,11,10,26,0.234,0.213,0.553,17.803,52,riffle_clumpy
0,24,19,3,46,0.522,27,0.587,3,3,0.5,2,1,26,20,17,9,20,0.37,0.196,0.435,17.785,53,riffle_clumpy
0,23,17,3,43,0.535,26,0.605,3,4,0.429,0,1,29,14,12,12,19,0.279,0.279,0.442,17.796,54,riffle_clumpy
0,17,24,5,46,0.37,22,0.478,3,3,0.5,3,2,31,15,6,14,26,0.13,0.304,0.565,17.792,55,riffle_clumpy
0,21,20,4,45,0.467,25,0.556,1,2,0.333,2,3,27,18,11,16,18,0.244,0.356,0.4,17.78,56,riffle_clumpy
0,18,24,4,46,0.391,22,0.478,3,1,0.75,2,4,31,15,12,10,24,0.261,0.217,0.522,17.782,57,riffle_clumpy
0,18,23,3,44,0.409,21,0.477,2,1,0.667,3,1,32,12,7,15,22,0.159,0.341,0.5,17.785,58,riffle_clumpy
0,14,26,3,43,0.326,17,0.395,5,3,0.625,0,3,32,11,11,10,22,0.256,0.233,0.512,17.786,59,riffle_clumpy
0,20,17,8,45,0.444,28,0.622,5,1,0.833,4,1,26,19,13,15,17,0.289,0.333,0.378,17.783,60,riffle_clumpy
0,22,19,4,45,0.489,26,0.578,5,5,0.5,2,2,26,19,16,11,18,0.356,0.244,0.4,17.784,61,riffle_clumpy
0,20,23,3,46,0.435,23,0.5,1,1,0.5,3,4,30,16,11,15,20,0.239,0.326,0.435,17.775,62,riffle_clumpy
0,24,20,3,47,0.511,27,0.574,3,3,0.5,4,4,28,19,9,17,21,0.191,0.362,0.447,17.773,63,riffle_clumpy
0,16,23,6,45,0.356,22,0.489,6,1,0.857,0,1,30,15,9,11,25,0.2,0.244,0.556,17.777,64,riffle_clumpy
0,17,21,6,44,0.386,23,0.523,2,3,0.4,2,3,29,15,10,11,23,0.227,0.25,0.523,17.764,65,riffle_clumpy
0,22,19,4,45,0.489,26,0.578,2,1,0.667,3,1,24,21,13,17,15,0.289,0.378,0.333,17.759,66,riffle_clumpy
0,23,21,4,48,0.479,27,0.562,2,5,0.286,3,2,34,14,7,12,29,0.146,0.25,0.604,17.758,67,riffle_clumpy
0,18,28,1,47,0.383,19,0.404,3,3,0.5,2,3,30,17,6,13,28,0.128,0.277,0.596,17.754,68,riffle_clumpy
0,21,18,6,45,0.467,27,0.6,4,2,0.667,2,1,25,20,11,12,22,0.244,0.267,0.489,17.741,69,riffle_clumpy
0,18,21,4,43,0.419,22,0.512,2,2,0.5,2,1,28,15,11,16,16,0.256,0.372,0.372,17.733,70,riffle_clumpy
0,17,19,8,44,0.386,25,0.568,2,2,0.5,0,2,28,16,11,13,20,0.25,0.295,0.455,17.741,71,riffle_clumpy
0,17,24,5,46,0.37,22,0.478,2,2,0.5,2,4,30,16,5,18,23,0.109,0.391,0.5,17.75,72,riffle_clumpy
0,18,21,6,45,0.4,24,0.533,3,2,0.6,0,5,29,16,10,13,22,0.222,0.289,0.489,17.755,73,riffle_clumpy
0,19,24,5,48,0.396,24,0.5,2,1,0.667,6,0,28,20,9,14,25,0.188,0.292,0.521,17.748,74,riffle_clumpy
0,18,27,3,48,0.375,21,0.438,1,2,0.333,3,2,31,17,9,11,28,0.188,0.229,0.583,17.737,75,riffle_clumpy
0,18,24,5,47,0.383,23,0.489,0,0,0,2,2,35,12,13,10,24,0.277,0.213,0.511,17.728,76,riffle_clumpy
0,16,26,2,44,0.364,18,0.409,3,2,0.6,0,1,28,16,12,13,19,0.273,0.295,0.432,17.722,77,riffle_clumpy
0,23,15,6,44,0.523,29,0.659,1,2,0.333,3,2,26,18,15,10,19,0.341,0.227,0.432,17.719,78,riffle_clumpy
0,21,21,4,46,0.457,25,0.543,5,3,0.625,2,3,28,18,16,7,23,0.348,0.152,0.5,17.716,79,riffle_clumpy
0,21,20,3,44,0.477,24,0.545,2,5,0.286,3,1,25,19,14,12,18,0.318,0.273,0.409,17.707,80,riffle_clumpy
0,19,20,5,44,0.432,24,0.545,2,1,0.667,3,0,30,14,6,16,22,0.136,0.364,0.5,17.704,81,riffle_clumpy
0,20,22,4,46,0.435,24,0.522,2,6,0.25,3,2,31,15,10,14,22,0.217,0.304,0.478,17.707,82,riffle_clumpy
0,25,17,3,45,0.556,28,0.622,5,1,0.833,4,3,29,16,14,9,22,0.311,0.2,0.489,17.698,83,riffle_clumpy
0,24,17,3,44,0.545,27,0.614,3,1,0.75,3,1,28,16,13,12,19,0.295,0.273,0.432,17.705,84,riffle_clumpy
0,21,22,4,47,0.447,25,0.532,3,2,0.6,1,3,24,23,14,17,16,0.298,0.362,0.34,17.708,85,riffle_clumpy
0,23,19,7,49,0.469,30,0.612,2,0,1.0,2,0,30,19,14,15,20,0.286,0.306,0.408,17.709,86,riffle_clumpy
0,18,24,3,45,0.4,21,0.467,2,4,0.333,2,4,29,16,9,13,23,0.2,0.289,0.511,17.709,87,riffle_clumpy
0,21,19,4,44,0.477,25,0.568,4,3,0.571,2,2,24,20,11,12,21,0.25,0.273,0.477,17.708,88,riffle_clumpy
0,15,22,7,44,0.341,22,0.5,4,1,0.8,2,1,30,14,7,13,24,0.159,0.295,0.545,17.71,89,riffle_clumpy
0,20,23,1,44,0.455,21,0.477,4,1,0.8,2,2,29,15,10,11,23,0.227,0.25,0.523,17.7,90,riffle_clumpy
0,16,28,2,46,0.348,18,0.391,4,2,0.667,0,5,24,22,13,17,16,0.283,0.37,0.348,17.699,91,riffle_clumpy
0,20,27,2,49,0.408,22,0.449,2,5,0.286,6,1,26,23,11,16,22,0.224,0.327,0.449,17.697,92,riffle_clumpy
0,18,19,9,46,0.391,27,0.587,2,2,0.5,2,3,24,22,10,14,22,0.217,0.304,0.478,17.698,93,riffle_clumpy
0,19,24,2,45,0.422,21,0.467,3,3,0.5,3,2,26,19,10,13,22,0.222,0.289,0.489,17.698,94,riffle_clumpy
0,19,22,3,44,0.432,22,0.5,4,0,1.0,3,3,27,17,12,11,21,0.273,0.25,0.477,17.696,95,riffle_clumpy
0,26,20,2,48,0.542,28,0.583,3,1,0.75,2,1,29,19,17,13,18,0.354,0.271,0.375,17.694,96,riffle_clumpy
0,21,12,10,43,0.488,31,0.721,3,2,0.6,0,0,28,15,12,15,16,0.279,0.349,0.372,18.8,1,riffle_clumpy
0,22,16,7,45,0.489,29,0.644,4,1,0.8,2,2,27,18,12,16,17,0.267,0.356,0.378,18.193,2,riffle_clumpy
0,22,16,6,44,0.5,28,0.636,2,2,0.5,1,1,29,15,13,11,20,0.295,0.25,0.455,18.105,3,riffle_clumpy
0,15,30,6,51,0.294,21,0.412,3,5,0.375,4,3,28,23,6,21,24,0.118,0.412,0.471,17.932,4,riffle_clumpy
0,21,20,5,46,0.457,26,0.565,2,2,0.5,2,2,30,16,12,12,22,0.261,0.261,0.478,17.946,5,riffle_clumpy
0,28,17,2,47,0.596,30,0.638,6,4,0.6,3,0,14,33,20,18,9,0.426,0.383,0.191,17.857,6,riffle_clumpy
0,21,21,4,46,0.457,25,0.543,4,2,0.667,0,4,28,18,13,10,23,0.283,0.217,0.5,17.871,7,riffle_clumpy
0,25,16,4,45,0.556,29,0.644,4,2,0.667,4,3,26,19,12,16,17,0.267,0.356,0.378,17.779,8,riffle_clumpy
0,20,24,2,46,0.435,22,0.478,4,3,0.571,1,2,30,16,10,16,20,0.217,0.348,0.435,17.732,9,riffle_clumpy
0,23,20,6,49,0.469,29,0.592,4,5,0.444,2,5,31,18,12,11,26,0.245,0.224,0.531,17.724,10,riffle_clumpy
0,20,21,4,45,0.444,24,0.533,0,2,0.0,1,1,25,20,11,18,16,0.244,0.4,0.356,17.755,11,riffle_clumpy
0,18,22,4,44,0.409,22,0.5,4,2,0.667,1,4,32,12,13,9,22,0.295,0.205,0.5,17.733,12,riffle_clumpy
0,20,22,4,46,0.435,24,0.522,5,3,0.625,5,1,23,23,13,16,17,0.283,0.348,0.37,17.735,13,riffle_clumpy
0,18,21,7,46,0.391,25,0.543,2,2,0.5,3,2,29,17,8,15,23,0.174,0.326,0.5,17.745,14,riffle_clumpy
0,15,23,6,44,0.341,21,0.477,3,2,0.6,3,3,26,18,10,15,19,0.227,0.341,0.432,17.738,15,riffle_clumpy
0,17,25,3,45,0.378,20,0.444,2,4,0.333,0,4,27,18,9,14,22,0.2,0.311,0.489,17.748,16,riffle_clumpy
0,19,23,3,45,0.422,22,0.489,6,0,1.0,1,6,33,12,11,10,24,0.244,0.222,0.533,17.743,17,riffle_clumpy
0,23,16,3,42,0.548,26,0.619,3,1,0.75,2,1,27,15,12,16,14,0.286,0.381,0.333,17.771,18,riffle_clumpy
0,23,20,6,49,0.469,29,0.592,5,0,1.0,3,3,25,24,11,19,19,0.224,0.388,0.388,17.759,19,riffle_clumpy
0,16,22,5,43,0.372,21,0.488,3,4,0.429,0,0,26,17,8,18,17,0.186,0.419,0.395,17.781,20,riffle_clumpy
0,18,28,0,46,0.391,18,0.391,4,1,0.8,2,5,30,16,9,10,27,0.196,0.217,0.587,17.73,21,riffle_clumpy
0,23,15,5,43,0.535,28,0.651,3,3,0.5,1,1,28,15,14,15,14,0.326,0.349,0.326,17.724,22,riffle_clumpy
0,22,21,5,48,0.458,27,0.562,4,1,0.8,2,3,32,16,7,15,26,0.146,0.312,0.542,17.705,23,riffle_clumpy
0,19,25,1,45,0.422,20,0.444,3,2,0.6,1,2,27,18,8,16,21,0.178,0.356,0.467,17.692,24,riffle_clumpy
0,17,21,7,45,0.378,24,0.533,6,2,0.75,1,2,25,20,13,13,19,0.289,0.289,0.422,17.708,25,riffle_clumpy
0,14,26,5,45,0.311,19,0.422,4,0,1.0,1,4,29,16,7,15,23,0.156,0.333,0.511,17.722,26,riffle_clumpy
0,27,19,3,49,0.551,30,0.612,4,2,0.667,2,4,25,24,15,18,16,0.306,0.367,0.327,17.726,27,riffle_clumpy
0,23,20,4,47,0.489,27,0.574,3,0,1.0,5,1,27,20,11,13,23,0.234,0.277,0.489,17.689,28,riffle_clumpy
0,19,25,1,45,0.422,20,0.444,2,0,1.0,3,2,24,21,10,16,19,0.222,0.356,0.422,17.676,29,riffle_clumpy
0,23,18,3,44,0.523,26,0.591,3,3,0.5,2,2,32,12,10,13,21,0.227,0.295,0.477,17.703,30,riffle_clumpy
0,19,20,6,45,0.422,25,0.556,7,3,0.7,1,1,23,22,10,18,17,0.222,0.4,0.378,17.701,31,riffle_clumpy
0,25,20,2,47,0.532,27,0.574,4,4,0.5,3,2,26,21,13,15,19,0.277,0.319,0.404,17.717,32,riffle_clumpy
0,19,20,4,43,0.442,23,0.535,3,2,0.6,2,1,25,18,13,13,17,0.302,0.302,0.395,17.712,33,riffle_clumpy
0,21,21,3,45,0.467,24,0.533,2,3,0.4,2,3,22,23,13,16,16,0.289,0.356,0.356,17.722,34,riffle_clumpy
0,24,19,2,45,0.533,26,0.578,4,0,1.0,1,2,28,17,16,14,15,0.356,0.311,0.333,17.728,35,riffle_clumpy
0,19,21,4,44,0.432,23,0.523,4,3,0.571,1,2,24,20,9,16,19,0.205,0.364,0.432,17.729,36,riffle_clumpy
0,18,24,5,47,0.383,23,0.489,3,5,0.375,2,3,30,17,7,17,23,0.149,0.362,0.489,17.73,37,riffle_clumpy
0,21,19,5,45,0.467,26,0.578,2,2,0.5,2,5,34,11,11,13,21,0.244,0.289,0.467,17.747,38,riffle_clumpy
0,16,27,3,46,0.348,19,0.413,3,5,0.375,3,4,29,17,9,13,24,0.196,0.283,0.522,17.726,39,riffle_clumpy
0,21,19,5,45,0.467,26,0.578,3,2,0.6,3,3,27,18,12,14,19,0.267,0.311,0.422,17.74,40,riffle_clumpy
0,21,23,3,47,0.447,24,0.511,3,2,0.6,3,3,31,16,8,13,26,0.17,0.277,0.553,17.718,41,riffle_clumpy
0,14,28,5,47,0.298,19,0.404,3,2,0.6,0,3,26,21,10,17,20,0.213,0.362,0.426,17.716,42,riffle_clumpy
0,20,22,4,46,0.435,24,0.522,2,0,1.0,0,6,35,11,8,9,29,0.174,0.196,0.63,17.725,43,riffle_clumpy
0,25,20,1,46,0.543,26,0.565,6,1,0.857,3,0,28,18,12,17,17,0.261,0.37,0.37,17.726,44,riffle_clumpy
0,21,23,4,48,0.438,25,0.521,2,1,0.667,3,0,28,20,10,15,23,0.208,0.312,0.479,17.711,45,riffle_clumpy
0,20,22,3,45,0.444,23,0.511,3,1,0.75,3,4,29,16,12,13,20,0.267,0.289,0.444,17.721,46,riffle_clumpy
0,18,26,3,47,0.383,21,0.447,7,2,0.778,2,5,26,21,10,17,20,0.213,0.362,0.426,17.723,47,riffle_clumpy
0,23,25,1,49,0.469,24,0.49,1,2,0.333,3,4,34,15,12,10,27,0.245,0.204,0.551,17.712,48,riffle_clumpy
0,20,23,2,45,0.444,22,0.489,2,3,0.4,2,2,30,15,12,10,23,0.267,0.222,0.511,17.694,49,riffle_clumpy
0,21,22,1,44,0.477,22,0.5,2,1,0.667,1,3,29,15,10,13,21,0.227,0.295,0.477,17.687,50,riffle_clumpy
0,23,23,5,51,0.451,28,0.549,3,3,0.5,2,4,31,20,19,14,18,0.373,0.275,0.353,17.691,51,riffle_clumpy
0,24,19,5,48,0.5,29,0.604,1,3,0.25,4,1,31,17,11,17,20,0.229,0.354,0.417,17.683,52,riffle_clumpy
0,20,24,3,47,0.426,23,0.489,0,1,0.0,5,3,26,21,10,19,18,0.213,0.404,0.383,17.686,53,riffle_clumpy
0,12,34,4,50,0.24,16,0.32,2,4,0.333,1,3,30,20,8,16,26,0.16,0.32,0.52,17.698,54,riffle_clumpy
0,22,17,5,44,0.5,27,0.614,5,1,0.833,4,2,26,18,13,11,20,0.295,0.25,0.455,17.696,55,riffle_clumpy
0,16,26,5,47,0.34,21,0.447,4,4,0.5,2,3,28,19,9,17,21,0.191,0.362,0.447,17.705,56,riffle_clumpy
0,21,24,3,48,0.438,24,0.5,3,1,0.75,5,1,30,18,12,12,24,0.25,0.25,0.5,17.71,57,riffle_clumpy
0,18,27,1,46,0.391,19,0.413,4,2,0.667,0,2,33,13,9,13,24,0.196,0.283,0.522,17.716,58,riffle_clumpy
0,20,20,6,46,0.435,26,0.565,6,4,0.6,1,2,28,18,10,14,22,0.217,0.304,0.478,17.725,59,riffle_clumpy
0,16,22,6,44,0.364,22,0.5,1,3,0.25,3,1,28,16,10,18,16,0.227,0.409,0.364,17.726,60,riffle_clumpy
0,18,28,1,47,0.383,19,0.404,5,3,0.625,0,0,27,20,14,14,19,0.298,0.298,0.404,17.728,61,riffle_clumpy
0,20,23,4,47,0.426,24,0.511,2,3,0.4,3,1,24,23,13,16,18,0.277,0.34,0.383,17.723,62,riffle_clumpy
0,23,17,5,45,0.511,28,0.622,5,1,0.833,2,0,24,21,11,15,19,0.244,0.333,0.422,17.727,63,riffle_clumpy
0,27,17,1,45,0.6,28,0.622,3,1,0.75,3,2,24,21,14,12,19,0.311,0.267,0.422,17.726,64,riffle_clumpy
0,25,17,3,45,0.556,28,0.622,4,1,0.8,4,1,23,22,14,13,18,0.311,0.289,0.4,17.717,65,riffle_clumpy
0,16,28,3,47,0.34,19,0.404,2,1,0.667,0,2,31,16,9,14,24,0.191,0.298,0.511,17.719,66,riffle_clumpy
0,16,22,7,45,0.356,23,0.511,1,1,0.5,0,1,33,12,6,19,20,0.133,0.422,0.444,17.725,67,riffle_clumpy
0,13,30,2,45,0.289,15,0.333,2,4,0.333,3,2,24,21,5,20,20,0.111,0.444,0.444,17.739,68,riffle_clumpy
0,14,31,4,49,0.286,18,0.367,2,4,0.333,2,3,28,21,6,18,25,0.122,0.367,0.51,17.737,69,riffle_clumpy
0,20,24,2,46,0.435,22,0.478,3,1,0.75,3,4,30,16,11,14,21,0.239,0.304,0.457,17.734,70,riffle_clumpy
0,13,26,4,43,0.302,17,0.395,3,2,0.6,1,4,29,14,11,11,21,0.256,0.256,0.488,17.737,71,riffle_clumpy
0,20,27,1,48,0.417,21,0.438,1,4,0.2,3,2,28,20,11,17,20,0.229,0.354,0.417,17.732,72,riffle_clumpy
0,22,23,3,48,0.458,25,0.521,1,1,0.5,2,1,25,23,11,20,17,0.229,0.417,0.354,17.723,73,riffle_clumpy
0,23,20,3,46,0.5,26,0.565,4,4,0.5,6,1,25,21,11,12,23,0.239,0.261,0.5,17.727,74,riffle_clumpy
0,14,23,7,44,0.318,21,0.477,0,3,0.0,1,2,28,16,7,15,22,0.159,0.341,0.5,17.726,75,riffle_clumpy
0,14,31,1,46,0.304,15,0.326,3,2,0.6,0,4,24,22,12,14,20,0.261,0.304,0.435,17.733,76,riffle_clumpy
0,23,16,6,45,0.511,29,0.644,2,0,1.0,4,3,25,20,14,10,21,0.311,0.222,0.467,17.728,77,riffle_clumpy
0,17,23,4,44,0.386,21,0.477,3,1,0.75,1,3,22,22,12,17,15,0.273,0.386,0.341,17.732,78,riffle_clumpy
0,24,16,5,45,0.533,29,0.644,6,3,0.667,0,1,29,16,13,12,20,0.289,0.267,0.444,17.735,79,riffle_clumpy
0,19,21,3,43,0.442,22,0.512,7,2,0.778,0,2,28,15,12,10,21,0.279,0.233,0.488,17.736,80,riffle_clumpy
0,17,26,5,48,0.354,22,0.458,5,2,0.714,2,3,30,18,5,22,21,0.104,0.458,0.438,17.739,81,riffle_clumpy
0,22,19,4,45,0.489,26,0.578,4,3,0.571,1,1,23,22,14,14,17,0.311,0.311,0.378,17.74,82,riffle_clumpy
0,21,22,3,46,0.457,24,0.522,1,3,0.25,3,2,23,23,11,16,19,0.239,0.348,0.413,17.739,83,riffle_clumpy
0,19,19,5,43,0.442,24,0.558,5,2,0.714,2,0,29,14,10,14,19,0.233,0.326,0.442,17.727,84,riffle_clumpy
0,16,25,3,44,0.364,19,0.432,1,4,0.2,2,2,24,20,8,19,17,0.182,0.432,0.386,17.722,85,riffle_clumpy
0,18,26,3,47,0.383,21,0.447,2,7,0.222,3,3,31,16,7,19,21,0.149,0.404,0.447,17.717,86,riffle_clumpy
0,23,20,4,47,0.489,27,0.574,4,3,0.571,3,2,32,15,8,16,23,0.17,0.34,0.489,17.713,87,riffle_clumpy
0,14,26,6,46,0.304,20,0.435,2,1,0.667,5,1,28,18,3,16,27,0.065,0.348,0.587,17.707,88,riffle_clumpy
0,25,18,4,47,0.532,29,0.617,0,0,0,2,2,35,12,16,8,23,0.34,0.17,0.489,17.709,89,riffle_clumpy
0,27,14,6,47,0.574,33,0.702,8,1,0.889,4,1,25,22,16,11,20,0.34,0.234,0.426,17.713,90,riffle_clumpy
0,19,20,7,46,0.413,26,0.565,3,4,0.429,3,3,25,21,7,16,23,0.152,0.348,0.5,17.707,91,riffle_clumpy
0,14,24,7,45,0.311,21,0.467,2,4,0.333,2,5,29,16,7,11,27,0.156,0.244,0.6,17.699,92,riffle_clumpy
0,18,24,3,45,0.4,21,0.467,0,1,0.0,2,1,27,18,8,16,21,0.178,0.356,0.467,17.7,93,riffle_clumpy
0,13,24,7,44,0.295,20,0.455,3,1,0.75,1,3,26,18,9,17,18,0.205,0.386,0.409,17.703,94,riffle_clumpy
0,22,22,3,47,0.468,25,0.532,0,3,0.0,3,0,25,22,8,16,23,0.17,0.34,0.489,17.7,95,riffle_clumpy
0,23,20,3,46,0.5,26,0.565,6,2,0.75,2,2,25,21,11,15,20,0.239,0.326,0.435,17.699,96,riffle_clumpy
0,24,17,4,45,0.533,28,0.622,4,3,0.571,3,0,28,17,8,16,21,0.178,0.356,0.467,17.969,1,riffle_clumpy
0,24,19,3,46,0.522,27,0.587,1,1,0.5,1,1,24,22,17,9,20,0.37,0.196,0.435,17.867,2,riffle_clumpy
0,21,24,2,47,0.447,23,0.489,3,3,0.5,2,2,24,23,13,13,21,0.277,0.277,0.447,17.625,3,riffle_clumpy
0,18,23,4,45,0.4,22,0.489,1,2,0.333,2,4,24,21,10,15,20,0.222,0.333,0.444,17.698,4,riffle_clumpy
0,24,19,3,46,0.522,27,0.587,4,6,0.4,2,2,26,20,11,14,21,0.239,0.304,0.457,17.694,5,riffle_clumpy
0,21,24,4,49,0.429,25,0.51,5,1,0.833,3,3,32,17,9,13,27,0.184,0.265,0.551,17.565,6,riffle_clumpy
0,22,19,4,45,0.489,26,0.578,5,2,0.714,4,2,27,18,14,11,20,0.311,0.244,0.444,17.561,7,riffle_clumpy
0,22,18,5,45,0.489,27,0.6,1,3,0.25,2,1,27,18,13,18,14,0.289,0.4,0.311,17.56,8,riffle_clumpy
0,22,20,3,45,0.489,25,0.556,7,2,0.778,1,1,24,21,15,15,15,0.333,0.333,0.333,17.605,9,riffle_clumpy
0,15,26,5,46,0.326,20,0.435,6,1,0.857,2,4,26,20,6,22,18,0.13,0.478,0.391,17.55,10,riffle_clumpy
0,15,26,6,47,0.319,21,0.447,2,0,1.0,3,7,33,14,11,8,28,0.234,0.17,0.596,17.498,11,riffle_clumpy
0,26,15,2,43,0.605,28,0.651,4,1,0.8,2,3,26,17,15,9,19,0.349,0.209,0.442,17.522,12,riffle_clumpy
0,20,22,4,46,0.435,24,0.522,7,3,0.7,1,2,28,18,9,18,19,0.196,0.391,0.413,17.586,13,riffle_clumpy
0,22,18,4,44,0.5,26,0.591,3,1,0.75,3,0,23,21,10,14,20,0.227,0.318,0.455,17.55,14,riffle_clumpy
0,24,17,3,44,0.545,27,0.614,8,1,0.889,4,2,25,19,10,11,23,0.227,0.25,0.523,17.514,15,riffle_clumpy
0,17,25,4,46,0.37,21,0.457,4,2,0.667,2,2,31,15,12,9,25,0.261,0.196,0.543,17.517,16,riffle_clumpy
0,15,27,6,48,0.312,21,0.438,3,1,0.75,2,2,28,20,7,20,21,0.146,0.417,0.438,17.527,17,riffle_clumpy
0,19,23,3,45,0.422,22,0.489,2,3,0.4,3,3,29,16,8,12,25,0.178,0.267,0.556,17.491,18,riffle_clumpy
0,21,21,4,46,0.457,25,0.543,4,3,0.571,3,1,27,19,12,12,22,0.261,0.261,0.478,17.504,19,riffle_clumpy
0,19,22,6,47,0.404,25,0.532,1,0,1.0,1,5,30,17,9,19,19,0.191,0.404,0.404,17.538,20,riffle_clumpy
0,26,17,3,46,0.565,29,0.63,3,1,0.75,2,3,23,23,19,8,19,0.413,0.174,0.413,17.549,21,riffle_clumpy
0,14,27,5,46,0.304,19,0.413,2,1,0.667,0,3,32,14,8,13,25,0.174,0.283,0.543,17.569,22,riffle_clumpy
0,18,23,4,45,0.4,22,0.489,4,2,0.667,2,0,24,21,10,17,18,0.222,0.378,0.4,17.595,23,riffle_clumpy
0,19,23,7,49,0.388,26,0.531,2,9,0.182,3,0,34,15,8,17,24,0.163,0.347,0.49,17.623,24,riffle_clumpy
0,22,22,2,46,0.478,24,0.522,1,2,0.333,1,2,19,27,17,13,16,0.37,0.283,0.348,17.633,25,riffle_clumpy
0,15,25,6,46,0.326,21,0.457,5,0,1.0,0,4,29,17,6,13,27,0.13,0.283,0.587,17.644,26,riffle_clumpy
0,22,17,6,45,0.489,28,0.622,5,3,0.625,4,1,26,19,12,10,23,0.267,0.222,0.511,17.609,27,riffle_clumpy
0,22,23,2,47,0.468,24,0.511,2,1,0.667,2,3,30,17,8,17,22,0.17,0.362,0.468,17.614,28,riffle_clumpy
0,15,25,6,46,0.326,21,0.457,2,0,1.0,3,2,27,19,6,16,24,0.13,0.348,0.522,17.603,29,riffle_clumpy
0,18,25,2,45,0.4,20,0.444,1,2,0.333,4,2,24,21,9,18,18,0.2,0.4,0.4,17.607,30,riffle_clumpy
0,21,23,1,45,0.467,22,0.489,1,1,0.5,3,6,30,15,14,7,24,0.311,0.156,0.533,17.602,31,riffle_clumpy
0,19,25,5,49,0.388,24,0.49,2,3,0.4,0,2,29,20,11,18,20,0.224,0.367,0.408,17.596,32,riffle_clumpy
0,22,23,1,46,0.478,23,0.5,3,4,0.429,2,1,23,23,15,12,19,0.326,0.261,0.413,17.582,33,riffle_clumpy
0,19,24,4,47,0.404,23,0.489,5,2,0.714,2,1,29,18,8,15,24,0.17,0.319,0.511,17.593,34,riffle_clumpy
0,18,23,4,45,0.4,22,0.489,5,2,0.714,3,1,26,19,9,17,19,0.2,0.378,0.422,17.595,35,riffle_clumpy
0,18,26,1,45,0.4,19,0.422,1,3,0.25,2,3,27,18,10,16,19,0.222,0.356,0.422,17.607,36,riffle_clumpy
0,21,21,4,46,0.457,25,0.543,1,5,0.167,1,1,30,16,8,18,20,0.174,0.391,0.435,17.617,37,riffle_clumpy
0,17,23,8,48,0.354,25,0.521,3,5,0.375,0,4,29,19,9,17,22,0.188,0.354,0.458,17.638,38,riffle_clumpy
0,21,21,2,44,0.477,23,0.523,4,2,0.667,1,3,27,17,9,12,23,0.205,0.273,0.523,17.62,39,riffle_clumpy
0,20,24,2,46,0.435,22,0.478,1,2,0.333,0,1,24,22,12,17,17,0.261,0.37,0.37,17.613,40,riffle_clumpy
0,21,23,1,45,0.467,22,0.489,6,4,0.6,3,3,22,23,10,17,18,0.222,0.378,0.4,17.619,41,riffle_clumpy
0,18,24,2,44,0.409,20,0.455,2,2,0.5,0,4,28,16,10,15,19,0.227,0.341,0.432,17.646,42,riffle_clumpy
0,19,23,4,46,0.413,23,0.5,2,1,0.667,1,2,27,19,10,16,20,0.217,0.348,0.435,17.648,43,riffle_clumpy
0,12,29,4,45,0.267,16,0.356,2,1,0.667,1,3,34,11,6,16,23,0.133,0.356,0.511,17.649,44,riffle_clumpy
0,19,20,8,47,0.404,27,0.574,3,2,0.6,2,5,33,14,10,14,23,0.213,0.298,0.489,17.661,45,riffle_clumpy
0,22,21,1,44,0.5,23,0.523,4,2,0.667,1,4,28,16,13,12,19,0.295,0.273,0.432,17.661,46,riffle_clumpy
0,19,24,3,46,0.413,22,0.478,5,2,0.714,0,1,30,16,14,9,23,0.304,0.196,0.5,17.677,47,riffle_clumpy
0,23,22,1,46,0.5,24,0.522,2,3,0.4,3,4,32,14,15,8,23,0.326,0.174,0.5,17.68,48,riffle_clumpy
0,16,25,4,45,0.356,20,0.444,1,2,0.333,3,3,23,22,9,16,20,0.2,0.356,0.444,17.679,49,riffle_clumpy
0,24,19,3,46,0.522,27,0.587,4,1,0.8,4,1,23,23,10,22,14,0.217,0.478,0.304,17.675,50,riffle_clumpy
0,22,21,3,46,0.478,25,0.543,2,1,0.667,3,1,28,18,11,9,26,0.239,0.196,0.565,17.68,51,riffle_clumpy
0,20,20,3,43,0.465,23,0.535,2,2,0.5,0,4,29,14,13,13,17,0.302,0.302,0.395,17.676,52,riffle_clumpy
0,19,22,5,46,0.413,24,0.522,2,3,0.4,0,2,28,18,8,20,18,0.174,0.435,0.391,17.69,53,riffle_clumpy
0,16,24,4,44,0.364,20,0.455,3,1,0.75,3,1,26,18,7,17,20,0.159,0.386,0.455,17.69,54,riffle_clumpy
0,22,23,0,45,0.489,22,0.489,7,4,0.636,1,2,26,19,16,10,19,0.356,0.222,0.422,17.687,55,riffle_clumpy
0,20,21,2,43,0.465,22,0.512,3,4,0.429,1,2,24,19,10,16,17,0.233,0.372,0.395,17.702,56,riffle_clumpy
0,20,19,6,45,0.444,26,0.578,3,3,0.5,2,1,31,14,12,8,25,0.267,0.178,0.556,17.702,57,riffle_clumpy
0,20,17,5,42,0.476,25,0.595,4,2,0.667,1,2,22,20,11,17,14,0.262,0.405,0.333,17.712,58,riffle_clumpy
0,23,18,5,46,0.5,28,0.609,3,2,0.6,2,3,27,19,12,13,21,0.261,0.283,0.457,17.721,59,riffle_clumpy
0,18,20,8,46,0.391,26,0.565,2,3,0.4,4,3,28,18,10,12,24,0.217,0.261,0.522,17.718,60,riffle_clumpy
0,24,21,2,47,0.511,26,0.553,9,1,0.9,5,1,29,18,12,14,21,0.255,0.298,0.447,17.707,61,riffle_clumpy
0,13,26,8,47,0.277,21,0.447,0,1,0.0,2,4,28,19,5,19,23,0.106,0.404,0.489,17.715,62,riffle_clumpy
0,23,20,2,45,0.511,25,0.556,3,2,0.6,3,1,28,17,13,19,13,0.289,0.422,0.289,17.719,63,riffle_clumpy
0,26,18,2,46,0.565,28,0.609,2,3,0.4,6,2,32,14,11,7,28,0.239,0.152,0.609,17.693,64,riffle_clumpy
0,26,14,3,43,0.605,29,0.674,6,3,0.667,2,0,18,25,16,12,15,0.372,0.279,0.349,17.689,65,riffle_clumpy
0,23,19,3,45,0.511,26,0.578,2,1,0.667,2,0,26,19,13,14,18,0.289,0.311,0.4,17.691,66,riffle_clumpy
0,17,21,7,45,0.378,24,0.533,4,1,0.8,3,2,28,17,6,15,24,0.133,0.333,0.533,17.693,67,riffle_clumpy
0,17,26,3,46,0.37,20,0.435,1,2,0.333,3,3,28,18,9,16,21,0.196,0.348,0.457,17.691,68,riffle_clumpy
0,20,24,2,46,0.435,22,0.478,2,1,0.667,2,5,29,17,13,7,26,0.283,0.152,0.565,17.685,69,riffle_clumpy
0,21,19,7,47,0.447,28,0.596,2,0,1.0,4,3,28,19,13,14,20,0.277,0.298,0.426,17.678,70,riffle_clumpy
0,23,20,4,47,0.489,27,0.574,5,3,0.625,0,3,25,22,16,14,17,0.34,0.298,0.362,17.679,71,riffle_clumpy
0,18,18,7,43,0.419,25,0.581,4,3,0.571,2,0,32,11,7,14,22,0.163,0.326,0.512,17.677,72,riffle_clumpy
0,22,20,3,45,0.489,25,0.556,1,2,0.333,3,1,25,20,12,13,20,0.267,0.289,0.444,17.676,73,riffle_clumpy
0,20,21,3,44,0.455,23,0.523,4,4,0.5,1,1,24,20,14,12,18,0.318,0.273,0.409,17.668,74,riffle_clumpy
0,21,22,2,45,0.467,23,0.511,2,0,1.0,2,5,28,17,11,16,18,0.244,0.356,0.4,17.663,75,riffle_clumpy
0,22,21,1,44,0.5,23,0.523,6,2,0.75,0,2,18,26,19,13,12,0.432,0.295,0.273,17.665,76,riffle_clumpy
0,20,23,2,45,0.444,22,0.489,0,2,0.0,2,3,24,21,14,16,15,0.311,0.356,0.333,17.668,77,riffle_clumpy
0,18,23,3,44,0.409,21,0.477,1,2,0.333,1,3,24,20,11,14,19,0.25,0.318,0.432,17.671,78,riffle_clumpy
0,17,25,1,43,0.395,18,0.419,0,2,0.0,0,1,24,19,12,12,19,0.279,0.279,0.442,17.67,79,riffle_clumpy
0,27,19,0,46,0.587,27,0.587,4,3,0.571,3,0,24,22,14,13,19,0.304,0.283,0.413,17.663,80,riffle_clumpy
0,22,21,3,46,0.478,25,0.543,5,2,0.714,2,2,28,18,16,11,19,0.348,0.239,0.413,17.669,81,riffle_clumpy
0,13,29,4,46,0.283,17,0.37,3,0,1.0,1,1,31,15,9,17,20,0.196,0.37,0.435,17.667,82,riffle_clumpy
0,17,20,5,42,0.405,22,0.524,3,4,0.429,1,1,25,17,12,13,17,0.286,0.31,0.405,17.675,83,riffle_clumpy
0,21,24,4,49,0.429,25,0.51,3,4,0.429,2,4,27,22,16,15,18,0.327,0.306,0.367,17.677,84,riffle_clumpy
0,15,26,3,44,0.341,18,0.409,2,1,0.667,1,1,23,21,10,17,17,0.227,0.386,0.386,17.677,85,riffle_clumpy
0,24,20,1,45,0.533,25,0.556,3,4,0.429,3,2,25,20,14,15,16,0.311,0.333,0.356,17.683,86,riffle_clumpy
0,22,18,4,44,0.5,26,0.591,2,2,0.5,2,2,27,17,12,13,19,0.273,0.295,0.432,17.679,87,riffle_clumpy
0,21,23,2,46,0.457,23,0.5,5,3,0.625,2,3,24,22,16,12,18,0.348,0.261,0.391,17.68,88,riffle_clumpy
0,20,23,2,45,0.444,22,0.489,2,1,0.667,0,1,27,18,11,20,14,0.244,0.444,0.311,17.683,89,riffle_clumpy
0,18,23,6,47,0.383,24,0.511,3,4,0.429,2,0,28,19,10,18,19,0.213,0.383,0.404,17.681,90,riffle_clumpy
0,25,18,2,45,0.556,27,0.6,3,2,0.6,2,0,28,17,13,11,21,0.289,0.244,0.467,17.665,91,riffle_clumpy
0,19,23,5,47,0.404,24,0.511,1,2,0.333,4,2,30,17,8,15,24,0.17,0.319,0.511,17.655,92,riffle_clumpy
0,24,21,1,46,0.522,25,0.543,2,3,0.4,1,3,31,15,16,9,21,0.348,0.196,0.457,17.653,93,riffle_clumpy
0,16,23,5,44,0.364,21,0.477,3,1,0.75,2,1,25,19,10,14,20,0.227,0.318,0.455,17.649,94,riffle_clumpy
0,16,21,5,42,0.381,21,0.5,4,2,0.667,1,0,31,11,9,13,20,0.214,0.31,0.476,17.656,95,riffle_clumpy
0,20,21,4,45,0.444,24,0.533,3,2,0.6,2,1,25,20,12,14,19,0.267,0.311,0.422,17.663,96,riffle_clumpy