,player_win,player_loss,push,total_hands,win_pct,win_push,win_push_pct,doubles_won,doubles_lost,doubles_won_pct,player_bj,dealer_bj,dealer_high_card,dealer_low_card,dealer_bust,dealer_draw,dealer_stand,dealer_bust_pct,dealer_draw_pct,dealer_stand_pct,dealer_avg_hand,num_of_shuffles,shuffle_method
0,20,23,3,46,0.435,23,0.5,1,1,0.5,1,2,31,15,12,16,18,0.261,0.348,0.391,17.852,1,riffle_clumpy
0,14,31,1,46,0.304,15,0.326,2,7,0.222,2,1,23,23,7,21,18,0.152,0.457,0.391,18.258,2,riffle_clumpy
0,23,22,3,48,0.479,26,0.542,4,2,0.667,2,2,29,19,14,18,16,0.292,0.375,0.333,18.267,3,riffle_clumpy
0,21,23,4,48,0.438,25,0.521,3,1,0.75,2,3,25,23,13,14,21,0.271,0.292,0.438,18.168,4,riffle_clumpy
0,18,28,3,49,0.367,21,0.429,3,1,0.75,0,4,30,19,9,19,21,0.184,0.388,0.429,18.199,5,riffle_clumpy
0,26,24,1,51,0.51,27,0.529,4,4,0.5,1,2,29,22,21,14,16,0.412,0.275,0.314,18.158,6,riffle_clumpy
0,21,24,4,49,0.429,25,0.51,5,3,0.625,4,1,30,19,12,18,19,0.245,0.367,0.388,18.196,7,riffle_clumpy
0,20,23,4,47,0.426,24,0.511,2,1,0.667,2,1,28,19,13,17,17,0.277,0.362,0.362,18.214,8,riffle_clumpy
0,19,28,1,48,0.396,20,0.417,1,1,0.5,2,3,31,17,11,17,20,0.229,0.354,0.417,18.243,9,riffle_clumpy
0,20,26,2,48,0.417,22,0.458,4,2,0.667,3,3,30,18,10,15,23,0.208,0.312,0.479,18.213,10,riffle_clumpy
0,20,23,4,47,0.426,24,0.511,1,1,0.5,4,1,35,12,10,15,22,0.213,0.319,0.468,18.204,11,riffle_clumpy
0,21,22,3,46,0.457,24,0.522,4,2,0.667,2,2,34,12,10,15,21,0.217,0.326,0.457,18.202,12,riffle_clumpy
0,22,23,2,47,0.468,24,0.511,2,3,0.4,4,1,29,18,14,19,14,0.298,0.404,0.298,18.207,13,riffle_clumpy
0,22,23,2,47,0.468,24,0.511,6,2,0.75,4,2,33,14,12,12,23,0.255,0.255,0.489,18.151,14,riffle_clumpy
0,19,24,4,47,0.404,23,0.489,5,1,0.833,2,3,31,16,9,19,19,0.191,0.404,0.404,18.161,15,riffle_clumpy
0,21,23,4,48,0.438,25,0.521,3,1,0.75,6,2,25,23,7,16,25,0.146,0.333,0.521,18.091,16,riffle_clumpy
0,25,20,3,48,0.521,28,0.583,2,1,0.667,0,5,31,17,18,13,17,0.375,0.271,0.354,18.089,17,riffle_clumpy
0,17,26,6,49,0.347,23,0.469,2,2,0.5,1,2,23,26,9,22,18,0.184,0.449,0.367,18.091,18,riffle_clumpy
0,20,26,2,48,0.417,22,0.458,2,1,0.667,4,3,30,18,13,11,24,0.271,0.229,0.5,18.083,19,riffle_clumpy
0,23,22,2,47,0.489,25,0.532,4,2,0.667,1,0,30,17,17,12,18,0.362,0.255,0.383,18.083,20,riffle_clumpy
0,19,23,7,49,0.388,26,0.531,2,2,0.5,4,5,31,18,11,18,20,0.224,0.367,0.408,18.076,21,riffle_clumpy
0,24,23,1,48,0.5,25,0.521,4,2,0.667,5,1,29,19,10,15,23,0.208,0.312,0.479,18.032,22,riffle_clumpy
0,13,33,2,48,0.271,15,0.312,1,2,0.333,1,1,29,19,10,22,16,0.208,0.458,0.333,18.04,23,riffle_clumpy
0,22,21,4,47,0.468,26,0.553,0,3,0.0,0,5,31,16,15,13,19,0.319,0.277,0.404,18.054,24,riffle_clumpy
0,19,25,2,46,0.413,21,0.457,1,4,0.2,1,3,27,19,11,15,20,0.239,0.326,0.435,18.038,25,riffle_clumpy
0,16,29,3,48,0.333,19,0.396,2,4,0.333,1,3,29,19,8,19,21,0.167,0.396,0.438,18.065,26,riffle_clumpy
0,19,23,3,45,0.422,22,0.489,4,2,0.667,2,1,28,17,12,16,17,0.267,0.356,0.378,18.041,27,riffle_clumpy
0,23,21,3,47,0.489,26,0.553,4,4,0.5,0,3,29,18,15,14,18,0.319,0.298,0.383,18.059,28,riffle_clumpy
0,13,30,4,47,0.277,17,0.362,4,2,0.667,0,3,32,15,10,16,21,0.213,0.34,0.447,18.062,29,riffle_clumpy
0,19,27,2,48,0.396,21,0.438,0,0,0,2,2,32,16,12,15,21,0.25,0.312,0.438,18.068,30,riffle_clumpy
0,23,21,5,49,0.469,28,0.571,4,3,0.571,4,2,31,18,14,11,24,0.286,0.224,0.49,18.06,31,riffle_clumpy
0,18,26,4,48,0.375,22,0.458,2,1,0.667,2,1,30,18,7,16,25,0.146,0.333,0.521,18.073,32,riffle_clumpy
0,19,24,2,45,0.422,21,0.467,3,3,0.5,2,5,28,17,15,11,19,0.333,0.244,0.422,18.071,33,riffle_clumpy
0,20,19,6,45,0.444,26,0.578,4,1,0.8,3,0,25,20,12,16,17,0.267,0.356,0.378,18.067,34,riffle_clumpy
0,25,23,3,51,0.49,28,0.549,3,2,0.6,3,1,33,18,13,13,25,0.255,0.255,0.49,18.067,35,riffle_clumpy
0,21,22,2,45,0.467,23,0.511,3,1,0.75,2,2,31,14,16,11,18,0.356,0.244,0.4,18.063,36,riffle_clumpy
0,23,20,6,49,0.469,29,0.592,3,2,0.6,1,3,31,18,13,16,20,0.265,0.327,0.408,18.059,37,riffle_clumpy
0,24,22,1,47,0.511,25,0.532,4,4,0.5,3,3,32,15,16,12,19,0.34,0.255,0.404,18.059,38,riffle_clumpy
0,21,20,5,46,0.457,26,0.565,3,1,0.75,1,1,30,16,14,10,22,0.304,0.217,0.478,18.058,39,riffle_clumpy
0,26,16,2,44,0.591,28,0.636,3,1,0.75,1,0,29,15,17,14,13,0.386,0.318,0.295,18.051,40,riffle_clumpy
0,20,18,5,43,0.465,25,0.581,4,1,0.8,1,1,28,15,16,16,11,0.372,0.372,0.256,18.055,41,riffle_clumpy
0,17,26,5,48,0.354,22,0.458,5,3,0.625,3,4,32,16,13,10,25,0.271,0.208,0.521,18.06,42,riffle_clumpy
0,22,17,4,43,0.512,26,0.605,4,1,0.8,0,2,26,17,13,16,14,0.302,0.372,0.326,18.066,43,riffle_clumpy
0,23,22,4,49,0.469,27,0.551,4,4,0.5,4,3,27,22,14,19,16,0.286,0.388,0.327,18.069,44,riffle_clumpy
0,23,23,0,46,0.5,23,0.5,3,2,0.6,2,1,28,18,10,15,21,0.217,0.326,0.457,18.074,45,riffle_clumpy
0,25,20,2,47,0.532,27,0.574,4,3,0.571,1,1,25,22,16,14,17,0.34,0.298,0.362,18.068,46,riffle_clumpy
0,21,26,0,47,0.447,21,0.447,5,1,0.833,2,1,33,14,15,16,16,0.319,0.34,0.34,18.056,47,riffle_clumpy
0,20,22,5,47,0.426,25,0.532,3,4,0.429,5,0,29,18,14,17,16,0.298,0.362,0.34,18.046,48,riffle_clumpy
0,16,27,3,46,0.348,19,0.413,1,3,0.25,1,3,33,13,12,15,19,0.261,0.326,0.413,18.055,49,riffle_clumpy
0,19,25,2,46,0.413,21,0.457,1,3,0.25,2,4,26,20,14,13,19,0.304,0.283,0.413,18.059,50,riffle_clumpy
0,22,22,3,47,0.468,25,0.532,6,0,1.0,0,1,28,19,14,17,16,0.298,0.362,0.34,18.074,51,riffle_clumpy
0,22,25,1,48,0.458,23,0.479,1,1,0.5,2,1,29,19,13,14,21,0.271,0.292,0.438,18.065,52,riffle_clumpy
0,22,16,7,45,0.489,29,0.644,4,6,0.4,4,1,27,18,8,14,23,0.178,0.311,0.511,18.048,53,riffle_clumpy
0,25,19,1,45,0.556,26,0.578,4,2,0.667,2,2,26,19,18,9,18,0.4,0.2,0.4,18.046,54,riffle_clumpy
0,23,26,1,50,0.46,24,0.48,2,2,0.5,4,1,33,17,11,13,26,0.22,0.26,0.52,18.035,55,riffle_clumpy
0,17,29,3,49,0.347,20,0.408,3,7,0.3,4,4,26,23,8,18,23,0.163,0.367,0.469,18.023,56,riffle_clumpy
0,17,27,2,46,0.37,19,0.413,4,2,0.667,1,2,29,17,13,15,18,0.283,0.326,0.391,18.029,57,riffle_clumpy
0,25,18,3,46,0.543,28,0.609,2,0,1.0,2,4,29,17,16,15,15,0.348,0.326,0.326,18.031,58,riffle_clumpy
0,21,25,0,46,0.457,21,0.457,4,3,0.571,1,3,28,18,14,13,19,0.304,0.283,0.413,18.032,59,riffle_clumpy
0,19,23,3,45,0.422,22,0.489,3,2,0.6,1,1,28,17,14,17,14,0.311,0.378,0.311,18.039,60,riffle_clumpy
0,18,26,2,46,0.391,20,0.435,4,2,0.667,2,6,27,19,12,12,22,0.261,0.261,0.478,18.038,61,riffle_clumpy
0,20,23,5,48,0.417,25,0.521,2,1,0.667,0,4,26,22,14,17,17,0.292,0.354,0.354,18.044,62,riffle_clumpy
0,16,28,4,48,0.333,20,0.417,2,2,0.5,1,6,35,13,8,17,23,0.167,0.354,0.479,18.048,63,riffle_clumpy
0,21,22,3,46,0.457,24,0.522,4,1,0.8,3,4,35,11,12,14,20,0.261,0.304,0.435,18.053,64,riffle_clumpy
0,19,25,4,48,0.396,23,0.479,3,2,0.6,2,2,33,15,12,16,20,0.25,0.333,0.417,18.049,65,riffle_clumpy
0,14,30,3,47,0.298,17,0.362,3,1,0.75,1,4,33,14,9,18,20,0.191,0.383,0.426,18.056,66,riffle_clumpy
0,21,25,4,50,0.42,25,0.5,5,1,0.833,1,1,25,25,17,17,16,0.34,0.34,0.32,18.059,67,riffle_clumpy
0,20,23,5,48,0.417,25,0.521,3,2,0.6,3,4,24,24,16,13,19,0.333,0.271,0.396,18.065,68,riffle_clumpy
0,20,20,6,46,0.435,26,0.565,5,1,0.833,2,4,28,18,12,17,17,0.261,0.37,0.37,18.07,69,riffle_clumpy
0,18,22,5,45,0.4,23,0.511,0,4,0.0,0,1,33,12,11,15,19,0.244,0.333,0.422,18.068,70,riffle_clumpy
0,19,25,3,47,0.404,22,0.468,3,1,0.75,1,2,28,19,12,16,19,0.255,0.34,0.404,18.066,71,riffle_clumpy
0,20,23,3,46,0.435,23,0.5,4,3,0.571,2,1,28,18,14,11,21,0.304,0.239,0.457,18.07,72,riffle_clumpy
0,22,17,4,43,0.512,26,0.605,0,2,0.0,2,3,23,20,15,17,11,0.349,0.395,0.256,18.071,73,riffle_clumpy
0,20,24,4,48,0.417,24,0.5,3,2,0.6,2,6,32,16,12,13,23,0.25,0.271,0.479,18.076,74,riffle_clumpy
0,20,26,1,47,0.426,21,0.447,1,3,0.25,1,2,27,20,11,19,17,0.234,0.404,0.362,18.075,75,riffle_clumpy
0,15,25,5,45,0.333,20,0.444,2,5,0.286,1,4,27,18,10,18,17,0.222,0.4,0.378,18.082,76,riffle_clumpy
0,23,23,2,48,0.479,25,0.521,5,3,0.625,4,1,35,13,14,16,18,0.292,0.333,0.375,18.079,77,riffle_clumpy
0,20,23,3,46,0.435,23,0.5,5,2,0.714,1,2,27,19,9,20,17,0.196,0.435,0.37,18.088,78,riffle_clumpy
0,22,18,6,46,0.478,28,0.609,5,2,0.714,3,3,32,14,15,11,20,0.326,0.239,0.435,18.086,79,riffle_clumpy
0,23,22,4,49,0.469,27,0.551,2,1,0.667,4,2,30,19,15,16,18,0.306,0.327,0.367,18.086,80,riffle_clumpy
0,15,28,3,46,0.326,18,0.391,0,3,0.0,0,2,23,23,14,19,13,0.304,0.413,0.283,18.088,81,riffle_clumpy
0,25,19,2,46,0.543,27,0.587,5,1,0.833,4,2,28,18,15,11,20,0.326,0.239,0.435,18.079,82,riffle_clumpy
0,24,20,1,45,0.533,25,0.556,6,2,0.75,4,1,27,18,15,12,18,0.333,0.267,0.4,18.066,83,riffle_clumpy
0,21,22,3,46,0.457,24,0.522,5,4,0.556,1,2,31,15,14,13,19,0.304,0.283,0.413,18.076,84,riffle_clumpy
0,18,24,5,47,0.383,23,0.489,6,3,0.667,1,2,28,19,14,15,18,0.298,0.319,0.383,18.077,85,riffle_clumpy
0,20,24,1,45,0.444,21,0.467,7,1,0.875,1,1,25,20,15,13,17,0.333,0.289,0.378,18.076,86,riffle_clumpy
0,22,25,1,48,0.458,23,0.479,2,3,0.4,3,4,31,17,13,16,19,0.271,0.333,0.396,18.076,87,riffle_clumpy
0,16,26,5,47,0.34,21,0.447,4,1,0.8,2,1,25,22,9,18,20,0.191,0.383,0.426,18.081,88,riffle_clumpy
0,23,23,2,48,0.479,25,0.521,3,1,0.75,4,3,33,15,9,19,20,0.188,0.396,0.417,18.076,89,riffle_clumpy
0,25,14,4,43,0.581,29,0.674,7,0,1.0,3,0,19,24,13,17,13,0.302,0.395,0.302,18.069,90,riffle_clumpy
0,21,24,2,47,0.447,23,0.489,0,1,0.0,3,2,28,19,12,15,20,0.255,0.319,0.426,18.064,91,riffle_clumpy
0,22,22,2,46,0.478,24,0.522,2,2,0.5,2,5,27,19,14,15,17,0.304,0.326,0.37,18.058,92,riffle_clumpy
0,20,25,3,48,0.417,23,0.479,1,1,0.5,1,3,29,19,9,19,20,0.188,0.396,0.417,18.064,93,riffle_clumpy
0,21,23,3,47,0.447,24,0.511,3,2,0.6,1,3,28,19,14,18,15,0.298,0.383,0.319,18.064,94,riffle_clumpy
0,18,30,3,51,0.353,21,0.412,4,3,0.571,2,2,33,18,13,15,23,0.255,0.294,0.451,18.068,95,riffle_clumpy
0,19,29,3,51,0.373,22,0.431,5,2,0.714,3,2,31,20,10,19,22,0.196,0.373,0.431,18.068,96,riffle_clumpy
0,19,26,1,46,0.413,20,0.435,1,2,0.333,1,2,28,18,12,17,17,0.261,0.37,0.37,18.556,1,riffle_clumpy
0,18,26,4,48,0.375,22,0.458,3,3,0.5,2,2,29,19,9,18,21,0.188,0.375,0.438,18.29,2,riffle_clumpy
0,22,29,0,51,0.431,22,0.431,6,1,0.857,4,2,31,20,10,20,21,0.196,0.392,0.412,18.147,3,riffle_clumpy
0,21,21,3,45,0.467,24,0.533,6,2,0.75,1,0,24,21,15,14,16,0.333,0.311,0.356,18.195,4,riffle_clumpy
0,18,24,4,46,0.391,22,0.478,1,3,0.25,2,1,33,13,12,19,15,0.261,0.413,0.326,18.235,5,riffle_clumpy
0,23,20,2,45,0.511,25,0.556,6,3,0.667,1,1,20,25,13,18,14,0.289,0.4,0.311,18.225,6,riffle_clumpy
0,20,24,2,46,0.435,22,0.478,3,3,0.5,2,3,30,16,10,13,23,0.217,0.283,0.5,18.132,7,riffle_clumpy
0,20,24,3,47,0.426,23,0.489,2,1,0.667,1,2,28,19,10,15,22,0.213,0.319,0.468,18.181,8,riffle_clumpy
0,18,20,9,47,0.383,27,0.574,2,2,0.5,5,4,29,18,9,18,20,0.191,0.383,0.426,18.133,9,riffle_clumpy
0,24,20,2,46,0.522,26,0.565,1,3,0.25,5,2,28,18,14,17,15,0.304,0.37,0.326,18.064,10,riffle_clumpy
0,21,22,4,47,0.447,25,0.532,2,1,0.667,2,1,25,22,13,21,13,0.277,0.447,0.277,18.055,11,riffle_clumpy
0,21,25,3,49,0.429,24,0.49,3,3,0.5,4,2,26,23,14,20,15,0.286,0.408,0.306,18.014,12,riffle_clumpy
0,17,28,2,47,0.362,19,0.404,2,3,0.4,2,3,30,17,9,17,21,0.191,0.362,0.447,18.034,13,riffle_clumpy
0,23,21,3,47,0.489,26,0.553,4,2,0.667,1,4,25,22,13,16,18,0.277,0.34,0.383,18.002,14,riffle_clumpy
0,20,20,6,46,0.435,26,0.565,2,1,0.667,4,1,30,16,11,17,18,0.239,0.37,0.391,18.02,15,riffle_clumpy
0,17,28,3,48,0.354,20,0.417,3,3,0.5,1,5,29,19,11,15,22,0.229,0.312,0.458,18.029,16,riffle_clumpy
0,24,21,2,47,0.511,26,0.553,4,4,0.5,2,2,24,23,17,14,16,0.362,0.298,0.34,18.034,17,riffle_clumpy
0,27,12,4,43,0.628,31,0.721,7,1,0.875,3,1,28,15,15,14,14,0.349,0.326,0.326,18.036,18,riffle_clumpy
0,20,19,8,47,0.426,28,0.596,2,1,0.667,2,3,26,21,14,14,19,0.298,0.298,0.404,18.038,19,riffle_clumpy
0,21,23,2,46,0.457,23,0.5,2,3,0.4,0,2,25,21,13,17,16,0.283,0.37,0.348,18.012,20,riffle_clumpy
0,20,28,1,49,0.408,21,0.429,8,4,0.667,0,4,31,18,13,11,25,0.265,0.224,0.51,18.008,21,riffle_clumpy
0,22,24,1,47,0.468,23,0.489,3,4,0.429,2,3,31,16,13,18,16,0.277,0.383,0.34,17.983,22,riffle_clumpy
0,26,20,2,48,0.542,28,0.583,8,1,0.889,6,0,27,21,14,18,16,0.292,0.375,0.333,17.979,23,riffle_clumpy
0,19,24,3,46,0.413,22,0.478,3,0,1.0,4,2,27,19,11,15,20,0.239,0.326,0.435,17.967,24,riffle_clumpy
0,25,17,5,47,0.532,30,0.638,7,2,0.778,2,1,23,24,17,17,13,0.362,0.362,0.277,17.959,25,riffle_clumpy
0,23,23,5,51,0.451,28,0.549,1,1,0.5,3,4,28,23,13,19,19,0.255,0.373,0.373,17.947,26,riffle_clumpy
0,20,22,3,45,0.444,23,0.511,1,0,1.0,3,4,23,22,12,17,16,0.267,0.378,0.356,17.931,27,riffle_clumpy
0,20,24,3,47,0.426,23,0.489,1,2,0.333,1,0,30,17,12,14,21,0.255,0.298,0.447,17.924,28,riffle_clumpy
0,20,22,5,47,0.426,25,0.532,1,1,0.5,3,4,32,15,12,14,21,0.255,0.298,0.447,17.933,29,riffle_clumpy
0,19,27,2,48,0.396,21,0.438,5,6,0.455,1,2,32,16,9,17,22,0.188,0.354,0.458,17.954,30,riffle_clumpy
0,19,25,5,49,0.388,24,0.49,5,5,0.5,3,0,28,21,10,19,20,0.204,0.388,0.408,17.96,31,riffle_clumpy
0,17,24,6,47,0.362,23,0.489,0,1,0.0,0,3,28,19,11,19,17,0.234,0.404,0.362,17.977,32,riffle_clumpy
0,14,30,3,47,0.298,17,0.362,6,2,0.75,1,4,34,13,10,20,17,0.213,0.426,0.362,17.978,33,riffle_clumpy
0,19,25,2,46,0.413,21,0.457,2,4,0.333,3,1,30,16,11,11,24,0.239,0.239,0.522,17.975,34,riffle_clumpy
0,19,25,3,47,0.404,22,0.468,1,0,1.0,0,3,29,18,17,15,15,0.362,0.319,0.319,17.994,35,riffle_clumpy
0,19,18,7,44,0.432,26,0.591,1,3,0.25,3,0,25,19,13,16,15,0.295,0.364,0.341,18.011,36,riffle_clumpy
0,26,15,4,45,0.578,30,0.667,6,2,0.75,2,2,27,18,16,14,15,0.356,0.311,0.333,18.001,37,riffle_clumpy
0,20,24,3,47,0.426,23,0.489,5,1,0.833,1,1,30,17,12,15,20,0.255,0.319,0.426,18.003,38,riffle_clumpy
0,20,22,4,46,0.435,24,0.522,6,3,0.667,1,3,23,23,13,17,16,0.283,0.37,0.348,17.995,39,riffle_clumpy
0,20,28,1,49,0.408,21,0.429,2,2,0.5,3,2,31,18,12,15,22,0.245,0.306,0.449,17.992,40,riffle_clumpy
0,18,25,4,47,0.383,22,0.468,6,3,0.667,1,2,24,23,11,24,12,0.234,0.511,0.255,18.008,41,riffle_clumpy
0,22,19,5,46,0.478,27,0.587,2,3,0.4,4,2,28,18,15,8,23,0.326,0.174,0.5,18.002,42,riffle_clumpy
0,15,28,4,47,0.319,19,0.404,5,4,0.556,2,1,29,18,8,14,25,0.17,0.298,0.532,17.999,43,riffle_clumpy
0,17,25,4,46,0.37,21,0.457,1,1,0.5,0,5,30,16,13,12,21,0.283,0.261,0.457,18.005,44,riffle_clumpy
0,17,29,4,50,0.34,21,0.42,4,4,0.5,1,5,33,17,8,22,20,0.16,0.44,0.4,18.015,45,riffle_clumpy
0,18,26,4,48,0.375,22,0.458,3,2,0.6,2,6,30,18,12,14,22,0.25,0.292,0.458,18.005,46,riffle_clumpy
0,20,26,1,47,0.426,21,0.447,4,1,0.8,4,3,34,13,8,13,26,0.17,0.277,0.553,17.999,47,riffle_clumpy
0,19,25,7,51,0.373,26,0.51,1,2,0.333,5,0,30,21,11,17,23,0.216,0.333,0.451,17.994,48,riffle_clumpy
0,18,24,3,45,0.4,21,0.467,3,1,0.75,2,2,30,15,12,15,18,0.267,0.333,0.4,18.002,49,riffle_clumpy
0,16,25,5,46,0.348,21,0.457,2,4,0.333,1,3,26,20,9,21,16,0.196,0.457,0.348,18.001,50,riffle_clumpy
0,21,22,4,47,0.447,25,0.532,2,2,0.5,3,2,25,22,13,14,20,0.277,0.298,0.426,18.0,51,riffle_clumpy
0,17,26,3,46,0.37,20,0.435,2,4,0.333,2,3,31,15,8,15,23,0.174,0.326,0.5,18.01,52,riffle_clumpy
0,24,16,4,44,0.545,28,0.636,6,2,0.75,0,0,23,21,19,15,10,0.432,0.341,0.227,18.007,53,riffle_clumpy
0,19,27,3,49,0.388,22,0.449,2,2,0.5,2,4,21,28,11,19,19,0.224,0.388,0.388,17.996,54,riffle_clumpy
0,17,28,4,49,0.347,21,0.429,0,3,0.0,4,4,32,17,5,18,26,0.102,0.367,0.531,17.994,55,riffle_clumpy
0,19,25,4,48,0.396,23,0.479,0,3,0.0,1,1,31,17,14,15,19,0.292,0.312,0.396,18.012,56,riffle_clumpy
0,25,16,5,46,0.543,30,0.652,5,1,0.833,2,2,23,23,16,13,17,0.348,0.283,0.37,18.019,57,riffle_clumpy
0,16,26,6,48,0.333,22,0.458,4,2,0.667,0,1,21,27,8,20,20,0.167,0.417,0.417,18.019,58,riffle_clumpy
0,18,26,3,47,0.383,21,0.447,2,3,0.4,1,2,32,15,11,14,22,0.234,0.298,0.468,18.014,59,riffle_clumpy
0,21,24,2,47,0.447,23,0.489,2,3,0.4,2,4,30,17,10,17,20,0.213,0.362,0.426,18.018,60,riffle_clumpy
0,12,28,7,47,0.255,19,0.404,2,1,0.667,2,5,31,16,7,22,18,0.149,0.468,0.383,18.024,61,riffle_clumpy
0,18,26,2,46,0.391,20,0.435,4,1,0.8,1,4,28,18,12,14,20,0.261,0.304,0.435,18.019,62,riffle_clumpy
0,20,25,1,46,0.435,21,0.457,2,2,0.5,0,4,21,25,17,16,13,0.37,0.348,0.283,18.025,63,riffle_clumpy
0,21,22,4,47,0.447,25,0.532,1,1,0.5,5,3,28,19,12,15,20,0.255,0.319,0.426,18.016,64,riffle_clumpy
0,22,16,9,47,0.468,31,0.66,2,1,0.667,3,4,32,15,17,13,17,0.362,0.277,0.362,18.022,65,riffle_clumpy
0,14,26,7,47,0.298,21,0.447,0,4,0.0,3,2,26,21,8,22,17,0.17,0.468,0.362,18.024,66,riffle_clumpy
0,22,24,0,46,0.478,22,0.478,2,2,0.5,1,1,22,24,13,21,12,0.283,0.457,0.261,18.024,67,riffle_clumpy
0,19,25,3,47,0.404,22,0.468,0,2,0.0,3,3,31,16,13,15,19,0.277,0.319,0.404,18.017,68,riffle_clumpy
0,24,22,6,52,0.462,30,0.577,5,2,0.714,3,2,28,24,12,17,23,0.231,0.327,0.442,18.016,69,riffle_clumpy
0,25,18,5,48,0.521,30,0.625,5,3,0.625,3,1,33,15,14,14,20,0.292,0.292,0.417,18.016,70,riffle_clumpy
0,20,19,5,44,0.455,25,0.568,3,2,0.6,1,2,25,19,12,17,15,0.273,0.386,0.341,18.011,71,riffle_clumpy
0,22,23,0,45,0.489,22,0.489,4,2,0.667,2,0,28,17,14,13,18,0.311,0.289,0.4,18.011,72,riffle_clumpy
0,21,19,8,48,0.438,29,0.604,1,3,0.25,4,1,31,17,10,15,23,0.208,0.312,0.479,17.998,73,riffle_clumpy
0,25,18,3,46,0.543,28,0.609,4,1,0.8,2,1,25,21,13,20,13,0.283,0.435,0.283,18.003,74,riffle_clumpy
0,19,23,3,45,0.422,22,0.489,5,1,0.833,1,0,29,16,10,14,21,0.222,0.311,0.467,18.014,75,riffle_clumpy
0,21,23,2,46,0.457,23,0.5,3,3,0.5,4,2,30,16,12,8,26,0.261,0.174,0.565,18.025,76,riffle_clumpy
0,27,13,5,45,0.6,32,0.711,6,0,1.0,2,2,22,23,17,14,14,0.378,0.311,0.311,18.025,77,riffle_clumpy
0,20,23,1,44,0.455,21,0.477,5,3,0.625,1,2,28,16,12,14,18,0.273,0.318,0.409,18.025,78,riffle_clumpy
0,15,22,7,44,0.341,22,0.5,4,3,0.571,0,2,21,23,13,18,13,0.295,0.409,0.295,18.033,79,riffle_clumpy
0,20,26,2,48,0.417,22,0.458,2,5,0.286,1,2,27,21,9,21,18,0.188,0.438,0.375,18.035,80,riffle_clumpy
0,21,24,2,47,0.447,23,0.489,1,3,0.25,5,3,27,20,15,16,16,0.319,0.34,0.34,18.029,81,riffle_clumpy
0,22,24,1,47,0.468,23,0.489,3,3,0.5,4,4,28,19,9,19,19,0.191,0.404,0.404,18.026,82,riffle_clumpy
0,26,18,3,47,0.553,29,0.617,4,1,0.8,6,0,29,18,13,12,22,0.277,0.255,0.468,18.015,83,riffle_clumpy
0,20,22,6,48,0.417,26,0.542,4,3,0.571,5,2,32,16,12,15,21,0.25,0.312,0.438,18.012,84,riffle_clumpy
0,16,30,3,49,0.327,19,0.388,3,3,0.5,1,4,31,18,8,20,21,0.163,0.408,0.429,18.011,85,riffle_clumpy
0,18,27,4,49,0.367,22,0.449,1,3,0.25,3,4,28,21,11,19,19,0.224,0.388,0.388,18.007,86,riffle_clumpy
0,11,31,4,46,0.239,15,0.326,2,3,0.4,2,4,30,16,7,19,20,0.152,0.413,0.435,18.008,87,riffle_clumpy
0,17,29,4,50,0.34,21,0.42,3,5,0.375,2,3,29,21,13,18,19,0.26,0.36,0.38,18.012,88,riffle_clumpy
0,21,22,3,46,0.457,24,0.522,2,4,0.333,2,1,28,18,12,16,18,0.261,0.348,0.391,18.014,89,riffle_clumpy
0,16,26,5,47,0.34,21,0.447,0,2,0.0,1,2,30,17,12,21,14,0.255,0.447,0.298,18.02,90,riffle_clumpy
0,20,25,1,46,0.435,21,0.457,3,4,0.429,3,2,26,20,10,20,16,0.217,0.435,0.348,18.024,91,riffle_clumpy
0,20,23,3,46,0.435,23,0.5,0,5,0.0,2,2,30,16,10,15,21,0.217,0.326,0.457,18.014,92,riffle_clumpy
0,21,21,3,45,0.467,24,0.533,4,0,1.0,0,4,36,9,11,18,16,0.244,0.4,0.356,18.019,93,riffle_clumpy
0,21,22,6,49,0.429,27,0.551,2,1,0.667,0,3,30,19,15,14,20,0.306,0.286,0.408,18.021,94,riffle_clumpy
0,20,24,2,46,0.435,22,0.478,5,2,0.714,2,2,32,14,13,14,19,0.283,0.304,0.413,18.019,95,riffle_clumpy
0,18,24,4,46,0.391,22,0.478,3,2,0.6,3,2,29,17,11,16,19,0.239,0.348,0.413,18.02,96,riffle_clumpy
0,18,25,2,45,0.4,20,0.444,4,5,0.444,0,2,26,19,16,15,14,0.356,0.333,0.311,18.043,1,riffle_clumpy
0,21,25,1,47,0.447,22,0.468,2,5,0.286,2,1,32,15,10,14,23,0.213,0.298,0.489,17.736,2,riffle_clumpy
0,24,20,1,45,0.533,25,0.556,2,2,0.5,4,1,22,23,13,15,17,0.289,0.333,0.378,17.642,3,riffle_clumpy
0,17,28,2,47,0.362,19,0.404,2,2,0.5,0,0,28,19,15,14,18,0.319,0.298,0.383,17.818,4,riffle_clumpy
0,16,28,6,50,0.32,22,0.44,8,1,0.889,3,6,32,18,16,14,20,0.32,0.28,0.4,18.0,5,riffle_clumpy
0,22,17,7,46,0.478,29,0.63,3,2,0.6,2,3,27,19,17,11,18,0.37,0.239,0.391,17.919,6,riffle_clumpy
0,21,23,3,47,0.447,24,0.511,6,0,1.0,3,4,28,19,15,11,21,0.319,0.234,0.447,17.973,7,riffle_clumpy
0,21,31,0,52,0.404,21,0.404,1,3,0.25,1,2,29,23,15,17,20,0.288,0.327,0.385,17.977,8,riffle_clumpy
0,17,30,1,48,0.354,18,0.375,2,4,0.333,4,4,31,17,7,22,19,0.146,0.458,0.396,18.033,9,riffle_clumpy
0,21,26,4,51,0.412,25,0.49,2,5,0.286,2,2,37,14,7,20,24,0.137,0.392,0.471,18.081,10,riffle_clumpy
0,22,20,5,47,0.468,27,0.574,1,2,0.333,4,2,24,23,14,18,15,0.298,0.383,0.319,18.01,11,riffle_clumpy
0,16,28,3,47,0.34,19,0.404,3,6,0.333,1,2,25,22,10,18,19,0.213,0.383,0.404,18.038,12,riffle_clumpy
0,19,26,1,46,0.413,20,0.435,4,3,0.571,0,1,28,18,9,20,17,0.196,0.435,0.37,18.016,13,riffle_clumpy
0,21,22,4,47,0.447,25,0.532,4,0,1.0,3,4,31,16,15,16,16,0.319,0.34,0.34,18.033,14,riffle_clumpy
0,22,18,5,45,0.489,27,0.6,1,1,0.5,1,3,31,14,15,10,20,0.333,0.222,0.444,18.047,15,riffle_clumpy
0,22,20,6,48,0.458,28,0.583,3,5,0.375,6,2,34,14,10,15,23,0.208,0.312,0.479,18.029,16,riffle_clumpy
0,25,17,4,46,0.543,29,0.63,2,2,0.5,3,5,26,20,16,11,19,0.348,0.239,0.413,18.002,17,riffle_clumpy
0,21,21,4,46,0.457,25,0.543,4,1,0.8,3,1,22,24,13,18,15,0.283,0.391,0.326,18.022,18,riffle_clumpy
0,18,24,4,46,0.391,22,0.478,3,1,0.75,1,0,32,14,8,12,26,0.174,0.261,0.565,18.005,19,riffle_clumpy
0,26,12,7,45,0.578,33,0.733,2,2,0.5,5,0,22,23,13,15,17,0.289,0.333,0.378,17.986,20,riffle_clumpy
0,24,20,2,46,0.522,26,0.565,4,3,0.571,3,4,27,19,15,14,17,0.326,0.304,0.37,17.948,21,riffle_clumpy
0,17,24,6,47,0.362,23,0.489,4,1,0.8,4,3,32,15,10,14,23,0.213,0.298,0.489,17.905,22,riffle_clumpy
0,24,22,2,48,0.5,26,0.542,2,4,0.333,3,4,30,18,12,15,21,0.25,0.312,0.438,17.891,23,riffle_clumpy
0,19,30,4,53,0.358,23,0.434,2,3,0.4,3,4,36,17,10,21,22,0.189,0.396,0.415,17.891,24,riffle_clumpy
0,18,24,4,46,0.391,22,0.478,5,2,0.714,1,2,22,24,15,16,15,0.326,0.348,0.326,17.907,25,riffle_clumpy
0,24,21,1,46,0.522,25,0.543,4,2,0.667,0,4,30,16,17,10,19,0.37,0.217,0.413,17.923,26,riffle_clumpy
0,23,21,2,46,0.5,25,0.543,2,0,1.0,4,1,27,19,14,14,18,0.304,0.304,0.391,17.939,27,riffle_clumpy
0,17,26,4,47,0.362,21,0.447,1,5,0.167,1,3,26,21,10,20,17,0.213,0.426,0.362,17.961,28,riffle_clumpy
0,21,20,4,45,0.467,25,0.556,3,2,0.6,3,1,26,19,12,18,15,0.267,0.4,0.333,17.96,29,riffle_clumpy
0,23,21,3,47,0.489,26,0.553,2,1,0.667,3,2,26,21,13,15,19,0.277,0.319,0.404,17.974,30,riffle_clumpy
0,26,20,1,47,0.553,27,0.574,6,2,0.75,4,0,28,19,15,18,14,0.319,0.383,0.298,17.956,31,riffle_clumpy
0,23,19,4,46,0.5,27,0.587,2,3,0.4,5,0,25,21,13,20,13,0.283,0.435,0.283,17.95,32,riffle_clumpy
0,16,27,2,45,0.356,18,0.4,2,1,0.667,1,4,28,17,8,22,15,0.178,0.489,0.333,17.954,33,riffle_clumpy
0,19,25,3,47,0.404,22,0.468,1,3,0.25,1,1,28,19,10,21,16,0.213,0.447,0.34,17.957,34,riffle_clumpy
0,22,22,5,49,0.449,27,0.551,3,1,0.75,1,2,25,24,18,15,16,0.367,0.306,0.327,17.953,35,riffle_clumpy
0,27,18,1,46,0.587,28,0.609,2,0,1.0,5,0,21,25,17,16,13,0.37,0.348,0.283,17.933,36,riffle_clumpy
0,19,26,2,47,0.404,21,0.447,0,4,0.0,2,3,25,22,11,18,18,0.234,0.383,0.383,17.947,37,riffle_clumpy
0,20,24,4,48,0.417,24,0.5,3,4,0.429,3,1,35,13,12,17,19,0.25,0.354,0.396,17.956,38,riffle_clumpy
0,20,22,6,48,0.417,26,0.542,3,3,0.5,2,2,29,19,12,18,18,0.25,0.375,0.375,17.959,39,riffle_clumpy
0,23,20,5,48,0.479,28,0.583,1,4,0.2,4,4,32,16,12,14,22,0.25,0.292,0.458,17.96,40,riffle_clumpy
0,23,21,5,49,0.469,28,0.571,5,0,1.0,2,4,30,19,16,10,23,0.327,0.204,0.469,17.952,41,riffle_clumpy
0,20,24,2,46,0.435,22,0.478,2,3,0.4,3,1,25,21,10,17,19,0.217,0.37,0.413,17.942,42,riffle_clumpy
0,24,24,0,48,0.5,24,0.5,2,1,0.667,3,1,29,19,12,17,19,0.25,0.354,0.396,17.941,43,riffle_clumpy
0,20,24,1,45,0.444,21,0.467,4,2,0.667,1,0,21,24,11,18,16,0.244,0.4,0.356,17.947,44,riffle_clumpy
0,20,23,5,48,0.417,25,0.521,4,1,0.8,2,4,27,21,11,15,22,0.229,0.312,0.458,17.953,45,riffle_clumpy
0,21,24,1,46,0.457,22,0.478,3,0,1.0,2,2,25,21,13,15,18,0.283,0.326,0.391,17.938,46,riffle_clumpy
0,21,25,0,46,0.457,21,0.457,3,3,0.5,4,1,27,19,10,17,19,0.217,0.37,0.413,17.938,47,riffle_clumpy
0,17,26,3,46,0.37,20,0.435,5,3,0.625,1,1,28,18,10,15,21,0.217,0.326,0.457,17.952,48,riffle_clumpy
0,24,19,4,47,0.511,28,0.596,6,2,0.75,2,3,24,23,14,18,15,0.298,0.383,0.319,17.95,49,riffle_clumpy
0,17,22,5,44,0.386,22,0.5,5,1,0.833,0,1,30,14,12,15,17,0.273,0.341,0.386,17.962,50,riffle_clumpy
0,21,23,4,48,0.438,25,0.521,2,2,0.5,1,4,30,18,14,16,18,0.292,0.333,0.375,17.963,51,riffle_clumpy
0,21,23,5,49,0.429,26,0.531,1,5,0.167,1,3,27,22,18,14,17,0.367,0.286,0.347,17.958,52,riffle_clumpy
0,15,27,4,46,0.326,19,0.413,2,3,0.4,1,2,28,18,7,20,19,0.152,0.435,0.413,17.962,53,riffle_clumpy
0,19,24,6,49,0.388,25,0.51,2,2,0.5,1,2,32,17,13,18,18,0.265,0.367,0.367,17.979,54,riffle_clumpy
0,24,19,4,47,0.511,28,0.596,4,2,0.667,4,1,24,23,13,15,19,0.277,0.319,0.404,17.974,55,riffle_clumpy
0,22,18,5,45,0.489,27,0.6,4,1,0.8,2,2,29,16,18,14,13,0.4,0.311,0.289,17.979,56,riffle_clumpy
0,17,27,7,51,0.333,24,0.471,0,1,0.0,2,3,28,23,9,21,21,0.176,0.412,0.412,17.978,57,riffle_clumpy
0,24,20,3,47,0.511,27,0.574,2,0,1.0,3,0,26,21,13,13,21,0.277,0.277,0.447,17.972,58,riffle_clumpy
0,17,24,6,47,0.362,23,0.489,3,0,1.0,0,3,27,20,14,17,16,0.298,0.362,0.34,17.97,59,riffle_clumpy
0,23,21,3,47,0.489,26,0.553,2,1,0.667,3,2,24,23,13,18,16,0.277,0.383,0.34,17.969,60,riffle_clumpy
0,22,20,4,46,0.478,26,0.565,3,1,0.75,2,1,28,18,15,14,17,0.326,0.304,0.37,17.969,61,riffle_clumpy
0,17,26,3,46,0.37,20,0.435,1,2,0.333,2,1,29,17,7,17,22,0.152,0.37,0.478,17.959,62,riffle_clumpy
0,18,27,3,48,0.375,21,0.438,2,3,0.4,3,2,35,13,9,15,24,0.188,0.312,0.5,17.961,63,riffle_clumpy
0,23,23,2,48,0.479,25,0.521,2,4,0.333,2,1,33,15,11,15,22,0.229,0.312,0.458,17.964,64,riffle_clumpy
0,20,22,5,47,0.426,25,0.532,4,6,0.4,3,2,26,21,11,17,19,0.234,0.362,0.404,17.962,65,riffle_clumpy
0,27,17,3,47,0.574,30,0.638,7,2,0.778,6,1,28,19,14,14,19,0.298,0.298,0.404,17.961,66,riffle_clumpy
0,18,28,2,48,0.375,20,0.417,5,0,1.0,2,5,31,17,12,17,19,0.25,0.354,0.396,17.965,67,riffle_clumpy
0,21,23,2,46,0.457,23,0.5,2,1,0.667,2,4,28,18,14,15,17,0.304,0.326,0.37,17.967,68,riffle_clumpy
0,23,23,1,47,0.489,24,0.511,4,0,1.0,1,2,27,20,18,15,14,0.383,0.319,0.298,17.967,69,riffle_clumpy
0,24,26,2,52,0.462,26,0.5,9,2,0.818,1,5,30,22,12,21,19,0.231,0.404,0.365,17.97,70,riffle_clumpy
0,20,29,3,52,0.385,23,0.442,1,3,0.25,2,1,28,24,13,19,20,0.25,0.365,0.385,17.968,71,riffle_clumpy
0,14,33,1,48,0.292,15,0.312,0,1,0.0,2,2,34,14,9,13,26,0.188,0.271,0.542,17.974,72,riffle_clumpy
0,22,20,4,46,0.478,26,0.565,2,4,0.333,3,1,26,20,12,17,17,0.261,0.37,0.37,17.967,73,riffle_clumpy
0,22,26,1,49,0.449,23,0.469,4,6,0.4,1,1,28,21,11,23,15,0.224,0.469,0.306,17.968,74,riffle_clumpy
0,22,21,3,46,0.478,25,0.543,4,3,0.571,1,1,28,18,16,13,17,0.348,0.283,0.37,17.961,75,riffle_clumpy
0,24,22,2,48,0.5,26,0.542,2,2,0.5,2,1,32,16,15,15,18,0.312,0.312,0.375,17.952,76,riffle_clumpy
0,18,25,2,45,0.4,20,0.444,2,2,0.5,1,2,25,20,9,21,15,0.2,0.467,0.333,17.957,77,riffle_clumpy
0,26,20,1,47,0.553,27,0.574,5,1,0.833,4,1,21,26,18,14,15,0.383,0.298,0.319,17.951,78,riffle_clumpy
0,14,33,1,48,0.292,15,0.312,2,0,1.0,0,3,33,15,8,19,21,0.167,0.396,0.438,17.962,79,riffle_clumpy
0,27,18,2,47,0.574,29,0.617,8,0,1.0,5,3,27,20,16,14,17,0.34,0.298,0.362,17.954,80,riffle_clumpy
0,19,23,3,45,0.422,22,0.489,3,0,1.0,3,2,36,9,10,13,22,0.222,0.289,0.489,17.956,81,riffle_clumpy
0,19,28,2,49,0.388,21,0.429,2,5,0.286,2,3,30,19,10,17,22,0.204,0.347,0.449,17.957,82,riffle_clumpy
0,17,24,5,46,0.37,22,0.478,2,3,0.4,0,4,27,19,14,16,16,0.304,0.348,0.348,17.959,83,riffle_clumpy
0,28,19,2,49,0.571,30,0.612,4,1,0.8,4,2,28,21,20,9,20,0.408,0.184,0.408,17.959,84,riffle_clumpy
0,23,20,7,50,0.46,30,0.6,5,1,0.833,4,2,32,18,13,13,24,0.26,0.26,0.48,17.96,85,riffle_clumpy
0,21,25,1,47,0.447,22,0.468,6,2,0.75,2,1,28,19,14,12,21,0.298,0.255,0.447,17.953,86,riffle_clumpy
0,20,28,2,50,0.4,22,0.44,2,1,0.667,1,2,33,17,12,20,18,0.24,0.4,0.36,17.959,87,riffle_clumpy
0,19,27,4,50,0.38,23,0.46,3,4,0.429,1,6,30,20,15,15,20,0.3,0.3,0.4,17.96,88,riffle_clumpy
0,22,16,7,45,0.489,29,0.644,4,1,0.8,2,0,29,16,12,15,18,0.267,0.333,0.4,17.964,89,riffle_clumpy
0,21,23,1,45,0.467,22,0.489,5,3,0.625,2,1,26,19,11,17,17,0.244,0.378,0.378,17.971,90,riffle_clumpy
0,19,23,3,45,0.422,22,0.489,6,3,0.667,0,0,31,14,12,14,19,0.267,0.311,0.422,17.985,91,riffle_clumpy
0,21,25,3,49,0.429,24,0.49,3,5,0.375,3,2,30,19,13,15,21,0.265,0.306,0.429,17.984,92,riffle_clumpy
0,25,22,1,48,0.521,26,0.542,3,5,0.375,2,2,26,22,18,19,11,0.375,0.396,0.229,17.987,93,riffle_clumpy
0,17,26,3,46,0.37,20,0.435,5,1,0.833,1,1,25,21,11,20,15,0.239,0.435,0.326,17.997,94,riffle_clumpy
0,14,25,8,47,0.298,22,0.468,2,0,1.0,2,4,36,11,7,13,27,0.149,0.277,0.574,17.993,95,riffle_clumpy
0,20,26,3,49,0.408,23,0.469,8,2,0.8,2,3,37,12,9,16,24,0.184,0.327,0.49,17.993,96,riffle_clumpy
0,20,22,5,47,0.426,25,0.532,3,1,0.75,3,2,28,19,8,15,24,0.17,0.319,0.511,17.879,1,riffle_clumpy
0,21,21,4,46,0.457,25,0.543,6,4,0.6,2,2,29,17,11,16,19,0.239,0.348,0.413,17.952,2,riffle_clumpy
0,14,30,2,46,0.304,16,0.348,2,4,0.333,1,2,31,15,11,18,17,0.239,0.391,0.37,18.067,3,riffle_clumpy
0,19,23,5,47,0.404,24,0.511,3,5,0.375,1,1,22,25,13,18,16,0.277,0.383,0.34,18.143,4,riffle_clumpy
0,23,20,1,44,0.523,24,0.545,5,2,0.714,1,3,30,14,16,12,16,0.364,0.273,0.364,18.19,5,riffle_clumpy
0,16,27,4,47,0.34,20,0.426,4,2,0.667,1,1,29,18,9,23,15,0.191,0.489,0.319,18.213,6,riffle_clumpy
0,15,31,2,48,0.312,17,0.354,3,3,0.5,1,3,32,16,12,13,23,0.25,0.271,0.479,18.255,7,riffle_clumpy
0,19,26,1,46,0.413,20,0.435,3,2,0.6,1,3,31,15,15,15,16,0.326,0.326,0.348,18.249,8,riffle_clumpy
0,26,21,2,49,0.531,28,0.571,2,0,1.0,3,0,29,20,14,18,17,0.286,0.367,0.347,18.204,9,riffle_clumpy
0,16,26,6,48,0.333,22,0.458,0,4,0.0,2,4,29,19,7,19,22,0.146,0.396,0.458,18.213,10,riffle_clumpy
0,17,25,3,45,0.378,20,0.444,3,3,0.5,0,1,34,11,10,13,22,0.222,0.289,0.489,18.257,11,riffle_clumpy
0,25,17,3,45,0.556,28,0.622,2,3,0.4,2,2,25,20,12,19,14,0.267,0.422,0.311,18.253,12,riffle_clumpy
0,19,26,2,47,0.404,21,0.447,1,1,0.5,2,2,31,16,9,19,19,0.191,0.404,0.404,18.19,13,riffle_clumpy
0,17,27,2,46,0.37,19,0.413,1,2,0.333,3,0,26,20,10,18,18,0.217,0.391,0.391,18.166,14,riffle_clumpy
0,15,28,4,47,0.319,19,0.404,0,3,0.0,3,3,26,21,10,20,17,0.213,0.426,0.362,18.191,15,riffle_clumpy
0,21,24,1,46,0.457,22,0.478,2,1,0.667,3,4,31,15,13,15,18,0.283,0.326,0.391,18.22,16,riffle_clumpy
0,19,28,3,50,0.38,22,0.44,6,2,0.75,2,3,32,18,9,15,26,0.18,0.3,0.52,18.232,17,riffle_clumpy
0,18,27,1,46,0.391,19,0.413,1,0,1.0,0,2,36,10,13,12,21,0.283,0.261,0.457,18.213,18,riffle_clumpy
0,20,21,6,47,0.426,26,0.553,1,2,0.333,3,3,34,13,10,16,21,0.213,0.34,0.447,18.209,19,riffle_clumpy
0,21,21,4,46,0.457,25,0.543,1,0,1.0,3,2,28,18,14,10,22,0.304,0.217,0.478,18.176,20,riffle_clumpy
0,18,25,3,46,0.391,21,0.457,6,2,0.75,0,3,28,18,9,19,18,0.196,0.413,0.391,18.2,21,riffle_clumpy
0,27,20,0,47,0.574,27,0.574,5,2,0.714,2,2,29,18,19,11,17,0.404,0.234,0.362,18.193,22,riffle_clumpy
0,17,26,5,48,0.354,22,0.458,3,4,0.429,0,2,22,26,12,22,14,0.25,0.458,0.292,18.217,23,riffle_clumpy
0,17,28,2,47,0.362,19,0.404,5,1,0.833,1,1,28,19,10,19,18,0.213,0.404,0.383,18.214,24,riffle_clumpy
0,24,20,3,47,0.511,27,0.574,2,2,0.5,2,5,29,18,16,15,16,0.34,0.319,0.34,18.191,25,riffle_clumpy
0,20,26,4,50,0.4,24,0.48,1,2,0.333,4,1,33,17,8,19,23,0.16,0.38,0.46,18.169,26,riffle_clumpy
0,20,24,4,48,0.417,24,0.5,4,2,0.667,4,2,33,15,9,20,19,0.188,0.417,0.396,18.145,27,riffle_clumpy
0,18,25,5,48,0.375,23,0.479,1,2,0.333,2,1,30,18,10,18,20,0.208,0.375,0.417,18.147,28,riffle_clumpy
0,21,25,2,48,0.438,23,0.479,2,2,0.5,3,2,28,20,14,18,16,0.292,0.375,0.333,18.159,29,riffle_clumpy
0,21,24,4,49,0.429,25,0.51,2,1,0.667,0,2,28,21,14,19,16,0.286,0.388,0.327,18.157,30,riffle_clumpy
0,17,27,3,47,0.362,20,0.426,1,3,0.25,2,2,33,14,9,15,23,0.191,0.319,0.489,18.153,31,riffle_clumpy
0,25,18,3,46,0.543,28,0.609,7,2,0.778,4,2,26,20,14,15,17,0.304,0.326,0.37,18.127,32,riffle_clumpy
0,24,23,2,49,0.49,26,0.531,1,5,0.167,3,2,30,19,12,17,20,0.245,0.347,0.408,18.12,33,riffle_clumpy
0,18,25,5,48,0.375,23,0.479,0,2,0.0,2,6,35,13,11,13,24,0.229,0.271,0.5,18.106,34,riffle_clumpy
0,19,23,4,46,0.413,23,0.5,7,1,0.875,2,1,30,16,11,14,21,0.239,0.304,0.457,18.079,35,riffle_clumpy
0,18,28,2,48,0.375,20,0.417,2,2,0.5,1,1,27,21,10,19,19,0.208,0.396,0.396,18.081,36,riffle_clumpy
0,27,20,1,48,0.562,28,0.583,6,3,0.667,2,2,30,18,17,20,11,0.354,0.417,0.229,18.087,37,riffle_clumpy
0,16,26,10,52,0.308,26,0.5,1,6,0.143,2,3,38,14,11,16,25,0.212,0.308,0.481,18.088,38,riffle_clumpy
0,22,23,4,49,0.449,26,0.531,3,1,0.75,2,3,32,17,15,17,17,0.306,0.347,0.347,18.091,39,riffle_clumpy
0,25,23,2,50,0.5,27,0.54,2,1,0.667,5,0,35,15,14,13,23,0.28,0.26,0.46,18.089,40,riffle_clumpy
0,23,22,1,46,0.5,24,0.522,3,2,0.6,2,5,32,14,13,13,20,0.283,0.283,0.435,18.09,41,riffle_clumpy
0,20,26,1,47,0.426,21,0.447,0,4,0.0,1,4,33,14,12,12,23,0.255,0.255,0.489,18.071,42,riffle_clumpy
0,22,22,4,48,0.458,26,0.542,3,1,0.75,2,5,29,19,13,12,23,0.271,0.25,0.479,18.044,43,riffle_clumpy
0,27,18,2,47,0.574,29,0.617,4,2,0.667,5,2,20,27,15,14,18,0.319,0.298,0.383,18.036,44,riffle_clumpy
0,27,17,3,47,0.574,30,0.638,4,6,0.4,2,5,28,19,15,10,22,0.319,0.213,0.468,18.028,45,riffle_clumpy
0,21,21,6,48,0.438,27,0.562,4,0,1.0,4,3,32,16,8,15,25,0.167,0.312,0.521,18.025,46,riffle_clumpy
0,21,23,1,45,0.467,22,0.489,1,1,0.5,4,2,23,22,12,19,14,0.267,0.422,0.311,18.018,47,riffle_clumpy
0,22,22,4,48,0.458,26,0.542,7,3,0.7,3,3,33,15,12,12,24,0.25,0.25,0.5,18.011,48,riffle_clumpy
0,17,26,4,47,0.362,21,0.447,1,4,0.2,3,2,29,18,10,17,20,0.213,0.362,0.426,18.008,49,riffle_clumpy
0,18,26,3,47,0.383,21,0.447,3,1,0.75,1,4,23,24,14,11,22,0.298,0.234,0.468,18.012,50,riffle_clumpy
0,18,28,1,47,0.383,19,0.404,3,3,0.5,1,1,34,13,8,23,16,0.17,0.489,0.34,18.022,51,riffle_clumpy
0,24,21,2,47,0.511,26,0.553,4,0,1.0,2,2,31,16,8,20,19,0.17,0.426,0.404,18.031,52,riffle_clumpy
0,21,25,0,46,0.457,21,0.457,4,3,0.571,4,3,31,15,13,12,21,0.283,0.261,0.457,18.038,53,riffle_clumpy
0,18,28,1,47,0.383,19,0.404,0,0,0,2,3,31,16,14,20,13,0.298,0.426,0.277,18.028,54,riffle_clumpy
0,15,31,1,47,0.319,16,0.34,2,4,0.333,3,2,26,21,9,17,21,0.191,0.362,0.447,18.025,55,riffle_clumpy
0,18,26,3,47,0.383,21,0.447,4,0,1.0,3,0,30,17,12,12,23,0.255,0.255,0.489,18.026,56,riffle_clumpy
0,16,30,2,48,0.333,18,0.375,1,2,0.333,3,1,29,19,11,17,20,0.229,0.354,0.417,18.027,57,riffle_clumpy
0,15,30,2,47,0.319,17,0.362,6,3,0.667,2,4,30,17,9,17,21,0.191,0.362,0.447,18.029,58,riffle_clumpy
0,28,18,1,47,0.596,29,0.617,7,1,0.875,2,2,22,25,18,17,12,0.383,0.362,0.255,18.031,59,riffle_clumpy
0,17,22,6,45,0.378,23,0.511,3,1,0.75,1,1,29,16,9,21,15,0.2,0.467,0.333,18.035,60,riffle_clumpy
0,23,22,2,47,0.489,25,0.532,2,1,0.667,3,2,32,15,15,9,23,0.319,0.191,0.489,18.024,61,riffle_clumpy
0,17,28,2,47,0.362,19,0.404,3,2,0.6,4,1,31,16,9,16,22,0.191,0.34,0.468,18.031,62,riffle_clumpy
0,22,24,2,48,0.458,24,0.5,1,0,1.0,3,1,32,16,13,13,22,0.271,0.271,0.458,18.029,63,riffle_clumpy
0,19,22,4,45,0.422,23,0.511,2,1,0.667,3,0,27,18,11,18,16,0.244,0.4,0.356,18.024,64,riffle_clumpy
0,18,22,5,45,0.4,23,0.511,1,2,0.333,1,1,27,18,12,18,15,0.267,0.4,0.333,18.027,65,riffle_clumpy
0,22,21,5,48,0.458,27,0.562,5,1,0.833,4,2,27,21,12,18,18,0.25,0.375,0.375,18.026,66,riffle_clumpy
0,14,28,9,51,0.275,23,0.451,2,7,0.222,2,0,28,23,9,24,18,0.176,0.471,0.353,18.03,67,riffle_clumpy
0,21,25,1,47,0.447,22,0.468,3,2,0.6,4,2,29,18,13,13,21,0.277,0.277,0.447,18.027,68,riffle_clumpy
0,22,20,3,45,0.489,25,0.556,3,1,0.75,1,1,26,19,13,17,15,0.289,0.378,0.333,18.031,69,riffle_clumpy
0,26,19,4,49,0.531,30,0.612,3,1,0.75,3,1,28,21,13,16,20,0.265,0.327,0.408,18.029,70,riffle_clumpy
0,19,23,4,46,0.413,23,0.5,3,3,0.5,1,2,25,21,13,15,18,0.283,0.326,0.391,18.03,71,riffle_clumpy
0,18,25,3,46,0.391,21,0.457,1,5,0.167,0,0,32,14,12,17,17,0.261,0.37,0.37,18.034,72,riffle_clumpy
0,18,25,2,45,0.4,20,0.444,2,2,0.5,0,2,24,21,17,13,15,0.378,0.289,0.333,18.037,73,riffle_clumpy
0,19,24,1,44,0.432,20,0.455,2,0,1.0,1,2,25,19,13,16,15,0.295,0.364,0.341,18.041,74,riffle_clumpy
0,11,28,7,46,0.239,18,0.391,1,3,0.25,1,2,31,15,5,18,23,0.109,0.391,0.5,18.046,75,riffle_clumpy
0,21,20,4,45,0.467,25,0.556,4,5,0.444,1,2,23,22,10,17,18,0.222,0.378,0.4,18.049,76,riffle_clumpy
0,20,22,4,46,0.435,24,0.522,4,2,0.667,1,2,24,22,11,17,18,0.239,0.37,0.391,18.047,77,riffle_clumpy
0,15,32,2,49,0.306,17,0.347,3,4,0.429,0,1,31,18,7,19,23,0.143,0.388,0.469,18.054,78,riffle_clumpy
0,26,17,3,46,0.565,29,0.63,5,0,1.0,4,1,26,20,14,13,19,0.304,0.283,0.413,18.043,79,riffle_clumpy
0,17,24,6,47,0.362,23,0.489,3,2,0.6,2,0,28,19,10,18,19,0.213,0.383,0.404,18.041,80,riffle_clumpy
0,17,23,6,46,0.37,23,0.5,2,2,0.5,3,2,29,17,7,18,21,0.152,0.391,0.457,18.043,81,riffle_clumpy
0,28,18,0,46,0.609,28,0.609,5,1,0.833,2,2,26,20,16,17,13,0.348,0.37,0.283,18.043,82,riffle_clumpy
0,20,23,3,46,0.435,23,0.5,5,2,0.714,3,4,29,17,12,13,21,0.261,0.283,0.457,18.039,83,riffle_clumpy
0,23,24,1,48,0.479,24,0.5,7,1,0.875,1,2,27,21,16,13,19,0.333,0.271,0.396,18.039,84,riffle_clumpy
0,24,21,3,48,0.5,27,0.562,2,2,0.5,0,1,25,23,19,14,15,0.396,0.292,0.312,18.043,85,riffle_clumpy
0,15,30,3,48,0.312,18,0.375,3,4,0.429,1,1,29,19,8,17,23,0.167,0.354,0.479,18.05,86,riffle_clumpy
0,25,20,3,48,0.521,28,0.583,8,4,0.667,0,1,24,24,13,19,16,0.271,0.396,0.333,18.053,87,riffle_clumpy
0,16,26,5,47,0.34,21,0.447,3,1,0.75,2,3,34,13,9,13,25,0.191,0.277,0.532,18.057,88,riffle_clumpy
0,23,19,4,46,0.5,27,0.587,4,2,0.667,2,2,30,16,14,13,19,0.304,0.283,0.413,18.059,89,riffle_clumpy
0,24,21,2,47,0.511,26,0.553,3,0,1.0,2,2,24,23,12,21,14,0.255,0.447,0.298,18.058,90,riffle_clumpy
0,22,20,1,43,0.512,23,0.535,8,1,0.889,0,1,26,17,15,15,13,0.349,0.349,0.302,18.063,91,riffle_clumpy
0,22,17,5,44,0.5,27,0.614,4,0,1.0,1,3,23,21,13,17,14,0.295,0.386,0.318,18.066,92,riffle_clumpy
0,21,23,5,49,0.429,26,0.531,2,2,0.5,1,0,37,12,12,15,22,0.245,0.306,0.449,18.068,93,riffle_clumpy
0,21,26,1,48,0.438,22,0.458,3,1,0.75,4,2,29,19,12,16,20,0.25,0.333,0.417,18.062,94,riffle_clumpy
0,16,27,4,47,0.34,20,0.426,4,3,0.571,0,0,35,12,11,22,14,0.234,0.468,0.298,18.066,95,riffle_clumpy
0,19,23,4,46,0.413,23,0.5,4,2,0.667,1,3,33,13,8,25,13,0.174,0.543,0.283,18.067,96,riffle_clumpy
0,23,18,5,46,0.5,28,0.609,2,5,0.286,4,2,26,20,10,19,17,0.217,0.413,0.37,18.103,1,riffle_clumpy
0,21,20,3,44,0.477,24,0.545,2,4,0.333,1,3,32,12,15,10,19,0.341,0.227,0.432,17.923,2,riffle_clumpy
0,16,29,2,47,0.34,18,0.383,3,4,0.429,2,2,28,19,8,19,20,0.17,0.404,0.426,18.108,3,riffle_clumpy
0,18,25,1,44,0.409,19,0.432,3,2,0.6,1,3,23,21,12,19,13,0.273,0.432,0.295,18.093,4,riffle_clumpy
0,22,23,2,47,0.468,24,0.511,5,3,0.625,2,3,21,26,16,15,16,0.34,0.319,0.34,18.115,5,riffle_clumpy
0,20,27,4,51,0.392,24,0.471,7,2,0.778,0,2,32,19,16,15,20,0.314,0.294,0.392,18.261,6,riffle_clumpy
0,22,25,3,50,0.44,25,0.5,4,2,0.667,4,3,28,22,10,15,25,0.2,0.3,0.5,18.216,7,riffle_clumpy
0,23,22,2,47,0.489,25,0.532,4,2,0.667,1,0,27,20,15,22,10,0.319,0.468,0.213,18.155,8,riffle_clumpy
0,18,27,2,47,0.383,20,0.426,2,3,0.4,1,4,26,21,13,17,17,0.277,0.362,0.362,18.168,9,riffle_clumpy
0,13,31,2,46,0.283,15,0.326,2,4,0.333,2,2,29,17,10,19,17,0.217,0.413,0.37,18.149,10,riffle_clumpy
0,19,27,4,50,0.38,23,0.46,2,4,0.333,0,3,30,20,13,19,18,0.26,0.38,0.36,18.186,11,riffle_clumpy
0,26,18,4,48,0.542,30,0.625,8,4,0.667,4,0,23,25,16,15,17,0.333,0.312,0.354,18.087,12,riffle_clumpy
0,23,22,3,48,0.479,26,0.542,5,1,0.833,4,1,26,22,14,16,18,0.292,0.333,0.375,18.074,13,riffle_clumpy
0,17,23,5,45,0.378,22,0.489,1,4,0.2,1,2,29,16,12,14,19,0.267,0.311,0.422,18.12,14,riffle_clumpy
0,22,20,4,46,0.478,26,0.565,8,1,0.889,3,3,29,17,15,8,23,0.326,0.174,0.5,18.102,15,riffle_clumpy
0,22,23,4,49,0.449,26,0.531,4,3,0.571,3,2,26,23,13,19,17,0.265,0.388,0.347,18.123,16,riffle_clumpy
0,20,23,4,47,0.426,24,0.511,4,4,0.5,2,0,30,17,11,18,18,0.234,0.383,0.383,18.14,17,riffle_clumpy
0,21,22,2,45,0.467,23,0.511,3,0,1.0,1,2,28,17,12,13,20,0.267,0.289,0.444,18.148,18,riffle_clumpy
0,21,19,5,45,0.467,26,0.578,4,2,0.667,3,0,26,19,14,13,18,0.311,0.289,0.4,18.132,19,riffle_clumpy
0,24,21,3,48,0.5,27,0.562,2,4,0.333,2,1,24,24,14,20,14,0.292,0.417,0.292,18.093,20,riffle_clumpy
0,18,22,6,46,0.391,24,0.522,2,1,0.667,1,2,20,26,11,23,12,0.239,0.5,0.261,18.09,21,riffle_clumpy
0,20,23,4,47,0.426,24,0.511,4,0,1.0,0,0,24,23,13,18,16,0.277,0.383,0.34,18.072,22,riffle_clumpy
0,18,27,2,47,0.383,20,0.426,2,2,0.5,3,3,28,19,10,17,20,0.213,0.362,0.426,18.072,23,riffle_clumpy
0,19,24,5,48,0.396,24,0.5,3,3,0.5,2,4,36,12,11,17,20,0.229,0.354,0.417,18.083,24,riffle_clumpy
0,19,27,3,49,0.388,22,0.449,7,3,0.7,2,3,33,16,8,19,22,0.163,0.388,0.449,18.087,25,riffle_clumpy
0,18,25,3,46,0.391,21,0.457,3,3,0.5,4,2,26,20,7,21,18,0.152,0.457,0.391,18.082,26,riffle_clumpy
0,18,25,3,46,0.391,21,0.457,2,1,0.667,3,4,27,19,12,14,20,0.261,0.304,0.435,18.084,27,riffle_clumpy
0,20,23,8,51,0.392,28,0.549,6,3,0.667,4,3,29,22,11,19,21,0.216,0.373,0.412,18.069,28,riffle_clumpy
0,24,16,5,45,0.533,29,0.644,3,4,0.429,1,2,26,19,16,14,15,0.356,0.311,0.333,18.071,29,riffle_clumpy
0,19,20,5,44,0.432,24,0.545,2,2,0.5,2,2,25,19,12,21,11,0.273,0.477,0.25,18.068,30,riffle_clumpy
0,18,23,4,45,0.4,22,0.489,2,4,0.333,0,3,32,13,13,13,19,0.289,0.289,0.422,18.089,31,riffle_clumpy
0,21,23,2,46,0.457,23,0.5,4,1,0.8,1,3,30,16,12,13,21,0.261,0.283,0.457,18.079,32,riffle_clumpy
0,23,21,2,46,0.5,25,0.543,5,3,0.625,2,3,26,20,16,13,17,0.348,0.283,0.37,18.066,33,riffle_clumpy
0,19,24,5,48,0.396,24,0.5,3,3,0.5,4,0,27,21,8,25,15,0.167,0.521,0.312,18.079,34,riffle_clumpy
0,18,24,4,46,0.391,22,0.478,4,2,0.667,3,3,29,17,10,14,22,0.217,0.304,0.478,18.066,35,riffle_clumpy
0,24,21,1,46,0.522,25,0.543,2,1,0.667,2,1,25,21,18,15,13,0.391,0.326,0.283,18.077,36,riffle_clumpy
0,21,20,5,46,0.457,26,0.565,2,2,0.5,1,2,31,15,16,14,16,0.348,0.304,0.348,18.045,37,riffle_clumpy
0,23,17,5,45,0.511,28,0.622,4,3,0.571,2,1,28,17,14,15,16,0.311,0.333,0.356,18.053,38,riffle_clumpy
0,20,23,5,48,0.417,25,0.521,7,3,0.7,2,1,24,24,15,15,18,0.312,0.312,0.375,18.066,39,riffle_clumpy
0,19,26,3,48,0.396,22,0.458,2,3,0.4,4,2,27,21,13,16,19,0.271,0.333,0.396,18.064,40,riffle_clumpy
0,17,25,4,46,0.37,21,0.457,1,5,0.167,1,2,25,21,12,19,15,0.261,0.413,0.326,18.067,41,riffle_clumpy
0,15,29,3,47,0.319,18,0.383,2,1,0.667,0,3,33,14,12,16,19,0.255,0.34,0.404,18.088,42,riffle_clumpy
0,22,21,1,44,0.5,23,0.523,6,5,0.545,0,1,22,22,14,18,12,0.318,0.409,0.273,18.104,43,riffle_clumpy
0,19,20,7,46,0.413,26,0.565,1,0,1.0,4,0,35,11,6,19,21,0.13,0.413,0.457,18.11,44,riffle_clumpy
0,19,23,4,46,0.413,23,0.5,2,1,0.667,1,4,32,14,11,16,19,0.239,0.348,0.413,18.11,45,riffle_clumpy
0,23,23,1,47,0.489,24,0.511,1,0,1.0,6,3,30,17,8,14,25,0.17,0.298,0.532,18.08,46,riffle_clumpy
0,23,18,5,46,0.5,28,0.609,1,0,1.0,3,3,31,15,16,14,16,0.348,0.304,0.348,18.079,47,riffle_clumpy
0,18,27,2,47,0.383,20,0.426,0,0,0,1,1,28,19,12,16,19,0.255,0.34,0.404,18.089,48,riffle_clumpy
0,28,16,3,47,0.596,31,0.66,7,0,1.0,2,1,22,25,15,16,16,0.319,0.34,0.34,18.085,49,riffle_clumpy
0,17,26,2,45,0.378,19,0.422,2,2,0.5,2,0,30,15,11,15,19,0.244,0.333,0.422,18.085,50,riffle_clumpy
0,18,25,5,48,0.375,23,0.479,1,2,0.333,4,0,34,14,8,16,24,0.167,0.333,0.5,18.084,51,riffle_clumpy
0,15,29,6,50,0.3,21,0.42,1,0,1.0,2,3,34,16,8,21,21,0.16,0.42,0.42,18.088,52,riffle_clumpy
0,25,18,4,47,0.532,29,0.617,4,3,0.571,2,3,32,15,14,13,20,0.298,0.277,0.426,18.082,53,riffle_clumpy
0,19,24,3,46,0.413,22,0.478,8,3,0.727,1,4,21,25,12,17,17,0.261,0.37,0.37,18.075,54,riffle_clumpy
0,23,19,4,46,0.5,27,0.587,4,0,1.0,2,1,29,17,12,15,19,0.261,0.326,0.413,18.065,55,riffle_clumpy
0,18,22,8,48,0.375,26,0.542,1,3,0.25,7,2,28,20,8,19,21,0.167,0.396,0.438,18.058,56,riffle_clumpy
0,16,28,2,46,0.348,18,0.391,3,3,0.5,2,3,33,13,8,16,22,0.174,0.348,0.478,18.064,57,riffle_clumpy
0,19,26,2,47,0.404,21,0.447,4,1,0.8,0,1,29,18,5,21,21,0.106,0.447,0.447,18.072,58,riffle_clumpy
0,21,22,4,47,0.447,25,0.532,0,2,0.0,1,2,25,22,14,16,17,0.298,0.34,0.362,18.072,59,riffle_clumpy
0,21,24,5,50,0.42,26,0.52,3,2,0.6,3,2,31,19,9,19,22,0.18,0.38,0.44,18.075,60,riffle_clumpy
0,24,25,1,50,0.48,25,0.5,4,2,0.667,3,2,32,18,13,17,20,0.26,0.34,0.4,18.076,61,riffle_clumpy
0,19,26,3,48,0.396,22,0.458,4,1,0.8,2,3,32,16,11,14,23,0.229,0.292,0.479,18.07,62,riffle_clumpy
0,20,25,5,50,0.4,25,0.5,3,2,0.6,3,1,29,21,8,23,19,0.16,0.46,0.38,18.061,63,riffle_clumpy
0,18,24,3,45,0.4,21,0.467,4,3,0.571,1,2,28,17,10,20,15,0.222,0.444,0.333,18.063,64,riffle_clumpy
0,24,19,4,47,0.511,28,0.596,3,2,0.6,3,5,32,15,15,13,19,0.319,0.277,0.404,18.049,65,riffle_clumpy
0,19,23,6,48,0.396,25,0.521,2,2,0.5,0,3,28,20,13,18,17,0.271,0.375,0.354,18.053,66,riffle_clumpy
0,21,22,4,47,0.447,25,0.532,4,1,0.8,2,2,29,18,13,16,18,0.277,0.34,0.383,18.055,67,riffle_clumpy
0,20,27,1,48,0.417,21,0.438,3,3,0.5,2,3,26,22,12,22,14,0.25,0.458,0.292,18.055,68,riffle_clumpy
0,18,19,8,45,0.4,26,0.578,2,2,0.5,1,2,30,15,10,18,17,0.222,0.4,0.378,18.062,69,riffle_clumpy
0,13,27,6,46,0.283,19,0.413,2,1,0.667,2,3,26,20,8,16,22,0.174,0.348,0.478,18.056,70,riffle_clumpy
0,14,27,6,47,0.298,20,0.426,4,1,0.8,1,3,33,14,9,15,23,0.191,0.319,0.489,18.058,71,riffle_clumpy
0,15,26,5,46,0.326,20,0.435,0,2,0.0,3,2,29,17,9,15,22,0.196,0.326,0.478,18.056,72,riffle_clumpy
0,19,25,2,46,0.413,21,0.457,6,1,0.857,3,2,27,19,12,19,15,0.261,0.413,0.326,18.061,73,riffle_clumpy
0,21,24,4,49,0.429,25,0.51,2,3,0.4,2,1,26,23,16,16,17,0.327,0.327,0.347,18.053,74,riffle_clumpy
0,22,24,1,47,0.468,23,0.489,3,0,1.0,1,0,28,19,11,22,14,0.234,0.468,0.298,18.06,75,riffle_clumpy
0,24,25,1,50,0.48,25,0.5,0,2,0.0,2,1,29,21,14,16,20,0.28,0.32,0.4,18.058,76,riffle_clumpy
0,22,21,2,45,0.489,24,0.533,1,0,1.0,1,4,30,15,13,19,13,0.289,0.422,0.289,18.058,77,riffle_clumpy
0,20,26,1,47,0.426,21,0.447,2,1,0.667,1,5,29,18,12,17,18,0.255,0.362,0.383,18.056,78,riffle_clumpy
0,25,19,5,49,0.51,30,0.612,4,4,0.5,3,0,26,23,13,18,18,0.265,0.367,0.367,18.052,79,riffle_clumpy
0,22,26,1,49,0.449,23,0.469,3,0,1.0,2,4,34,15,12,13,24,0.245,0.265,0.49,18.046,80,riffle_clumpy
0,22,25,3,50,0.44,25,0.5,4,1,0.8,3,1,34,16,7,19,24,0.14,0.38,0.48,18.042,81,riffle_clumpy
0,18,25,3,46,0.391,21,0.457,3,1,0.75,1,4,32,14,7,20,19,0.152,0.435,0.413,18.041,82,riffle_clumpy
0,24,21,3,48,0.5,27,0.562,4,0,1.0,5,1,26,22,13,15,20,0.271,0.312,0.417,18.042,83,riffle_clumpy
0,14,29,3,46,0.304,17,0.37,4,1,0.8,0,3,32,14,9,17,20,0.196,0.37,0.435,18.042,84,riffle_clumpy
0,18,26,1,45,0.4,19,0.422,4,4,0.5,1,0,32,13,11,14,20,0.244,0.311,0.444,18.039,85,riffle_clumpy
0,18,26,2,46,0.391,20,0.435,1,2,0.333,0,1,28,18,12,13,21,0.261,0.283,0.457,18.045,86,riffle_clumpy
0,23,22,4,49,0.469,27,0.551,0,4,0.0,2,2,31,18,17,15,17,0.347,0.306,0.347,18.048,87,riffle_clumpy
0,20,24,3,47,0.426,23,0.489,3,2,0.6,2,1,28,19,11,20,16,0.234,0.426,0.34,18.055,88,riffle_clumpy
0,21,22,4,47,0.447,25,0.532,2,2,0.5,1,3,31,16,14,12,21,0.298,0.255,0.447,18.057,89,riffle_clumpy
0,19,24,4,47,0.404,23,0.489,2,1,0.667,5,1,26,21,7,18,22,0.149,0.383,0.468,18.05,90,riffle_clumpy
0,24,21,1,46,0.522,25,0.543,8,3,0.727,1,1,26,20,17,14,15,0.37,0.304,0.326,18.051,91,riffle_clumpy
0,16,26,5,47,0.34,21,0.447,1,2,0.333,1,1,31,16,9,16,22,0.191,0.34,0.468,18.047,92,riffle_clumpy
0,11,37,1,49,0.224,12,0.245,1,3,0.25,3,5,30,19,6,20,23,0.122,0.408,0.469,18.051,93,riffle_clumpy
0,20,21,4,45,0.444,24,0.533,2,0,1.0,2,1,30,15,11,21,13,0.244,0.467,0.289,18.051,94,riffle_clumpy
0,19,28,1,48,0.396,20,0.417,3,3,0.5,2,4,28,20,12,17,19,0.25,0.354,0.396,18.048,95,riffle_clumpy
0,21,22,5,48,0.438,26,0.542,1,1,0.5,4,2,28,20,13,13,22,0.271,0.271,0.458,18.038,96,riffle_clumpy
0,21,21,3,45,0.467,24,0.533,3,1,0.75,3,3,27,18,13,15,17,0.289,0.333,0.378,18.0,1,riffle_clumpy
0,23,21,4,48,0.479,27,0.562,3,1,0.75,3,2,32,16,16,13,19,0.333,0.271,0.396,18.037,2,riffle_clumpy
0,27,16,5,48,0.562,32,0.667,5,2,0.714,3,1,27,21,15,15,18,0.312,0.312,0.375,18.071,3,riffle_clumpy
0,19,29,2,50,0.38,21,0.42,1,1,0.5,3,1,27,23,9,17,24,0.18,0.34,0.48,17.991,4,riffle_clumpy
0,22,20,4,46,0.478,26,0.565,4,1,0.8,2,1,32,14,11,21,14,0.239,0.457,0.304,18.083,5,riffle_clumpy
0,18,30,5,53,0.34,23,0.434,2,7,0.222,2,4,32,21,9,14,30,0.17,0.264,0.566,18.061,6,riffle_clumpy
0,26,17,3,46,0.565,29,0.63,2,0,1.0,3,2,33,13,13,12,21,0.283,0.261,0.457,18.029,7,riffle_clumpy
0,21,24,2,47,0.447,23,0.489,2,5,0.286,3,1,31,16,10,17,20,0.213,0.362,0.426,18.054,8,riffle_clumpy
0,12,28,8,48,0.25,20,0.417,2,3,0.4,2,2,27,21,7,27,14,0.146,0.562,0.292,18.07,9,riffle_clumpy
0,19,23,6,48,0.396,25,0.521,1,2,0.333,3,5,34,14,15,11,22,0.312,0.229,0.458,18.057,10,riffle_clumpy
0,21,22,5,48,0.438,26,0.542,3,3,0.5,3,1,32,16,14,15,19,0.292,0.312,0.396,18.064,11,riffle_clumpy
0,13,30,4,47,0.277,17,0.362,3,1,0.75,2,0,27,20,9,16,22,0.191,0.34,0.468,18.078,12,riffle_clumpy
0,21,22,1,44,0.477,22,0.5,4,1,0.8,1,0,28,16,13,21,10,0.295,0.477,0.227,18.049,13,riffle_clumpy
0,21,23,2,46,0.457,23,0.5,5,1,0.833,2,2,27,19,18,11,17,0.391,0.239,0.37,18.062,14,riffle_clumpy
0,16,26,3,45,0.356,19,0.422,3,2,0.6,0,0,31,14,10,14,21,0.222,0.311,0.467,18.097,15,riffle_clumpy
0,17,25,4,46,0.37,21,0.457,6,2,0.75,1,2,26,20,11,18,17,0.239,0.391,0.37,18.129,16,riffle_clumpy
0,21,24,3,48,0.438,24,0.5,6,1,0.857,1,5,33,15,14,11,23,0.292,0.229,0.479,18.153,17,riffle_clumpy
0,19,22,4,45,0.422,23,0.511,1,3,0.25,1,2,21,24,14,15,16,0.311,0.333,0.356,18.132,18,riffle_clumpy
0,20,23,1,44,0.455,21,0.477,4,5,0.444,1,3,26,18,13,14,17,0.295,0.318,0.386,18.135,19,riffle_clumpy
0,16,31,3,50,0.32,19,0.38,2,0,1.0,5,4,30,20,6,25,19,0.12,0.5,0.38,18.15,20,riffle_clumpy
0,16,27,3,46,0.348,19,0.413,5,4,0.556,1,2,27,19,8,19,19,0.174,0.413,0.413,18.164,21,riffle_clumpy
0,18,24,3,45,0.4,21,0.467,4,1,0.8,1,2,26,19,11,17,17,0.244,0.378,0.378,18.163,22,riffle_clumpy
0,20,25,1,46,0.435,21,0.457,4,0,1.0,2,1,35,11,12,16,18,0.261,0.348,0.391,18.178,23,riffle_clumpy
0,21,25,1,47,0.447,22,0.468,2,2,0.5,2,3,26,21,17,16,14,0.362,0.34,0.298,18.154,24,riffle_clumpy
0,24,25,0,49,0.49,24,0.49,5,2,0.714,3,4,35,14,16,11,22,0.327,0.224,0.449,18.145,25,riffle_clumpy
0,18,23,6,47,0.383,24,0.511,2,1,0.667,3,5,35,12,10,14,23,0.213,0.298,0.489,18.155,26,riffle_clumpy
0,20,25,4,49,0.408,24,0.49,1,4,0.2,4,1,23,26,11,20,18,0.224,0.408,0.367,18.102,27,riffle_clumpy
0,24,26,1,51,0.471,25,0.49,3,0,1.0,3,3,30,21,14,16,21,0.275,0.314,0.412,18.105,28,riffle_clumpy
0,18,24,4,46,0.391,22,0.478,1,2,0.333,1,2,26,20,11,16,19,0.239,0.348,0.413,18.119,29,riffle_clumpy
0,19,24,5,48,0.396,24,0.5,3,2,0.6,5,1,31,17,7,17,24,0.146,0.354,0.5,18.114,30,riffle_clumpy
0,21,25,4,50,0.42,25,0.5,2,0,1.0,1,2,32,18,17,12,21,0.34,0.24,0.42,18.108,31,riffle_clumpy
0,24,24,0,48,0.5,24,0.5,5,1,0.833,1,2,26,22,14,18,16,0.292,0.375,0.333,18.104,32,riffle_clumpy
0,16,26,6,48,0.333,22,0.458,5,0,1.0,3,0,31,17,11,21,16,0.229,0.438,0.333,18.115,33,riffle_clumpy
0,11,31,5,47,0.234,16,0.34,0,4,0.0,3,2,33,14,7,22,18,0.149,0.468,0.383,18.123,34,riffle_clumpy
0,21,24,4,49,0.429,25,0.51,4,0,1.0,1,3,25,24,15,17,17,0.306,0.347,0.347,18.122,35,riffle_clumpy
0,23,21,2,46,0.5,25,0.543,3,3,0.5,2,4,26,20,19,8,19,0.413,0.174,0.413,18.123,36,riffle_clumpy
0,24,17,5,46,0.522,29,0.63,2,2,0.5,3,1,28,18,17,12,17,0.37,0.261,0.37,18.109,37,riffle_clumpy
0,17,25,4,46,0.37,21,0.457,1,2,0.333,2,2,28,18,9,21,16,0.196,0.457,0.348,18.106,38,riffle_clumpy
0,18,25,5,48,0.375,23,0.479,4,2,0.667,1,4,30,18,12,19,17,0.25,0.396,0.354,18.103,39,riffle_clumpy
0,20,24,5,49,0.408,25,0.51,1,2,0.333,5,0,32,17,9,18,22,0.184,0.367,0.449,18.088,40,riffle_clumpy
0,20,23,5,48,0.417,25,0.521,3,3,0.5,2,0,30,18,11,18,19,0.229,0.375,0.396,18.099,41,riffle_clumpy
0,23,20,2,45,0.511,25,0.556,1,1,0.5,2,2,26,19,13,16,16,0.289,0.356,0.356,18.095,42,riffle_clumpy
0,18,24,3,45,0.4,21,0.467,3,2,0.6,0,0,30,15,10,16,19,0.222,0.356,0.422,18.11,43,riffle_clumpy
0,17,29,2,48,0.354,19,0.396,3,2,0.6,2,1,31,17,10,16,22,0.208,0.333,0.458,18.104,44,riffle_clumpy
0,21,22,2,45,0.467,23,0.511,3,1,0.75,4,3,32,13,12,13,20,0.267,0.289,0.444,18.094,45,riffle_clumpy
0,18,25,4,47,0.383,22,0.468,3,1,0.75,1,4,30,17,13,15,19,0.277,0.319,0.404,18.091,46,riffle_clumpy
0,24,25,2,51,0.471,26,0.51,4,3,0.571,2,2,31,20,14,16,21,0.275,0.314,0.412,18.083,47,riffle_clumpy
0,17,23,6,46,0.37,23,0.5,4,2,0.667,1,3,33,13,12,12,22,0.261,0.261,0.478,18.092,48,riffle_clumpy
0,21,22,2,45,0.467,23,0.511,3,2,0.6,1,4,30,15,9,19,17,0.2,0.422,0.378,18.092,49,riffle_clumpy
0,22,20,4,46,0.478,26,0.565,1,1,0.5,2,3,29,17,11,19,16,0.239,0.413,0.348,18.088,50,riffle_clumpy
0,26,22,2,50,0.52,28,0.56,3,2,0.6,1,2,27,23,15,19,16,0.3,0.38,0.32,18.092,51,riffle_clumpy
0,19,19,6,44,0.432,25,0.568,3,3,0.5,1,1,27,17,14,17,13,0.318,0.386,0.295,18.098,52,riffle_clumpy
0,18,25,5,48,0.375,23,0.479,2,2,0.5,2,4,27,21,10,19,19,0.208,0.396,0.396,18.089,53,riffle_clumpy
0,27,18,4,49,0.551,31,0.633,3,1,0.75,4,0,35,14,16,13,20,0.327,0.265,0.408,18.084,54,riffle_clumpy
0,22,23,2,47,0.468,24,0.511,3,1,0.75,3,1,26,21,11,16,20,0.234,0.34,0.426,18.064,55,riffle_clumpy
0,25,17,3,45,0.556,28,0.622,2,1,0.667,3,1,25,20,15,13,17,0.333,0.289,0.378,18.067,56,riffle_clumpy
0,21,25,1,47,0.447,22,0.468,3,3,0.5,6,1,27,20,9,16,22,0.191,0.34,0.468,18.06,57,riffle_clumpy
0,18,28,1,47,0.383,19,0.404,3,3,0.5,3,3,27,20,9,16,22,0.191,0.34,0.468,18.053,58,riffle_clumpy
0,22,22,4,48,0.458,26,0.542,3,0,1.0,4,2,32,16,10,14,24,0.208,0.292,0.5,18.055,59,riffle_clumpy
0,19,24,3,46,0.413,22,0.478,4,4,0.5,0,4,29,17,9,20,17,0.196,0.435,0.37,18.061,60,riffle_clumpy
0,26,15,3,44,0.591,29,0.659,5,3,0.625,1,1,29,15,12,15,17,0.273,0.341,0.386,18.068,61,riffle_clumpy
0,21,20,5,46,0.457,26,0.565,4,2,0.667,4,4,32,14,12,10,24,0.261,0.217,0.522,18.053,62,riffle_clumpy
0,23,21,4,48,0.479,27,0.562,3,2,0.6,5,6,33,15,11,13,24,0.229,0.271,0.5,18.035,63,riffle_clumpy
0,23,22,2,47,0.489,25,0.532,3,1,0.75,3,3,30,17,14,15,18,0.298,0.319,0.383,18.033,64,riffle_clumpy
0,19,24,4,47,0.404,23,0.489,4,2,0.667,2,3,28,19,12,18,17,0.255,0.383,0.362,18.029,65,riffle_clumpy
0,21,28,4,53,0.396,25,0.472,4,4,0.5,1,4,34,19,12,21,20,0.226,0.396,0.377,18.03,66,riffle_clumpy
0,19,24,4,47,0.404,23,0.489,4,5,0.444,0,4,25,22,14,17,16,0.298,0.362,0.34,18.038,67,riffle_clumpy
0,20,24,3,47,0.426,23,0.489,3,1,0.75,1,2,29,18,11,18,18,0.234,0.383,0.383,18.036,68,riffle_clumpy
0,13,28,5,46,0.283,18,0.391,2,2,0.5,0,5,26,20,10,19,17,0.217,0.413,0.37,18.045,69,riffle_clumpy
0,23,22,3,48,0.479,26,0.542,3,1,0.75,2,3,26,22,17,13,18,0.354,0.271,0.375,18.044,70,riffle_clumpy
0,21,21,3,45,0.467,24,0.533,4,3,0.571,2,2,30,15,13,17,15,0.289,0.378,0.333,18.045,71,riffle_clumpy
0,23,20,6,49,0.469,29,0.592,5,2,0.714,6,2,30,19,10,14,25,0.204,0.286,0.51,18.033,72,riffle_clumpy
0,23,23,2,48,0.479,25,0.521,5,3,0.625,1,5,26,22,18,9,21,0.375,0.188,0.438,18.035,73,riffle_clumpy
0,15,30,2,47,0.319,17,0.362,4,4,0.5,0,4,27,20,12,19,16,0.255,0.404,0.34,18.041,74,riffle_clumpy
0,20,25,2,47,0.426,22,0.468,3,4,0.429,6,3,33,14,7,20,20,0.149,0.426,0.426,18.038,75,riffle_clumpy
0,18,24,2,44,0.409,20,0.455,2,1,0.667,4,1,26,18,13,16,15,0.295,0.364,0.341,18.036,76,riffle_clumpy
0,16,26,5,47,0.34,21,0.447,3,2,0.6,3,4,32,15,11,15,21,0.234,0.319,0.447,18.035,77,riffle_clumpy
0,19,27,1,47,0.404,20,0.426,4,2,0.667,1,3,25,22,10,23,14,0.213,0.489,0.298,18.041,78,riffle_clumpy
0,21,24,4,49,0.429,25,0.51,2,5,0.286,2,0,27,22,13,15,21,0.265,0.306,0.429,18.05,79,riffle_clumpy
0,26,19,2,47,0.553,28,0.596,2,1,0.667,3,1,26,21,13,16,18,0.277,0.34,0.383,18.045,80,riffle_clumpy
0,21,24,3,48,0.438,24,0.5,3,5,0.375,4,4,29,19,13,18,17,0.271,0.375,0.354,18.044,81,riffle_clumpy
0,19,26,4,49,0.388,23,0.469,1,0,1.0,3,2,32,17,9,20,20,0.184,0.408,0.408,18.042,82,riffle_clumpy
0,19,20,6,45,0.422,25,0.556,1,3,0.25,2,2,27,18,11,18,16,0.244,0.4,0.356,18.047,83,riffle_clumpy
0,23,24,1,48,0.479,24,0.5,3,0,1.0,3,3,34,14,13,12,23,0.271,0.25,0.479,18.045,84,riffle_clumpy
0,24,23,0,47,0.511,24,0.511,3,4,0.429,4,2,30,17,13,12,22,0.277,0.255,0.468,18.047,85,riffle_clumpy
0,27,14,5,46,0.587,32,0.696,4,0,1.0,4,1,28,18,13,12,21,0.283,0.261,0.457,18.042,86,riffle_clumpy
0,17,24,8,49,0.347,25,0.51,1,4,0.2,4,2,28,21,9,17,23,0.184,0.347,0.469,18.044,87,riffle_clumpy
0,19,28,4,51,0.373,23,0.451,3,2,0.6,2,1,35,16,13,11,27,0.255,0.216,0.529,18.039,88,riffle_clumpy
0,28,15,1,44,0.636,29,0.659,6,1,0.857,3,0,31,13,12,17,15,0.273,0.386,0.341,18.037,89,riffle_clumpy
0,22,22,2,46,0.478,24,0.522,2,1,0.667,2,4,26,20,16,13,17,0.348,0.283,0.37,18.031,90,riffle_clumpy
0,19,23,5,47,0.404,24,0.511,1,4,0.2,3,0,29,18,12,14,21,0.255,0.298,0.447,18.036,91,riffle_clumpy
0,20,24,5,49,0.408,25,0.51,1,2,0.333,3,1,36,13,10,13,26,0.204,0.265,0.531,18.035,92,riffle_clumpy
0,23,25,1,49,0.469,24,0.49,3,2,0.6,3,0,29,20,16,9,24,0.327,0.184,0.49,18.034,93,riffle_clumpy
0,13,34,3,50,0.26,16,0.32,2,3,0.4,3,5,31,19,7,14,29,0.14,0.28,0.58,18.035,94,riffle_clumpy
0,22,20,3,45,0.489,25,0.556,3,0,1.0,2,1,21,24,16,14,15,0.356,0.311,0.333,18.035,95,riffle_clumpy
0,20,26,2,48,0.417,22,0.458,5,2,0.714,3,2,37,11,9,17,22,0.188,0.354,0.458,18.027,96,riffle_clumpy
0,17,21,8,46,0.37,25,0.543,3,3,0.5,3,1,30,16,13,14,19,0.283,0.304,0.413,18.31,1,riffle_clumpy
0,14,31,2,47,0.298,16,0.34,2,3,0.4,1,5,31,16,9,18,20,0.191,0.383,0.426,18.508,2,riffle_clumpy
0,19,27,1,47,0.404,20,0.426,4,0,1.0,1,4,28,19,11,13,23,0.234,0.277,0.489,18.225,3,riffle_clumpy
0,19,25,5,49,0.388,24,0.49,3,4,0.429,4,4,27,22,7,18,24,0.143,0.367,0.49,18.033,4,riffle_clumpy
0,19,23,6,48,0.396,25,0.521,2,1,0.667,2,1,29,19,8,20,20,0.167,0.417,0.417,18.076,5,riffle_clumpy
0,22,25,2,49,0.449,24,0.49,4,0,1.0,4,4,32,17,13,11,25,0.265,0.224,0.51,18.016,6,riffle_clumpy
0,21,24,2,47,0.447,23,0.489,4,1,0.8,3,1,25,22,13,15,19,0.277,0.319,0.404,17.949,7,riffle_clumpy
0,18,26,4,48,0.375,22,0.458,6,2,0.75,1,3,30,18,12,17,19,0.25,0.354,0.396,18.012,8,riffle_clumpy
0,17,27,1,45,0.378,18,0.4,4,1,0.8,1,3,27,18,15,13,17,0.333,0.289,0.378,18.011,9,riffle_clumpy
0,16,28,3,47,0.34,19,0.404,4,0,1.0,1,4,26,21,9,21,17,0.191,0.447,0.362,18.044,10,riffle_clumpy
0,18,25,3,46,0.391,21,0.457,1,1,0.5,2,1,26,20,12,15,19,0.261,0.326,0.413,18.028,11,riffle_clumpy
0,23,17,4,44,0.523,27,0.614,5,1,0.833,2,2,26,18,14,17,13,0.318,0.386,0.295,18.06,12,riffle_clumpy
0,19,27,4,50,0.38,23,0.46,3,2,0.6,3,3,32,18,12,18,20,0.24,0.36,0.4,18.047,13,riffle_clumpy
0,15,27,5,47,0.319,20,0.426,4,4,0.5,4,1,25,22,7,17,23,0.149,0.362,0.489,18.022,14,riffle_clumpy
0,17,23,6,46,0.37,23,0.5,3,3,0.5,3,2,31,15,12,17,17,0.261,0.37,0.37,18.047,15,riffle_clumpy
0,22,24,2,48,0.458,24,0.5,4,3,0.571,0,4,27,21,14,16,18,0.292,0.333,0.375,18.038,16,riffle_clumpy
0,22,21,5,48,0.458,27,0.562,3,5,0.375,4,2,23,25,12,19,17,0.25,0.396,0.354,18.046,17,riffle_clumpy
0,23,19,5,47,0.489,28,0.596,4,3,0.571,3,0,24,23,15,15,17,0.319,0.319,0.362,18.023,18,riffle_clumpy
0,22,25,2,49,0.449,24,0.49,0,1,0.0,1,3,36,13,12,18,19,0.245,0.367,0.388,18.018,19,riffle_clumpy
0,17,23,6,46,0.37,23,0.5,2,6,0.25,2,0,23,23,11,22,13,0.239,0.478,0.283,18.01,20,riffle_clumpy
0,22,19,4,45,0.489,26,0.578,4,3,0.571,1,3,24,21,16,10,19,0.356,0.222,0.422,18.012,21,riffle_clumpy
0,18,25,4,47,0.383,22,0.468,2,2,0.5,3,2,32,15,12,15,20,0.255,0.319,0.426,18.017,22,riffle_clumpy
0,23,22,3,48,0.479,26,0.542,2,1,0.667,4,1,26,22,14,15,19,0.292,0.312,0.396,18.027,23,riffle_clumpy
0,23,22,0,45,0.511,23,0.511,6,0,1.0,4,2,29,16,12,14,19,0.267,0.311,0.422,18.037,24,riffle_clumpy
0,18,24,4,46,0.391,22,0.478,2,1,0.667,0,1,34,12,13,15,18,0.283,0.326,0.391,18.062,25,riffle_clumpy
0,21,20,3,44,0.477,24,0.545,4,4,0.5,1,3,19,25,14,17,13,0.318,0.386,0.295,18.078,26,riffle_clumpy
0,14,27,5,46,0.304,19,0.413,2,2,0.5,1,1,30,16,9,18,19,0.196,0.391,0.413,18.075,27,riffle_clumpy
0,23,18,6,47,0.489,29,0.617,1,3,0.25,2,1,29,18,10,15,22,0.213,0.319,0.468,18.065,28,riffle_clumpy
0,16,26,8,50,0.32,24,0.48,5,4,0.556,2,2,34,16,12,15,23,0.24,0.3,0.46,18.068,29,riffle_clumpy
0,23,22,4,49,0.469,27,0.551,3,3,0.5,4,2,30,19,9,20,20,0.184,0.408,0.408,18.057,30,riffle_clumpy
0,24,19,3,46,0.522,27,0.587,2,2,0.5,2,1,26,20,14,19,13,0.304,0.413,0.283,18.068,31,riffle_clumpy
0,18,22,5,45,0.4,23,0.511,3,5,0.375,1,1,25,20,15,12,18,0.333,0.267,0.4,18.08,32,riffle_clumpy
0,16,32,2,50,0.32,18,0.36,0,5,0.0,3,5,30,20,8,17,25,0.16,0.34,0.5,18.077,33,riffle_clumpy
0,20,24,3,47,0.426,23,0.489,6,1,0.857,4,1,29,18,11,16,20,0.234,0.34,0.426,18.071,34,riffle_clumpy
0,23,20,5,48,0.479,28,0.583,6,1,0.857,2,1,31,17,13,13,22,0.271,0.271,0.458,18.074,35,riffle_clumpy
0,19,26,1,46,0.413,20,0.435,4,3,0.571,1,1,27,19,10,16,20,0.217,0.348,0.435,18.081,36,riffle_clumpy
0,21,18,6,45,0.467,27,0.6,7,1,0.875,2,3,30,15,10,15,20,0.222,0.333,0.444,18.081,37,riffle_clumpy
0,25,20,5,50,0.5,30,0.6,5,2,0.714,2,4,32,18,17,12,21,0.34,0.24,0.42,18.082,38,riffle_clumpy
0,17,28,4,49,0.347,21,0.429,0,1,0.0,1,2,28,21,11,13,25,0.224,0.265,0.51,18.098,39,riffle_clumpy
0,18,22,8,48,0.375,26,0.542,2,1,0.667,3,6,29,19,9,17,22,0.188,0.354,0.458,18.109,40,riffle_clumpy
0,26,19,1,46,0.565,27,0.587,1,2,0.333,4,3,23,23,17,13,16,0.37,0.283,0.348,18.099,41,riffle_clumpy
0,19,23,4,46,0.413,23,0.5,3,2,0.6,2,3,30,16,15,13,18,0.326,0.283,0.391,18.091,42,riffle_clumpy
0,21,21,3,45,0.467,24,0.533,1,2,0.333,0,2,27,18,16,15,14,0.356,0.333,0.311,18.09,43,riffle_clumpy
0,22,23,0,45,0.489,22,0.489,2,2,0.5,3,1,29,16,13,11,21,0.289,0.244,0.467,18.087,44,riffle_clumpy
0,20,24,2,46,0.435,22,0.478,5,1,0.833,4,3,28,18,11,15,20,0.239,0.326,0.435,18.089,45,riffle_clumpy
0,26,18,1,45,0.578,27,0.6,5,3,0.625,3,1,26,19,17,11,17,0.378,0.244,0.378,18.084,46,riffle_clumpy
0,21,24,2,47,0.447,23,0.489,3,1,0.75,1,4,27,20,13,18,16,0.277,0.383,0.34,18.08,47,riffle_clumpy
0,14,30,2,46,0.304,16,0.348,2,0,1.0,1,6,30,16,9,16,21,0.196,0.348,0.457,18.086,48,riffle_clumpy
0,14,33,3,50,0.28,17,0.34,1,6,0.143,0,7,34,16,9,14,27,0.18,0.28,0.54,18.091,49,riffle_clumpy
0,21,22,3,46,0.457,24,0.522,1,1,0.5,3,1,27,19,10,15,21,0.217,0.326,0.457,18.084,50,riffle_clumpy
0,18,29,1,48,0.375,19,0.396,4,3,0.571,0,5,30,18,12,13,23,0.25,0.271,0.479,18.094,51,riffle_clumpy
0,22,22,2,46,0.478,24,0.522,5,2,0.714,2,4,31,15,16,13,17,0.348,0.283,0.37,18.098,52,riffle_clumpy
0,20,25,3,48,0.417,23,0.479,0,3,0.0,1,2,25,23,12,21,15,0.25,0.438,0.312,18.101,53,riffle_clumpy
0,26,17,3,46,0.565,29,0.63,1,0,1.0,2,0,27,19,18,15,13,0.391,0.326,0.283,18.103,54,riffle_clumpy
0,15,28,3,46,0.326,18,0.391,2,3,0.4,2,3,38,8,9,16,21,0.196,0.348,0.457,18.097,55,riffle_clumpy
0,18,28,2,48,0.375,20,0.417,3,0,1.0,3,1,27,21,10,18,20,0.208,0.375,0.417,18.104,56,riffle_clumpy
0,19,22,5,46,0.413,24,0.522,1,0,1.0,3,2,26,20,12,15,19,0.261,0.326,0.413,18.1,57,riffle_clumpy
0,19,22,5,46,0.413,24,0.522,4,0,1.0,3,1,27,19,11,19,16,0.239,0.413,0.348,18.095,58,riffle_clumpy
0,22,21,5,48,0.458,27,0.562,3,1,0.75,3,4,25,23,12,18,18,0.25,0.375,0.375,18.093,59,riffle_clumpy
0,23,20,3,46,0.5,26,0.565,5,1,0.833,1,2,25,21,15,19,12,0.326,0.413,0.261,18.08,60,riffle_clumpy
0,22,21,2,45,0.489,24,0.533,3,1,0.75,2,2,27,18,14,13,18,0.311,0.289,0.4,18.071,61,riffle_clumpy
0,21,24,1,46,0.457,22,0.478,3,3,0.5,1,2,30,16,12,14,20,0.261,0.304,0.435,18.07,62,riffle_clumpy
0,27,16,5,48,0.562,32,0.667,3,1,0.75,2,1,27,21,18,14,16,0.375,0.292,0.333,18.064,63,riffle_clumpy
0,22,26,1,49,0.449,23,0.469,5,2,0.714,1,2,30,19,10,18,21,0.204,0.367,0.429,18.058,64,riffle_clumpy
0,19,26,3,48,0.396,22,0.458,2,1,0.667,1,4,34,14,16,8,24,0.333,0.167,0.5,18.055,65,riffle_clumpy
0,21,21,3,45,0.467,24,0.533,1,1,0.5,3,0,24,21,14,14,17,0.311,0.311,0.378,18.059,66,riffle_clumpy
0,21,22,5,48,0.438,26,0.542,2,3,0.4,3,1,23,25,12,22,14,0.25,0.458,0.292,18.053,67,riffle_clumpy
0,15,31,6,52,0.288,21,0.404,1,2,0.333,2,3,28,24,9,17,26,0.173,0.327,0.5,18.044,68,riffle_clumpy
0,23,20,3,46,0.5,26,0.565,3,3,0.5,3,2,29,17,9,18,19,0.196,0.391,0.413,18.05,69,riffle_clumpy
0,19,30,3,52,0.365,22,0.423,3,4,0.429,0,3,32,20,14,18,20,0.269,0.346,0.385,18.064,70,riffle_clumpy
0,24,23,4,51,0.471,28,0.549,3,4,0.429,5,2,35,16,16,13,22,0.314,0.255,0.431,18.057,71,riffle_clumpy
0,23,21,3,47,0.489,26,0.553,4,2,0.667,5,1,33,14,9,16,22,0.191,0.34,0.468,18.058,72,riffle_clumpy
0,21,21,4,46,0.457,25,0.543,5,1,0.833,1,1,29,17,8,14,24,0.174,0.304,0.522,18.061,73,riffle_clumpy
0,23,19,4,46,0.5,27,0.587,2,2,0.5,4,1,30,16,12,14,20,0.261,0.304,0.435,18.065,74,riffle_clumpy
0,21,22,7,50,0.42,28,0.56,2,3,0.4,1,1,32,18,11,22,17,0.22,0.44,0.34,18.064,75,riffle_clumpy
0,17,35,3,55,0.309,20,0.364,5,7,0.417,2,5,30,25,11,23,21,0.2,0.418,0.382,18.068,76,riffle_clumpy
0,26,15,5,46,0.565,31,0.674,2,1,0.667,6,2,21,25,17,15,14,0.37,0.326,0.304,18.058,77,riffle_clumpy
0,20,26,1,47,0.426,21,0.447,2,1,0.667,3,5,29,18,15,15,17,0.319,0.319,0.362,18.064,78,riffle_clumpy
0,19,23,4,46,0.413,23,0.5,1,0,1.0,2,2,31,15,11,20,15,0.239,0.435,0.326,18.055,79,riffle_clumpy
0,19,23,5,47,0.404,24,0.511,4,0,1.0,2,2,28,19,14,18,15,0.298,0.383,0.319,18.062,80,riffle_clumpy
0,24,21,3,48,0.5,27,0.562,1,3,0.25,2,1,23,25,13,20,15,0.271,0.417,0.312,18.059,81,riffle_clumpy
0,24,20,3,47,0.511,27,0.574,1,1,0.5,0,2,29,18,14,12,21,0.298,0.255,0.447,18.066,82,riffle_clumpy
0,25,21,3,49,0.51,28,0.571,6,3,0.667,1,2,32,17,15,17,17,0.306,0.347,0.347,18.067,83,riffle_clumpy
0,20,21,5,46,0.435,25,0.543,4,1,0.8,3,3,29,17,9,19,18,0.196,0.413,0.391,18.07,84,riffle_clumpy
0,14,28,5,47,0.298,19,0.404,0,1,0.0,2,3,27,20,10,21,16,0.213,0.447,0.34,18.076,85,riffle_clumpy
0,18,29,3,50,0.36,21,0.42,1,2,0.333,4,5,36,14,11,17,22,0.22,0.34,0.44,18.073,86,riffle_clumpy
0,18,22,5,45,0.4,23,0.511,4,2,0.667,3,2,22,23,14,15,16,0.311,0.333,0.356,18.068,87,riffle_clumpy
0,25,23,0,48,0.521,25,0.521,8,2,0.8,2,3,24,24,14,19,15,0.292,0.396,0.312,18.065,88,riffle_clumpy
0,20,25,2,47,0.426,22,0.468,0,4,0.0,3,2,32,15,11,14,22,0.234,0.298,0.468,18.059,89,riffle_clumpy
0,18,27,3,48,0.375,21,0.438,2,1,0.667,3,2,29,19,6,20,22,0.125,0.417,0.458,18.061,90,riffle_clumpy
0,19,29,1,49,0.388,20,0.408,2,2,0.5,3,2,27,22,13,18,18,0.265,0.367,0.367,18.06,91,riffle_clumpy
0,21,22,3,46,0.457,24,0.522,3,0,1.0,2,2,25,21,13,13,20,0.283,0.283,0.435,18.062,92,riffle_clumpy
0,22,25,3,50,0.44,25,0.5,3,2,0.6,2,4,36,14,10,17,23,0.2,0.34,0.46,18.063,93,riffle_clumpy
0,19,28,3,50,0.38,22,0.44,4,4,0.5,2,4,31,19,10,16,24,0.2,0.32,0.48,18.062,94,riffle_clumpy
0,29,16,5,50,0.58,34,0.68,2,1,0.667,2,2,36,14,17,13,20,0.34,0.26,0.4,18.064,95,riffle_clumpy
0,18,23,5,46,0.391,23,0.5,2,3,0.4,3,3,25,21,14,12,20,0.304,0.261,0.435,18.064,96,riffle_clumpy
0,15,26,5,46,0.326,20,0.435,3,2,0.6,1,3,30,16,10,17,19,0.217,0.37,0.413,18.5,1,riffle_clumpy
0,24,16,5,45,0.533,29,0.644,2,0,1.0,2,1,32,13,16,12,17,0.356,0.267,0.378,18.167,2,riffle_clumpy
0,24,15,5,44,0.545,29,0.659,0,5,0.0,3,0,31,13,14,14,16,0.318,0.318,0.364,18.136,3,riffle_clumpy
0,20,23,3,46,0.435,23,0.5,6,1,0.857,1,3,30,16,11,15,20,0.239,0.326,0.435,18.062,4,riffle_clumpy
0,22,24,2,48,0.458,24,0.5,4,0,1.0,1,3,28,20,15,13,20,0.312,0.271,0.417,18.095,5,riffle_clumpy
0,15,28,4,47,0.319,19,0.404,0,3,0.0,2,4,32,15,6,16,25,0.128,0.34,0.532,18.012,6,riffle_clumpy
0,20,26,1,47,0.426,21,0.447,1,3,0.25,1,4,29,18,9,18,20,0.191,0.383,0.426,18.054,7,riffle_clumpy
0,20,23,6,49,0.408,26,0.531,3,0,1.0,5,4,31,18,8,17,24,0.163,0.347,0.49,17.928,8,riffle_clumpy
0,18,25,3,46,0.391,21,0.457,2,3,0.4,3,0,29,17,10,16,20,0.217,0.348,0.435,17.925,9,riffle_clumpy
0,23,23,1,47,0.489,24,0.511,5,2,0.714,3,2,28,19,9,17,21,0.191,0.362,0.447,17.903,10,riffle_clumpy
0,19,25,5,49,0.388,24,0.49,0,4,0.0,1,1,30,19,13,16,20,0.265,0.327,0.408,17.943,11,riffle_clumpy
0,29,17,2,48,0.604,31,0.646,2,3,0.4,2,0,24,24,12,18,18,0.25,0.375,0.375,17.893,12,riffle_clumpy
0,19,18,7,44,0.432,26,0.591,2,0,1.0,2,3,30,14,10,19,15,0.227,0.432,0.341,17.919,13,riffle_clumpy
0,20,24,2,46,0.435,22,0.478,1,2,0.333,3,1,23,23,13,16,17,0.283,0.348,0.37,17.941,14,riffle_clumpy
0,20,22,5,47,0.426,25,0.532,1,1,0.5,1,2,27,20,10,21,16,0.213,0.447,0.34,17.958,15,riffle_clumpy
0,21,24,2,47,0.447,23,0.489,4,0,1.0,3,2,28,19,14,16,17,0.298,0.34,0.362,17.979,16,riffle_clumpy
0,20,21,5,46,0.435,25,0.543,3,2,0.6,0,1,26,20,15,14,17,0.326,0.304,0.37,18.03,17,riffle_clumpy
0,20,27,2,49,0.408,22,0.449,0,3,0.0,3,0,31,18,13,14,22,0.265,0.286,0.449,18.034,18,riffle_clumpy
0,25,22,4,51,0.49,29,0.569,4,1,0.8,3,2,30,21,17,14,20,0.333,0.275,0.392,18.009,19,riffle_clumpy
0,22,21,3,46,0.478,25,0.543,1,1,0.5,0,1,26,20,14,19,13,0.304,0.413,0.283,18.031,20,riffle_clumpy
0,20,23,5,48,0.417,25,0.521,2,4,0.333,2,1,31,17,12,15,21,0.25,0.312,0.438,18.013,21,riffle_clumpy
0,22,22,2,46,0.478,24,0.522,2,4,0.333,3,0,27,19,10,18,18,0.217,0.391,0.391,17.986,22,riffle_clumpy
0,16,29,3,48,0.333,19,0.396,2,3,0.4,5,1,32,16,7,16,25,0.146,0.333,0.521,17.937,23,riffle_clumpy
0,17,31,1,49,0.347,18,0.367,3,2,0.6,4,4,29,20,7,19,23,0.143,0.388,0.469,17.939,24,riffle_clumpy
0,19,26,0,45,0.422,19,0.422,5,4,0.556,1,4,29,16,14,10,21,0.311,0.222,0.467,17.95,25,riffle_clumpy
0,13,28,4,45,0.289,17,0.378,3,4,0.429,1,3,30,15,9,19,17,0.2,0.422,0.378,17.966,26,riffle_clumpy
0,22,20,5,47,0.468,27,0.574,4,0,1.0,5,1,27,20,12,19,16,0.255,0.404,0.34,17.953,27,riffle_clumpy
0,20,23,3,46,0.435,23,0.5,2,1,0.667,2,1,25,21,14,17,15,0.304,0.37,0.326,17.967,28,riffle_clumpy
0,18,23,5,46,0.391,23,0.5,5,3,0.625,1,3,30,16,9,18,19,0.196,0.391,0.413,17.987,29,riffle_clumpy
0,22,24,2,48,0.458,24,0.5,4,2,0.667,2,0,23,25,13,21,14,0.271,0.438,0.292,17.989,30,riffle_clumpy
0,24,15,7,46,0.522,31,0.674,5,2,0.714,3,2,27,19,14,15,17,0.304,0.326,0.37,17.99,31,riffle_clumpy
0,23,17,4,44,0.523,27,0.614,5,2,0.714,0,1,23,21,16,14,14,0.364,0.318,0.318,17.999,32,riffle_clumpy
0,24,20,3,47,0.511,27,0.574,5,2,0.714,4,2,24,23,18,13,16,0.383,0.277,0.34,17.994,33,riffle_clumpy
0,21,20,5,46,0.457,26,0.565,5,3,0.625,5,5,27,19,14,13,19,0.304,0.283,0.413,17.996,34,riffle_clumpy
0,15,32,4,51,0.294,19,0.373,0,3,0.0,1,5,33,18,10,14,27,0.196,0.275,0.529,18.016,35,riffle_clumpy
0,15,28,1,44,0.341,16,0.364,2,3,0.4,1,1,27,17,12,14,18,0.273,0.318,0.409,18.037,36,riffle_clumpy
0,24,23,3,50,0.48,27,0.54,1,1,0.5,1,4,24,26,17,16,17,0.34,0.32,0.34,18.023,37,riffle_clumpy
0,18,25,5,48,0.375,23,0.479,6,0,1.0,2,3,36,12,7,16,25,0.146,0.333,0.521,18.021,38,riffle_clumpy
0,24,19,2,45,0.533,26,0.578,5,2,0.714,1,0,28,17,17,17,11,0.378,0.378,0.244,18.017,39,riffle_clumpy
0,20,23,2,45,0.444,22,0.489,7,2,0.778,1,1,27,18,14,13,18,0.311,0.289,0.4,18.019,40,riffle_clumpy
0,25,19,3,47,0.532,28,0.596,5,2,0.714,4,2,26,21,18,14,15,0.383,0.298,0.319,18.029,41,riffle_clumpy
0,19,26,5,50,0.38,24,0.48,4,2,0.667,3,1,29,21,11,19,20,0.22,0.38,0.4,18.025,42,riffle_clumpy
0,17,23,5,45,0.378,22,0.489,4,2,0.667,1,2,29,16,12,13,20,0.267,0.289,0.444,18.029,43,riffle_clumpy
0,15,27,4,46,0.326,19,0.413,4,2,0.667,2,2,28,18,9,18,19,0.196,0.391,0.413,18.024,44,riffle_clumpy
0,18,30,1,49,0.367,19,0.388,3,0,1.0,4,3,31,18,9,17,23,0.184,0.347,0.469,18.021,45,riffle_clumpy
0,20,25,1,46,0.435,21,0.457,4,0,1.0,3,2,31,15,12,13,21,0.261,0.283,0.457,18.032,46,riffle_clumpy
0,25,19,2,46,0.543,27,0.587,2,2,0.5,2,2,28,18,20,12,14,0.435,0.261,0.304,18.034,47,riffle_clumpy
0,18,24,3,45,0.4,21,0.467,3,3,0.5,2,1,26,19,15,17,13,0.333,0.378,0.289,18.039,48,riffle_clumpy
0,15,29,4,48,0.312,19,0.396,1,3,0.25,3,1,33,15,8,14,26,0.167,0.292,0.542,18.053,49,riffle_clumpy
0,25,20,3,48,0.521,28,0.583,6,2,0.75,2,3,28,20,16,14,18,0.333,0.292,0.375,18.057,50,riffle_clumpy
0,22,25,1,48,0.458,23,0.479,2,3,0.4,4,2,34,14,13,17,18,0.271,0.354,0.375,18.053,51,riffle_clumpy
0,21,21,5,47,0.447,26,0.553,4,1,0.8,0,2,27,20,14,18,15,0.298,0.383,0.319,18.048,52,riffle_clumpy
0,17,26,3,46,0.37,20,0.435,6,4,0.6,2,3,30,16,9,18,19,0.196,0.391,0.413,18.038,53,riffle_clumpy
0,15,26,4,45,0.333,19,0.422,2,1,0.667,2,2,29,16,9,17,19,0.2,0.378,0.422,18.046,54,riffle_clumpy
0,19,21,6,46,0.413,25,0.543,3,3,0.5,2,2,30,16,11,19,16,0.239,0.413,0.348,18.055,55,riffle_clumpy
0,22,18,8,48,0.458,30,0.625,4,0,1.0,0,2,32,16,15,12,21,0.312,0.25,0.438,18.061,56,riffle_clumpy
0,21,23,2,46,0.457,23,0.5,4,2,0.667,0,3,24,22,15,18,13,0.326,0.391,0.283,18.072,57,riffle_clumpy
0,16,26,3,45,0.356,19,0.422,2,1,0.667,0,2,26,19,11,18,16,0.244,0.4,0.356,18.072,58,riffle_clumpy
0,22,26,1,49,0.449,23,0.469,4,1,0.8,3,1,28,21,14,14,21,0.286,0.286,0.429,18.067,59,riffle_clumpy
0,22,22,5,49,0.449,27,0.551,3,1,0.75,1,3,25,24,14,16,19,0.286,0.327,0.388,18.076,60,riffle_clumpy
0,24,18,4,46,0.522,28,0.609,4,3,0.571,2,1,26,20,12,16,18,0.261,0.348,0.391,18.071,61,riffle_clumpy
0,19,26,4,49,0.388,23,0.469,2,3,0.4,3,2,26,23,14,15,20,0.286,0.306,0.408,18.074,62,riffle_clumpy
0,21,18,7,46,0.457,28,0.609,2,3,0.4,3,2,28,18,14,16,16,0.304,0.348,0.348,18.071,63,riffle_clumpy
0,15,33,2,50,0.3,17,0.34,5,1,0.833,1,3,24,26,11,19,20,0.22,0.38,0.4,18.078,64,riffle_clumpy
0,18,25,4,47,0.383,22,0.468,2,2,0.5,4,2,28,19,7,21,19,0.149,0.447,0.404,18.064,65,riffle_clumpy
0,19,23,3,45,0.422,22,0.489,4,3,0.571,2,0,24,21,12,20,13,0.267,0.444,0.289,18.068,66,riffle_clumpy
0,20,26,1,47,0.426,21,0.447,3,3,0.5,3,2,32,15,11,13,23,0.234,0.277,0.489,18.062,67,riffle_clumpy
0,27,18,2,47,0.574,29,0.617,3,1,0.75,3,4,28,19,16,17,14,0.34,0.362,0.298,18.059,68,riffle_clumpy
0,22,22,3,47,0.468,25,0.532,2,0,1.0,5,3,31,16,12,14,21,0.255,0.298,0.447,18.05,69,riffle_clumpy
0,21,20,5,46,0.457,26,0.565,7,2,0.778,4,3,29,17,10,15,21,0.217,0.326,0.457,18.048,70,riffle_clumpy
0,18,25,3,46,0.391,21,0.457,1,1,0.5,2,5,32,14,10,15,21,0.217,0.326,0.457,18.043,71,riffle_clumpy
0,24,19,3,46,0.522,27,0.587,2,2,0.5,4,0,26,20,14,17,15,0.304,0.37,0.326,18.046,72,riffle_clumpy
0,15,34,1,50,0.3,16,0.32,2,5,0.286,0,1,29,21,10,22,18,0.2,0.44,0.36,18.051,73,riffle_clumpy
0,15,28,7,50,0.3,22,0.44,3,4,0.429,2,1,31,19,10,24,16,0.2,0.48,0.32,18.057,74,riffle_clumpy
0,22,24,1,47,0.468,23,0.489,5,1,0.833,2,1,30,17,15,13,19,0.319,0.277,0.404,18.058,75,riffle_clumpy
0,27,19,2,48,0.562,29,0.604,4,2,0.667,2,2,29,19,20,18,10,0.417,0.375,0.208,18.061,76,riffle_clumpy
0,22,23,1,46,0.478,23,0.5,1,2,0.333,3,2,33,13,14,11,21,0.304,0.239,0.457,18.06,77,riffle_clumpy
0,20,22,3,45,0.444,23,0.511,5,4,0.556,3,1,27,18,11,14,20,0.244,0.311,0.444,18.065,78,riffle_clumpy
0,23,23,4,50,0.46,27,0.54,5,3,0.625,2,0,29,21,12,20,18,0.24,0.4,0.36,18.064,79,riffle_clumpy
0,12,34,2,48,0.25,14,0.292,2,2,0.5,1,5,30,18,9,16,23,0.188,0.333,0.479,18.062,80,riffle_clumpy
0,18,24,5,47,0.383,23,0.489,1,4,0.2,2,3,29,18,12,15,20,0.255,0.319,0.426,18.062,81,riffle_clumpy
0,19,28,2,49,0.388,21,0.429,0,5,0.0,4,0,25,24,11,16,22,0.224,0.327,0.449,18.063,82,riffle_clumpy
0,24,23,1,48,0.5,25,0.521,7,2,0.778,0,0,28,20,18,15,15,0.375,0.312,0.312,18.064,83,riffle_clumpy
0,26,20,1,47,0.553,27,0.574,4,1,0.8,2,3,28,19,13,21,13,0.277,0.447,0.277,18.074,84,riffle_clumpy
0,18,28,1,47,0.383,19,0.404,4,6,0.4,1,4,29,18,14,19,14,0.298,0.404,0.298,18.073,85,riffle_clumpy
0,18,27,1,46,0.391,19,0.413,5,1,0.833,0,1,33,13,13,16,17,0.283,0.348,0.37,18.075,86,riffle_clumpy
0,23,20,3,46,0.5,26,0.565,4,2,0.667,3,0,23,23,13,19,14,0.283,0.413,0.304,18.076,87,riffle_clumpy
0,23,24,1,48,0.479,24,0.5,1,1,0.5,6,3,30,18,12,14,22,0.25,0.292,0.458,18.068,88,riffle_clumpy
0,16,25,4,45,0.356,20,0.444,3,4,0.429,0,0,28,17,11,18,16,0.244,0.4,0.356,18.075,89,riffle_clumpy
0,22,25,2,49,0.449,24,0.49,4,1,0.8,1,1,29,20,8,21,20,0.163,0.429,0.408,18.079,90,riffle_clumpy
0,19,21,6,46,0.413,25,0.543,6,1,0.857,2,2,26,20,12,19,15,0.261,0.413,0.326,18.085,91,riffle_clumpy
0,15,31,2,48,0.312,17,0.354,1,6,0.143,3,2,27,21,4,22,22,0.083,0.458,0.458,18.075,92,riffle_clumpy
0,18,28,0,46,0.391,18,0.391,4,3,0.571,2,1,34,12,12,12,22,0.261,0.261,0.478,18.07,93,riffle_clumpy
0,21,21,3,45,0.467,24,0.533,2,3,0.4,1,2,31,14,14,12,19,0.311,0.267,0.422,18.075,94,riffle_clumpy
0,22,21,3,46,0.478,25,0.543,2,2,0.5,2,0,30,16,15,12,19,0.326,0.261,0.413,18.074,95,riffle_clumpy
0,16,28,2,46,0.348,18,0.391,1,3,0.25,0,5,28,18,12,18,16,0.261,0.391,0.348,18.08,96,riffle_clumpy
0,18,25,4,47,0.383,22,0.468,1,2,0.333,1,2,27,20,6,21,20,0.128,0.447,0.426,18.471,1,riffle_clumpy
0,18,22,6,46,0.391,24,0.522,2,3,0.4,1,5,30,16,13,10,23,0.283,0.217,0.5,18.339,2,riffle_clumpy
0,21,23,3,47,0.447,24,0.511,4,1,0.8,4,2,33,14,14,15,18,0.298,0.319,0.383,18.182,3,riffle_clumpy
0,21,21,4,46,0.457,25,0.543,3,2,0.6,2,1,27,19,12,16,18,0.261,0.348,0.391,18.179,4,riffle_clumpy
0,25,24,3,52,0.481,28,0.538,5,6,0.455,3,1,28,24,14,18,20,0.269,0.346,0.385,18.167,5,riffle_clumpy
0,17,24,6,47,0.362,23,0.489,2,1,0.667,1,3,27,20,10,19,18,0.213,0.404,0.383,18.109,6,riffle_clumpy
0,20,25,6,51,0.392,26,0.51,2,0,1.0,3,2,28,23,12,14,25,0.235,0.275,0.49,18.051,7,riffle_clumpy
0,21,23,4,48,0.438,25,0.521,3,2,0.6,3,4,31,17,8,18,22,0.167,0.375,0.458,18.078,8,riffle_clumpy
0,20,23,4,47,0.426,24,0.511,2,1,0.667,3,3,31,16,9,16,22,0.191,0.34,0.468,18.043,9,riffle_clumpy
0,22,19,4,45,0.489,26,0.578,5,3,0.625,1,1,25,20,14,18,13,0.311,0.4,0.289,18.02,10,riffle_clumpy
0,22,21,3,46,0.478,25,0.543,5,0,1.0,2,2,22,24,19,14,13,0.413,0.304,0.283,18.028,11,riffle_clumpy
0,21,25,0,46,0.457,21,0.457,4,4,0.5,2,6,29,17,9,16,21,0.196,0.348,0.457,18.042,12,riffle_clumpy
0,13,34,2,49,0.265,15,0.306,0,3,0.0,2,3,35,14,7,17,25,0.143,0.347,0.51,18.056,13,riffle_clumpy
0,17,27,3,47,0.362,20,0.426,2,2,0.5,0,1,27,20,9,18,20,0.191,0.383,0.426,18.066,14,riffle_clumpy
0,19,25,2,46,0.413,21,0.457,5,1,0.833,1,3,33,13,11,14,21,0.239,0.304,0.457,18.092,15,riffle_clumpy
0,19,21,5,45,0.422,24,0.533,2,2,0.5,3,2,25,20,12,17,16,0.267,0.378,0.356,18.093,16,riffle_clumpy
0,20,27,2,49,0.408,22,0.449,1,1,0.5,3,4,30,19,13,15,21,0.265,0.306,0.429,18.078,17,riffle_clumpy
0,19,22,4,45,0.422,23,0.511,4,2,0.667,2,0,23,22,15,11,19,0.333,0.244,0.422,18.069,18,riffle_clumpy
0,20,24,3,47,0.426,23,0.489,7,3,0.7,2,4,30,17,14,12,21,0.298,0.255,0.447,18.065,19,riffle_clumpy
0,22,24,4,50,0.44,26,0.52,3,2,0.6,4,3,32,18,10,14,26,0.2,0.28,0.52,18.057,20,riffle_clumpy
0,18,24,4,46,0.391,22,0.478,3,2,0.6,5,4,22,24,11,15,20,0.239,0.326,0.435,18.017,21,riffle_clumpy
0,16,30,3,49,0.327,19,0.388,1,2,0.333,6,3,34,15,5,20,24,0.102,0.408,0.49,18.005,22,riffle_clumpy
0,20,24,3,47,0.426,23,0.489,3,2,0.6,2,2,32,15,10,15,22,0.213,0.319,0.468,17.986,23,riffle_clumpy
0,23,22,2,47,0.489,25,0.532,4,2,0.667,4,2,26,21,10,20,17,0.213,0.426,0.362,17.974,24,riffle_clumpy
0,25,18,3,46,0.543,28,0.609,7,2,0.778,4,1,22,24,13,12,21,0.283,0.261,0.457,17.976,25,riffle_clumpy
0,20,24,3,47,0.426,23,0.489,0,4,0.0,4,4,26,21,10,21,16,0.213,0.447,0.34,17.961,26,riffle_clumpy
0,21,20,4,45,0.467,25,0.556,3,1,0.75,2,2,26,19,12,18,15,0.267,0.4,0.333,17.991,27,riffle_clumpy
0,22,22,2,46,0.478,24,0.522,4,1,0.8,0,1,27,19,16,14,16,0.348,0.304,0.348,17.993,28,riffle_clumpy
0,22,22,2,46,0.478,24,0.522,2,3,0.4,2,1,27,19,15,12,19,0.326,0.261,0.413,18.001,29,riffle_clumpy
0,14,23,11,48,0.292,25,0.521,1,0,1.0,3,2,24,24,8,25,15,0.167,0.521,0.312,17.999,30,riffle_clumpy
0,21,21,2,44,0.477,23,0.523,3,0,1.0,3,2,27,17,12,19,13,0.273,0.432,0.295,18.008,31,riffle_clumpy
0,25,19,2,46,0.543,27,0.587,4,1,0.8,3,0,28,18,17,14,15,0.37,0.304,0.326,18.007,32,riffle_clumpy
0,20,24,3,47,0.426,23,0.489,2,4,0.333,1,4,36,11,10,18,19,0.213,0.383,0.404,18.014,33,riffle_clumpy
0,17,29,2,48,0.354,19,0.396,2,3,0.4,1,8,32,16,11,17,20,0.229,0.354,0.417,18.017,34,riffle_clumpy
0,17,29,5,51,0.333,22,0.431,2,3,0.4,3,5,36,15,12,13,26,0.235,0.255,0.51,18.005,35,riffle_clumpy
0,21,21,3,45,0.467,24,0.533,2,6,0.25,0,1,28,17,17,15,13,0.378,0.333,0.289,18.02,36,riffle_clumpy
0,18,23,4,45,0.4,22,0.489,4,1,0.8,2,1,28,17,11,18,16,0.244,0.4,0.356,18.021,37,riffle_clumpy
0,21,26,3,50,0.42,24,0.48,2,4,0.333,6,2,30,20,7,17,26,0.14,0.34,0.52,18.011,38,riffle_clumpy
0,21,23,2,46,0.457,23,0.5,1,4,0.2,1,3,32,14,15,13,18,0.326,0.283,0.391,18.025,39,riffle_clumpy
0,18,24,3,45,0.4,21,0.467,5,4,0.556,2,0,30,15,12,13,20,0.267,0.289,0.444,18.038,40,riffle_clumpy
0,20,21,4,45,0.444,24,0.533,3,4,0.429,2,3,27,18,13,12,20,0.289,0.267,0.444,18.029,41,riffle_clumpy
0,17,29,1,47,0.362,18,0.383,2,2,0.5,2,4,31,16,11,16,20,0.234,0.34,0.426,18.044,42,riffle_clumpy
0,24,20,1,45,0.533,25,0.556,2,1,0.667,4,0,31,14,11,12,22,0.244,0.267,0.489,18.031,43,riffle_clumpy
0,18,25,4,47,0.383,22,0.468,4,1,0.8,3,3,28,19,10,19,18,0.213,0.404,0.383,18.032,44,riffle_clumpy
0,21,21,5,47,0.447,26,0.553,3,4,0.429,1,5,30,17,12,12,23,0.255,0.255,0.489,18.022,45,riffle_clumpy
0,17,26,4,47,0.362,21,0.447,3,3,0.5,3,2,28,19,8,17,22,0.17,0.362,0.468,18.018,46,riffle_clumpy
0,22,23,2,47,0.468,24,0.511,6,2,0.75,1,2,25,22,14,18,15,0.298,0.383,0.319,18.021,47,riffle_clumpy
0,17,29,5,51,0.333,22,0.431,3,0,1.0,3,1,27,24,10,25,16,0.196,0.49,0.314,18.027,48,riffle_clumpy
0,18,23,3,44,0.409,21,0.477,2,0,1.0,1,0,24,20,10,17,17,0.227,0.386,0.386,18.027,49,riffle_clumpy
0,21,23,6,50,0.42,27,0.54,0,5,0.0,0,0,24,26,15,19,16,0.3,0.38,0.32,18.039,50,riffle_clumpy
0,26,18,4,48,0.542,30,0.625,3,0,1.0,2,4,30,18,19,13,16,0.396,0.271,0.333,18.048,51,riffle_clumpy
0,22,22,3,47,0.468,25,0.532,2,4,0.333,3,3,24,23,16,16,15,0.34,0.34,0.319,18.057,52,riffle_clumpy
0,22,21,3,46,0.478,25,0.543,3,4,0.429,5,3,24,22,16,15,15,0.348,0.326,0.326,18.056,53,riffle_clumpy
0,19,28,1,48,0.396,20,0.417,4,5,0.444,2,2,29,19,8,21,19,0.167,0.438,0.396,18.05,54,riffle_clumpy
0,24,24,1,49,0.49,25,0.51,4,3,0.571,5,2,33,16,15,13,21,0.306,0.265,0.429,18.044,55,riffle_clumpy
0,18,27,3,48,0.375,21,0.438,7,3,0.7,2,2,32,16,12,12,24,0.25,0.25,0.5,18.037,56,riffle_clumpy
0,20,26,2,48,0.417,22,0.458,3,4,0.429,3,2,32,16,14,15,19,0.292,0.312,0.396,18.044,57,riffle_clumpy
0,29,18,0,47,0.617,29,0.617,5,1,0.833,6,2,26,21,18,11,18,0.383,0.234,0.383,18.03,58,riffle_clumpy
0,18,27,2,47,0.383,20,0.426,2,1,0.667,0,1,29,18,13,15,19,0.277,0.319,0.404,18.037,59,riffle_clumpy
0,15,28,3,46,0.326,18,0.391,3,0,1.0,2,1,26,20,7,21,18,0.152,0.457,0.391,18.032,60,riffle_clumpy
0,20,26,1,47,0.426,21,0.447,1,1,0.5,3,3,31,16,13,15,19,0.277,0.319,0.404,18.025,61,riffle_clumpy
0,20,23,2,45,0.444,22,0.489,3,1,0.75,3,1,33,12,12,13,20,0.267,0.289,0.444,18.026,62,riffle_clumpy
0,19,29,1,49,0.388,20,0.408,8,3,0.727,3,3,30,19,9,18,22,0.184,0.367,0.449,18.031,63,riffle_clumpy
0,25,14,5,44,0.568,30,0.682,4,2,0.667,2,1,27,17,16,13,15,0.364,0.295,0.341,18.03,64,riffle_clumpy
0,15,30,3,48,0.312,18,0.375,1,2,0.333,3,3,29,19,6,17,25,0.125,0.354,0.521,18.037,65,riffle_clumpy
0,26,22,0,48,0.542,26,0.542,4,1,0.8,2,2,30,18,17,19,12,0.354,0.396,0.25,18.028,66,riffle_clumpy
0,18,27,3,48,0.375,21,0.438,3,1,0.75,3,1,36,12,10,15,23,0.208,0.312,0.479,18.02,67,riffle_clumpy
0,21,26,3,50,0.42,24,0.48,7,8,0.467,2,4,26,24,13,22,15,0.26,0.44,0.3,18.024,68,riffle_clumpy
0,27,17,2,46,0.587,29,0.63,6,0,1.0,2,3,24,22,15,18,13,0.326,0.391,0.283,18.026,69,riffle_clumpy
0,21,22,5,48,0.438,26,0.542,4,1,0.8,3,2,30,18,15,12,21,0.312,0.25,0.438,18.026,70,riffle_clumpy
0,24,25,1,50,0.48,25,0.5,3,4,0.429,3,2,30,20,15,17,18,0.3,0.34,0.36,18.022,71,riffle_clumpy
0,21,28,1,50,0.42,22,0.44,2,0,1.0,1,5,27,23,17,12,21,0.34,0.24,0.42,18.019,72,riffle_clumpy
0,22,25,4,51,0.431,26,0.51,3,0,1.0,1,2,26,25,12,17,22,0.235,0.333,0.431,18.02,73,riffle_clumpy
0,25,18,4,47,0.532,29,0.617,1,1,0.5,3,1,29,18,13,16,18,0.277,0.34,0.383,18.019,74,riffle_clumpy
0,20,23,7,50,0.4,27,0.54,3,3,0.5,3,3,30,20,11,16,23,0.22,0.32,0.46,18.013,75,riffle_clumpy
0,22,23,2,47,0.468,24,0.511,2,1,0.667,4,2,27,20,9,16,22,0.191,0.34,0.468,18.005,76,riffle_clumpy
0,26,18,3,47,0.553,29,0.617,2,1,0.667,5,2,25,22,15,11,21,0.319,0.234,0.447,17.993,77,riffle_clumpy
0,26,18,3,47,0.553,29,0.617,3,1,0.75,3,1,34,13,17,17,13,0.362,0.362,0.277,17.986,78,riffle_clumpy
0,26,18,1,45,0.578,27,0.6,2,2,0.5,2,2,25,20,13,14,18,0.289,0.311,0.4,17.986,79,riffle_clumpy
0,21,24,3,48,0.438,24,0.5,1,3,0.25,1,1,26,22,15,18,15,0.312,0.375,0.312,17.992,80,riffle_clumpy
0,20,24,2,46,0.435,22,0.478,3,1,0.75,4,1,29,17,10,16,20,0.217,0.348,0.435,17.996,81,riffle_clumpy
0,24,21,2,47,0.511,26,0.553,1,2,0.333,5,0,27,20,13,13,21,0.277,0.277,0.447,17.984,82,riffle_clumpy
0,30,19,4,53,0.566,34,0.642,6,3,0.667,7,2,35,18,14,18,21,0.264,0.34,0.396,17.983,83,riffle_clumpy
0,15,28,4,47,0.319,19,0.404,2,0,1.0,1,4,32,15,10,18,19,0.213,0.383,0.404,17.986,84,riffle_clumpy
0,25,22,2,49,0.51,27,0.551,2,4,0.333,3,1,32,17,20,13,16,0.408,0.265,0.327,17.982,85,riffle_clumpy
0,21,22,6,49,0.429,27,0.551,7,2,0.778,2,2,27,22,16,13,20,0.327,0.265,0.408,17.99,86,riffle_clumpy
0,22,18,6,46,0.478,28,0.609,4,3,0.571,6,2,27,19,10,12,24,0.217,0.261,0.522,17.978,87,riffle_clumpy
0,16,22,6,44,0.364,22,0.5,3,2,0.6,1,1,25,19,11,18,15,0.25,0.409,0.341,17.981,88,riffle_clumpy
0,17,26,4,47,0.362,21,0.447,4,5,0.444,2,2,26,21,10,15,22,0.213,0.319,0.468,17.979,89,riffle_clumpy
0,23,24,2,49,0.469,25,0.51,0,3,0.0,3,3,27,22,14,14,21,0.286,0.286,0.429,17.973,90,riffle_clumpy
0,17,25,4,46,0.37,21,0.457,2,4,0.333,4,4,30,16,10,15,21,0.217,0.326,0.457,17.973,91,riffle_clumpy
0,12,28,6,46,0.261,18,0.391,5,1,0.833,0,4,31,15,9,14,23,0.196,0.304,0.5,17.973,92,riffle_clumpy
0,19,24,5,48,0.396,24,0.5,2,5,0.286,1,4,27,21,11,20,17,0.229,0.417,0.354,17.977,93,riffle_clumpy
0,22,20,4,46,0.478,26,0.565,2,1,0.667,1,2,25,21,13,17,16,0.283,0.37,0.348,17.972,94,riffle_clumpy
0,19,22,6,47,0.404,25,0.532,2,1,0.667,3,3,33,14,11,12,24,0.234,0.255,0.511,17.969,95,riffle_clumpy
0,18,23,7,48,0.375,25,0.521,2,3,0.4,1,4,27,21,14,16,18,0.292,0.333,0.375,17.973,96,riffle_clumpy
0,21,26,2,49,0.429,23,0.469,1,1,0.5,0,1,24,25,16,18,15,0.327,0.367,0.306,18.111,1,riffle_clumpy
0,18,25,3,46,0.391,21,0.457,3,1,0.75,2,1,31,15,9,19,18,0.196,0.413,0.391,18.21,2,riffle_clumpy
0,27,14,3,44,0.614,30,0.682,5,1,0.833,0,1,25,19,15,17,12,0.341,0.386,0.273,18.276,3,riffle_clumpy
0,20,18,8,46,0.435,28,0.609,3,2,0.6,1,2,29,17,12,15,19,0.261,0.326,0.413,18.212,4,riffle_clumpy
0,21,22,3,46,0.457,24,0.522,5,3,0.625,1,2,26,20,13,22,11,0.283,0.478,0.239,18.317,5,riffle_clumpy
0,18,26,5,49,0.367,23,0.469,3,3,0.5,3,2,31,18,11,17,21,0.224,0.347,0.429,18.223,6,riffle_clumpy
0,15,24,6,45,0.333,21,0.467,2,1,0.667,3,2,30,15,10,14,21,0.222,0.311,0.467,18.256,7,riffle_clumpy
0,25,19,3,47,0.532,28,0.596,3,2,0.6,3,5,32,15,13,9,25,0.277,0.191,0.532,18.205,8,riffle_clumpy
0,27,15,2,44,0.614,29,0.659,4,3,0.571,3,3,27,17,21,13,10,0.477,0.295,0.227,18.224,9,riffle_clumpy
0,19,25,3,47,0.404,22,0.468,1,2,0.333,3,3,27,20,9,20,18,0.191,0.426,0.383,18.214,10,riffle_clumpy
0,13,29,5,47,0.277,18,0.383,1,1,0.5,2,1,29,18,6,23,18,0.128,0.489,0.383,18.219,11,riffle_clumpy
0,17,31,1,49,0.347,18,0.367,1,3,0.25,0,2,30,19,10,18,21,0.204,0.367,0.429,18.221,12,riffle_clumpy
0,19,26,1,46,0.413,20,0.435,2,1,0.667,2,2,32,14,9,20,17,0.196,0.435,0.37,18.213,13,riffle_clumpy
0,18,28,2,48,0.375,20,0.417,2,1,0.667,1,0,32,16,11,20,17,0.229,0.417,0.354,18.208,14,riffle_clumpy
0,15,25,5,45,0.333,20,0.444,2,4,0.333,2,2,29,16,7,14,24,0.156,0.311,0.533,18.177,15,riffle_clumpy
0,22,21,3,46,0.478,25,0.543,4,0,1.0,2,0,28,18,14,15,17,0.304,0.326,0.37,18.186,16,riffle_clumpy
0,20,25,1,46,0.435,21,0.457,3,1,0.75,3,3,28,18,15,11,20,0.326,0.239,0.435,18.155,17,riffle_clumpy
0,17,28,2,47,0.362,19,0.404,1,3,0.25,0,0,30,17,12,17,18,0.255,0.362,0.383,18.178,18,riffle_clumpy
0,18,23,4,45,0.4,22,0.489,1,3,0.25,2,2,27,18,13,16,16,0.289,0.356,0.356,18.174,19,riffle_clumpy
0,22,28,0,50,0.44,22,0.44,4,3,0.571,0,3,33,17,15,16,19,0.3,0.32,0.38,18.182,20,riffle_clumpy
0,17,27,2,46,0.37,19,0.413,3,2,0.6,2,1,29,17,8,21,17,0.174,0.457,0.37,18.187,21,riffle_clumpy
0,19,26,2,47,0.404,21,0.447,5,3,0.625,1,3,29,18,12,16,19,0.255,0.34,0.404,18.184,22,riffle_clumpy
0,18,30,2,50,0.36,20,0.4,2,5,0.286,3,4,35,15,11,17,22,0.22,0.34,0.44,18.179,23,riffle_clumpy
0,23,21,2,46,0.5,25,0.543,4,1,0.8,3,1,24,22,10,17,19,0.217,0.37,0.413,18.166,24,riffle_clumpy
0,14,29,1,44,0.318,15,0.341,0,3,0.0,0,0,28,16,10,19,15,0.227,0.432,0.341,18.184,25,riffle_clumpy
0,23,16,8,47,0.489,31,0.66,4,0,1.0,2,0,29,18,14,14,19,0.298,0.298,0.404,18.176,26,riffle_clumpy
0,16,28,2,46,0.348,18,0.391,3,2,0.6,1,1,34,12,10,15,21,0.217,0.326,0.457,18.186,27,riffle_clumpy
0,19,27,2,48,0.396,21,0.438,3,1,0.75,1,3,33,15,13,16,19,0.271,0.333,0.396,18.195,28,riffle_clumpy
0,18,29,4,51,0.353,22,0.431,0,3,0.0,2,3,32,19,10,20,21,0.196,0.392,0.412,18.203,29,riffle_clumpy
0,22,23,2,47,0.468,24,0.511,2,0,1.0,4,0,29,18,9,15,23,0.191,0.319,0.489,18.159,30,riffle_clumpy
0,30,15,1,46,0.652,31,0.674,10,4,0.714,3,4,22,24,20,12,14,0.435,0.261,0.304,18.148,31,riffle_clumpy
0,18,25,3,46,0.391,21,0.457,5,2,0.714,4,3,26,20,9,17,20,0.196,0.37,0.435,18.136,32,riffle_clumpy
0,21,22,4,47,0.447,25,0.532,6,3,0.667,5,3,25,22,13,15,19,0.277,0.319,0.404,18.139,33,riffle_clumpy
0,15,29,5,49,0.306,20,0.408,2,2,0.5,2,4,23,26,10,21,18,0.204,0.429,0.367,18.153,34,riffle_clumpy
0,27,18,2,47,0.574,29,0.617,5,0,1.0,5,3,31,16,15,11,21,0.319,0.234,0.447,18.14,35,riffle_clumpy
0,19,21,5,45,0.422,24,0.533,5,2,0.714,1,3,31,14,13,13,19,0.289,0.289,0.422,18.154,36,riffle_clumpy
0,19,21,5,45,0.422,24,0.533,5,1,0.833,1,3,31,14,15,11,19,0.333,0.244,0.422,18.14,37,riffle_clumpy
0,19,26,2,47,0.404,21,0.447,5,4,0.556,1,4,25,22,13,14,20,0.277,0.298,0.426,18.136,38,riffle_clumpy
0,19,21,7,47,0.404,26,0.553,4,3,0.571,0,2,24,23,10,21,16,0.213,0.447,0.34,18.157,39,riffle_clumpy
0,21,25,2,48,0.438,23,0.479,1,3,0.25,2,1,26,22,9,20,19,0.188,0.417,0.396,18.149,40,riffle_clumpy
0,24,20,0,44,0.545,24,0.545,1,6,0.143,1,1,20,24,18,17,9,0.409,0.386,0.205,18.149,41,riffle_clumpy
0,25,18,2,45,0.556,27,0.6,2,3,0.4,3,1,20,25,13,17,15,0.289,0.378,0.333,18.136,42,riffle_clumpy
0,19,23,6,48,0.396,25,0.521,3,5,0.375,4,4,25,23,13,17,18,0.271,0.354,0.375,18.132,43,riffle_clumpy
0,21,24,3,48,0.438,24,0.5,1,1,0.5,1,3,25,23,9,21,18,0.188,0.438,0.375,18.136,44,riffle_clumpy
0,21,22,3,46,0.457,24,0.522,4,2,0.667,1,4,31,15,13,14,19,0.283,0.304,0.413,18.127,45,riffle_clumpy
0,15,29,3,47,0.319,18,0.383,2,4,0.333,3,3,30,17,11,13,23,0.234,0.277,0.489,18.131,46,riffle_clumpy
0,26,18,3,47,0.553,29,0.617,3,2,0.6,3,4,31,16,11,14,22,0.234,0.298,0.468,18.135,47,riffle_clumpy
0,21,25,5,51,0.412,26,0.51,7,1,0.875,1,2,30,21,10,13,28,0.196,0.255,0.549,18.132,48,riffle_clumpy
0,18,26,2,46,0.391,20,0.435,1,3,0.25,1,1,26,20,13,16,17,0.283,0.348,0.37,18.137,49,riffle_clumpy
0,19,24,3,46,0.413,22,0.478,0,5,0.0,0,1,27,19,11,22,13,0.239,0.478,0.283,18.137,50,riffle_clumpy
0,21,21,4,46,0.457,25,0.543,4,1,0.8,6,3,27,19,11,14,21,0.239,0.304,0.457,18.122,51,riffle_clumpy
0,12,30,4,46,0.261,16,0.348,1,2,0.333,2,3,28,18,4,27,15,0.087,0.587,0.326,18.13,52,riffle_clumpy
0,22,18,6,46,0.478,28,0.609,4,4,0.5,1,4,27,19,15,16,15,0.326,0.348,0.326,18.125,53,riffle_clumpy
0,24,18,3,45,0.533,27,0.6,3,4,0.429,3,2,28,17,15,15,15,0.333,0.333,0.333,18.126,54,riffle_clumpy
0,27,20,3,50,0.54,30,0.6,3,0,1.0,2,2,30,20,17,18,15,0.34,0.36,0.3,18.122,55,riffle_clumpy
0,20,19,8,47,0.426,28,0.596,5,3,0.625,2,4,27,20,11,12,24,0.234,0.255,0.511,18.111,56,riffle_clumpy
0,19,24,3,46,0.413,22,0.478,2,3,0.4,1,3,26,20,13,15,18,0.283,0.326,0.391,18.113,57,riffle_clumpy
0,23,23,1,47,0.489,24,0.511,2,2,0.5,1,3,27,20,16,11,20,0.34,0.234,0.426,18.11,58,riffle_clumpy
0,23,18,6,47,0.489,29,0.617,0,2,0.0,1,1,24,23,17,14,16,0.362,0.298,0.34,18.114,59,riffle_clumpy
0,22,24,1,47,0.468,23,0.489,1,3,0.25,1,2,34,13,14,17,16,0.298,0.362,0.34,18.12,60,riffle_clumpy
0,21,22,4,47,0.447,25,0.532,3,2,0.6,1,1,26,21,12,18,17,0.255,0.383,0.362,18.117,61,riffle_clumpy
0,15,27,7,49,0.306,22,0.449,1,4,0.2,3,5,31,18,7,21,21,0.143,0.429,0.429,18.116,62,riffle_clumpy
0,23,22,3,48,0.479,26,0.542,4,2,0.667,2,3,24,24,19,14,15,0.396,0.292,0.312,18.12,63,riffle_clumpy
0,23,22,4,49,0.469,27,0.551,2,2,0.5,3,3,32,17,15,16,18,0.306,0.327,0.367,18.129,64,riffle_clumpy
0,16,24,5,45,0.356,21,0.467,2,3,0.4,2,1,30,15,11,19,15,0.244,0.422,0.333,18.127,65,riffle_clumpy
0,20,24,3,47,0.426,23,0.489,3,4,0.429,0,4,31,16,12,15,20,0.255,0.319,0.426,18.124,66,riffle_clumpy
0,24,20,5,49,0.49,29,0.592,4,2,0.667,4,0,29,20,14,17,18,0.286,0.347,0.367,18.121,67,riffle_clumpy
0,19,26,1,46,0.413,20,0.435,2,3,0.4,1,4,29,17,12,13,21,0.261,0.283,0.457,18.123,68,riffle_clumpy
0,16,27,2,45,0.356,18,0.4,2,1,0.667,0,1,24,21,10,20,15,0.222,0.444,0.333,18.126,69,riffle_clumpy
0,25,20,1,46,0.543,26,0.565,6,1,0.857,0,1,32,14,14,14,18,0.304,0.304,0.391,18.129,70,riffle_clumpy
0,20,26,4,50,0.4,24,0.48,4,2,0.667,5,0,29,21,8,19,23,0.16,0.38,0.46,18.129,71,riffle_clumpy
0,17,28,3,48,0.354,20,0.417,4,1,0.8,1,3,33,15,12,16,20,0.25,0.333,0.417,18.129,72,riffle_clumpy
0,22,22,4,48,0.458,26,0.542,5,1,0.833,3,1,32,16,12,13,23,0.25,0.271,0.479,18.129,73,riffle_clumpy
0,23,22,2,47,0.489,25,0.532,4,0,1.0,1,3,35,12,13,13,21,0.277,0.277,0.447,18.136,74,riffle_clumpy
0,19,24,3,46,0.413,22,0.478,5,1,0.833,2,2,26,20,12,13,21,0.261,0.283,0.457,18.14,75,riffle_clumpy
0,26,18,3,47,0.553,29,0.617,6,2,0.75,3,0,30,17,13,15,19,0.277,0.319,0.404,18.132,76,riffle_clumpy
0,26,18,2,46,0.565,28,0.609,3,0,1.0,7,2,31,15,9,16,21,0.196,0.348,0.457,18.124,77,riffle_clumpy
0,22,24,4,50,0.44,26,0.52,3,4,0.429,2,5,27,23,11,19,20,0.22,0.38,0.4,18.121,78,riffle_clumpy
0,20,23,3,46,0.435,23,0.5,5,1,0.833,0,2,25,21,10,22,14,0.217,0.478,0.304,18.126,79,riffle_clumpy
0,18,28,1,47,0.383,19,0.404,0,5,0.0,1,2,28,19,11,22,14,0.234,0.468,0.298,18.135,80,riffle_clumpy
0,20,21,4,45,0.444,24,0.533,5,1,0.833,0,4,32,13,17,12,16,0.378,0.267,0.356,18.138,81,riffle_clumpy
0,28,19,1,48,0.583,29,0.604,4,2,0.667,4,3,28,20,18,14,16,0.375,0.292,0.333,18.131,82,riffle_clumpy
0,23,20,3,46,0.5,26,0.565,3,1,0.75,1,2,23,23,15,16,15,0.326,0.348,0.326,18.131,83,riffle_clumpy
0,24,19,3,46,0.522,27,0.587,3,1,0.75,3,0,30,16,15,14,17,0.326,0.304,0.37,18.131,84,riffle_clumpy
0,14,28,4,46,0.304,18,0.391,3,2,0.6,1,0,27,19,9,17,20,0.196,0.37,0.435,18.137,85,riffle_clumpy
0,16,28,2,46,0.348,18,0.391,3,5,0.375,1,3,29,17,13,18,15,0.283,0.391,0.326,18.143,86,riffle_clumpy
0,22,17,7,46,0.478,29,0.63,4,0,1.0,3,1,29,17,10,15,21,0.217,0.326,0.457,18.143,87,riffle_clumpy
0,14,30,4,48,0.292,18,0.375,1,1,0.5,2,5,30,18,8,15,25,0.167,0.312,0.521,18.138,88,riffle_clumpy
0,15,28,3,46,0.326,18,0.391,2,0,1.0,2,3,27,19,10,17,19,0.217,0.37,0.413,18.141,89,riffle_clumpy
0,22,21,2,45,0.489,24,0.533,6,0,1.0,0,3,27,18,15,15,15,0.333,0.333,0.333,18.143,90,riffle_clumpy
0,19,22,3,44,0.432,22,0.5,2,3,0.4,2,1,25,19,13,13,18,0.295,0.295,0.409,18.14,91,riffle_clumpy
0,20,27,2,49,0.408,22,0.449,2,1,0.667,3,5,32,17,10,17,22,0.204,0.347,0.449,18.136,92,riffle_clumpy
0,22,21,5,48,0.458,27,0.562,2,1,0.667,2,2,27,21,16,12,20,0.333,0.25,0.417,18.128,93,riffle_clumpy
0,16,27,3,46,0.348,19,0.413,1,2,0.333,2,2,21,25,13,18,15,0.283,0.391,0.326,18.133,94,riffle_clumpy
0,20,23,3,46,0.435,23,0.5,1,0,1.0,2,2,30,16,14,14,18,0.304,0.304,0.391,18.129,95,riffle_clumpy
0,20,24,4,48,0.417,24,0.5,3,1,0.75,1,1,30,18,12,18,18,0.25,0.375,0.375,18.125,96,riffle_clumpy
0,21,22,1,44,0.477,22,0.5,3,1,0.75,0,0,27,17,15,14,15,0.341,0.318,0.341,18.036,1,riffle_clumpy
0,17,26,6,49,0.347,23,0.469,4,0,1.0,2,0,33,16,6,21,22,0.122,0.429,0.449,18.303,2,riffle_clumpy
0,16,26,3,45,0.356,19,0.422,2,1,0.667,0,0,25,20,10,18,17,0.222,0.4,0.378,18.289,3,riffle_clumpy
0,22,22,3,47,0.468,25,0.532,3,4,0.429,2,5,26,21,9,18,20,0.191,0.383,0.426,18.2,4,riffle_clumpy
0,20,25,2,47,0.426,22,0.468,5,2,0.714,1,4,32,15,13,14,20,0.277,0.298,0.426,18.26,5,riffle_clumpy
0,17,26,3,46,0.37,20,0.435,3,3,0.5,4,3,30,16,9,13,24,0.196,0.283,0.522,18.06,6,riffle_clumpy
0,17,26,5,48,0.354,22,0.458,2,8,0.2,1,1,30,18,9,24,15,0.188,0.5,0.312,18.055,7,riffle_clumpy
0,23,24,0,47,0.489,23,0.489,2,2,0.5,2,1,32,15,9,16,22,0.191,0.34,0.468,18.091,8,riffle_clumpy
0,24,18,6,48,0.5,30,0.625,2,0,1.0,2,1,28,20,12,18,18,0.25,0.375,0.375,18.121,9,riffle_clumpy
0,29,15,5,49,0.592,34,0.694,3,1,0.75,3,3,30,19,19,12,18,0.388,0.245,0.367,18.075,10,riffle_clumpy
0,18,25,4,47,0.383,22,0.468,1,2,0.333,1,1,30,17,11,15,21,0.234,0.319,0.447,18.062,11,riffle_clumpy
0,21,20,5,46,0.457,26,0.565,3,3,0.5,0,1,26,20,18,16,12,0.391,0.348,0.261,18.072,12,riffle_clumpy
0,19,23,3,45,0.422,22,0.489,5,2,0.714,4,4,27,18,11,14,20,0.244,0.311,0.444,18.036,13,riffle_clumpy
0,24,20,3,47,0.511,27,0.574,5,2,0.714,5,0,28,19,13,15,19,0.277,0.319,0.404,18.028,14,riffle_clumpy
0,18,25,2,45,0.4,20,0.444,1,2,0.333,4,2,30,15,12,17,16,0.267,0.378,0.356,17.989,15,riffle_clumpy
0,17,31,2,50,0.34,19,0.38,4,4,0.5,0,3,28,22,11,22,17,0.22,0.44,0.34,17.994,16,riffle_clumpy
0,23,22,4,49,0.469,27,0.551,5,3,0.625,4,3,31,18,12,18,19,0.245,0.367,0.388,17.951,17,riffle_clumpy
0,22,18,6,46,0.478,28,0.609,1,1,0.5,2,2,26,20,14,18,14,0.304,0.391,0.304,17.955,18,riffle_clumpy
0,23,25,3,51,0.451,26,0.51,6,0,1.0,1,0,28,23,16,16,19,0.314,0.314,0.373,17.986,19,riffle_clumpy
0,25,21,4,50,0.5,29,0.58,10,0,1.0,5,2,27,23,17,12,21,0.34,0.24,0.42,17.985,20,riffle_clumpy
0,19,26,1,46,0.413,20,0.435,1,2,0.333,3,3,28,18,10,19,17,0.217,0.413,0.37,17.982,21,riffle_clumpy
0,14,30,3,47,0.298,17,0.362,0,3,0.0,2,2,29,18,5,22,20,0.106,0.468,0.426,18.0,22,riffle_clumpy
0,15,29,3,47,0.319,18,0.383,1,4,0.2,0,1,26,21,12,20,15,0.255,0.426,0.319,18.026,23,riffle_clumpy
0,20,20,7,47,0.426,27,0.574,4,1,0.8,4,1,28,19,11,15,21,0.234,0.319,0.447,17.999,24,riffle_clumpy
0,18,22,7,47,0.383,25,0.532,2,2,0.5,2,3,26,21,10,18,19,0.213,0.383,0.404,18.003,25,riffle_clumpy
0,24,17,5,46,0.522,29,0.63,5,0,1.0,4,1,31,15,11,15,20,0.239,0.326,0.435,17.98,26,riffle_clumpy
0,17,28,5,50,0.34,22,0.44,4,1,0.8,3,1,33,17,6,20,24,0.12,0.4,0.48,17.976,27,riffle_clumpy
0,29,14,2,45,0.644,31,0.689,5,0,1.0,6,0,22,23,17,13,15,0.378,0.289,0.333,17.973,28,riffle_clumpy
0,27,18,2,47,0.574,29,0.617,2,2,0.5,3,1,25,22,19,13,15,0.404,0.277,0.319,17.956,29,riffle_clumpy
0,22,23,2,47,0.468,24,0.511,2,1,0.667,4,3,30,17,10,17,20,0.213,0.362,0.426,17.951,30,riffle_clumpy
0,20,24,3,47,0.426,23,0.489,2,3,0.4,2,2,28,19,15,16,16,0.319,0.34,0.34,17.95,31,riffle_clumpy
0,18,24,5,47,0.383,23,0.489,4,2,0.667,3,3,26,21,10,14,23,0.213,0.298,0.489,17.948,32,riffle_clumpy
0,27,20,1,48,0.562,28,0.583,2,0,1.0,0,1,22,26,20,15,13,0.417,0.312,0.271,17.963,33,riffle_clumpy
0,13,27,6,46,0.283,19,0.413,5,2,0.714,3,4,32,14,8,12,26,0.174,0.261,0.565,17.966,34,riffle_clumpy
0,22,22,3,47,0.468,25,0.532,5,1,0.833,2,3,29,18,13,18,16,0.277,0.383,0.34,17.964,35,riffle_clumpy
0,18,21,6,45,0.4,24,0.533,4,0,1.0,2,2,26,19,10,19,16,0.222,0.422,0.356,17.967,36,riffle_clumpy
0,26,18,2,46,0.565,28,0.609,4,2,0.667,1,3,28,18,21,15,10,0.457,0.326,0.217,17.965,37,riffle_clumpy
0,20,23,3,46,0.435,23,0.5,4,0,1.0,0,4,33,13,13,15,18,0.283,0.326,0.391,17.976,38,riffle_clumpy
0,19,24,5,48,0.396,24,0.5,1,1,0.5,3,3,26,22,13,15,20,0.271,0.312,0.417,17.963,39,riffle_clumpy
0,22,20,3,45,0.489,25,0.556,2,1,0.667,3,2,25,20,17,17,11,0.378,0.378,0.244,17.959,40,riffle_clumpy
0,21,20,3,44,0.477,24,0.545,2,2,0.5,2,2,27,17,7,20,17,0.159,0.455,0.386,17.952,41,riffle_clumpy
0,23,19,2,44,0.523,25,0.568,2,3,0.4,0,2,21,23,18,12,14,0.409,0.273,0.318,17.955,42,riffle_clumpy
0,28,14,5,47,0.596,33,0.702,4,1,0.8,2,0,22,25,16,17,14,0.34,0.362,0.298,17.954,43,riffle_clumpy
0,22,23,3,48,0.458,25,0.521,3,2,0.6,4,0,27,21,12,17,19,0.25,0.354,0.396,17.949,44,riffle_clumpy
0,25,22,2,49,0.51,27,0.551,4,1,0.8,4,3,36,13,10,13,26,0.204,0.265,0.531,17.934,45,riffle_clumpy
0,22,22,2,46,0.478,24,0.522,5,3,0.625,1,3,29,17,13,14,19,0.283,0.304,0.413,17.938,46,riffle_clumpy
0,21,23,1,45,0.467,22,0.489,2,4,0.333,3,3,22,23,12,14,19,0.267,0.311,0.422,17.932,47,riffle_clumpy
0,20,26,1,47,0.426,21,0.447,5,4,0.556,2,0,28,19,12,20,15,0.255,0.426,0.319,17.945,48,riffle_clumpy
0,23,24,1,48,0.479,24,0.5,4,2,0.667,2,2,30,18,14,13,21,0.292,0.271,0.438,17.936,49,riffle_clumpy
0,18,23,5,46,0.391,23,0.5,1,1,0.5,2,2,33,13,10,15,21,0.217,0.326,0.457,17.938,50,riffle_clumpy
0,18,27,4,49,0.367,22,0.449,3,3,0.5,2,0,31,18,13,16,20,0.265,0.327,0.408,17.93,51,riffle_clumpy
0,20,25,3,48,0.417,23,0.479,3,2,0.6,1,2,27,21,11,17,20,0.229,0.354,0.417,17.935,52,riffle_clumpy
0,19,27,2,48,0.396,21,0.438,3,3,0.5,2,8,29,19,7,19,22,0.146,0.396,0.458,17.936,53,riffle_clumpy
0,16,29,3,48,0.333,19,0.396,1,1,0.5,2,2,31,17,10,13,25,0.208,0.271,0.521,17.937,54,riffle_clumpy
0,22,26,3,51,0.431,25,0.49,2,5,0.286,3,2,28,23,13,21,17,0.255,0.412,0.333,17.929,55,riffle_clumpy
0,20,23,3,46,0.435,23,0.5,1,2,0.333,3,2,22,24,14,18,14,0.304,0.391,0.304,17.928,56,riffle_clumpy
0,22,24,1,47,0.468,23,0.489,3,6,0.333,3,2,23,24,16,14,17,0.34,0.298,0.362,17.925,57,riffle_clumpy
0,21,23,3,47,0.447,24,0.511,3,3,0.5,2,3,28,19,13,14,20,0.277,0.298,0.426,17.927,58,riffle_clumpy
0,17,24,6,47,0.362,23,0.489,3,2,0.6,1,5,33,14,14,12,21,0.298,0.255,0.447,17.933,59,riffle_clumpy
0,23,22,3,48,0.479,26,0.542,1,1,0.5,3,1,26,22,11,15,22,0.229,0.312,0.458,17.927,60,riffle_clumpy
0,19,26,2,47,0.404,21,0.447,0,5,0.0,0,2,27,20,10,21,16,0.213,0.447,0.34,17.942,61,riffle_clumpy
0,19,27,3,49,0.388,22,0.449,1,1,0.5,2,6,31,18,12,13,24,0.245,0.265,0.49,17.944,62,riffle_clumpy
0,21,23,2,46,0.457,23,0.5,3,2,0.6,2,1,23,23,8,21,17,0.174,0.457,0.37,17.942,63,riffle_clumpy
0,22,18,5,45,0.489,27,0.6,3,2,0.6,3,1,30,15,15,11,19,0.333,0.244,0.422,17.945,64,riffle_clumpy
0,13,24,11,48,0.271,24,0.5,1,2,0.333,2,2,30,18,8,18,22,0.167,0.375,0.458,17.952,65,riffle_clumpy
0,22,22,2,46,0.478,24,0.522,2,1,0.667,2,3,30,16,12,15,19,0.261,0.326,0.413,17.955,66,riffle_clumpy
0,19,26,2,47,0.404,21,0.447,0,2,0.0,4,1,31,16,9,17,21,0.191,0.362,0.447,17.957,67,riffle_clumpy
0,18,26,3,47,0.383,21,0.447,3,3,0.5,0,2,32,15,9,16,22,0.191,0.34,0.468,17.972,68,riffle_clumpy
0,21,21,1,43,0.488,22,0.512,2,3,0.4,1,2,22,21,15,16,12,0.349,0.372,0.279,17.977,69,riffle_clumpy
0,20,23,4,47,0.426,24,0.511,1,4,0.2,2,3,30,17,11,19,17,0.234,0.404,0.362,17.982,70,riffle_clumpy
0,20,23,3,46,0.435,23,0.5,1,3,0.25,2,1,23,23,13,19,14,0.283,0.413,0.304,17.981,71,riffle_clumpy
0,25,20,2,47,0.532,27,0.574,6,1,0.857,6,4,27,20,7,18,22,0.149,0.383,0.468,17.969,72,riffle_clumpy
0,21,19,6,46,0.457,27,0.587,4,2,0.667,2,1,22,24,15,17,14,0.326,0.37,0.304,17.975,73,riffle_clumpy
0,14,31,3,48,0.292,17,0.354,1,0,1.0,2,5,31,17,7,15,26,0.146,0.312,0.542,17.972,74,riffle_clumpy
0,23,21,3,47,0.489,26,0.553,4,2,0.667,4,1,23,24,12,19,16,0.255,0.404,0.34,17.969,75,riffle_clumpy
0,19,27,3,49,0.388,22,0.449,1,3,0.25,2,3,29,20,10,20,19,0.204,0.408,0.388,17.964,76,riffle_clumpy
0,21,24,2,47,0.447,23,0.489,4,2,0.667,3,2,33,14,12,17,18,0.255,0.362,0.383,17.973,77,riffle_clumpy
0,18,26,3,47,0.383,21,0.447,1,0,1.0,0,2,27,20,9,17,21,0.191,0.362,0.447,17.966,78,riffle_clumpy
0,18,29,8,55,0.327,26,0.473,2,3,0.4,1,3,35,20,11,20,24,0.2,0.364,0.436,17.968,79,riffle_clumpy
0,25,22,3,50,0.5,28,0.56,5,1,0.833,2,4,26,24,15,16,19,0.3,0.32,0.38,17.968,80,riffle_clumpy
0,29,16,3,48,0.604,32,0.667,3,3,0.5,3,0,31,17,12,15,21,0.25,0.312,0.438,17.969,81,riffle_clumpy
0,26,19,1,46,0.565,27,0.587,5,4,0.556,2,1,31,15,18,13,15,0.391,0.283,0.326,17.973,82,riffle_clumpy
0,16,27,3,46,0.348,19,0.413,2,3,0.4,2,3,25,21,11,16,19,0.239,0.348,0.413,17.974,83,riffle_clumpy
0,18,22,5,45,0.4,23,0.511,4,3,0.571,1,1,26,19,12,17,16,0.267,0.378,0.356,17.972,84,riffle_clumpy
0,23,16,8,47,0.489,31,0.66,4,4,0.5,3,1,33,14,11,17,19,0.234,0.362,0.404,17.967,85,riffle_clumpy
0,20,25,5,50,0.4,25,0.5,4,2,0.667,3,4,24,26,13,19,18,0.26,0.38,0.36,17.955,86,riffle_clumpy
0,19,20,7,46,0.413,26,0.565,8,2,0.8,1,4,24,22,11,18,17,0.239,0.391,0.37,17.955,87,riffle_clumpy
0,18,29,3,50,0.36,21,0.42,1,2,0.333,5,4,33,17,11,17,22,0.22,0.34,0.44,17.957,88,riffle_clumpy
0,20,25,1,46,0.435,21,0.457,3,1,0.75,2,5,28,18,11,19,16,0.239,0.413,0.348,17.953,89,riffle_clumpy
0,9,37,3,49,0.184,12,0.245,1,3,0.25,1,1,28,21,5,20,24,0.102,0.408,0.49,17.96,90,riffle_clumpy
0,28,19,1,48,0.583,29,0.604,7,1,0.875,2,1,25,23,19,9,20,0.396,0.188,0.417,17.962,91,riffle_clumpy
0,18,25,5,48,0.375,23,0.479,3,4,0.429,2,4,29,19,12,21,15,0.25,0.438,0.312,17.966,92,riffle_clumpy
0,18,29,4,51,0.353,22,0.431,5,2,0.714,4,3,28,23,12,18,21,0.235,0.353,0.412,17.963,93,riffle_clumpy
0,20,27,2,49,0.408,22,0.449,6,4,0.6,1,0,29,20,16,13,20,0.327,0.265,0.408,17.972,94,riffle_clumpy
0,12,30,3,45,0.267,15,0.333,4,1,0.8,0,3,28,17,6,17,22,0.133,0.378,0.489,17.978,95,riffle_clumpy
0,16,28,4,48,0.333,20,0.417,3,1,0.75,2,2,28,20,9,19,20,0.188,0.396,0.417,17.981,96,riffle_clumpy
0,23,22,2,47,0.489,25,0.532,2,4,0.333,2,2,30,17,12,16,19,0.255,0.34,0.404,17.724,1,riffle_clumpy
0,21,27,0,48,0.438,21,0.438,3,2,0.6,4,2,35,13,12,10,26,0.25,0.208,0.542,17.583,2,riffle_clumpy
0,26,20,1,47,0.553,27,0.574,4,5,0.444,4,1,25,22,19,13,15,0.404,0.277,0.319,17.64,3,riffle_clumpy
0,21,18,8,47,0.447,29,0.617,3,1,0.75,2,2,31,16,13,17,17,0.277,0.362,0.362,17.774,4,riffle_clumpy
0,20,23,5,48,0.417,25,0.521,1,3,0.25,2,2,32,16,9,19,20,0.188,0.396,0.417,17.845,5,riffle_clumpy
0,20,23,2,45,0.444,22,0.489,6,2,0.75,1,1,29,16,12,19,14,0.267,0.422,0.311,17.955,6,riffle_clumpy
0,20,23,2,45,0.444,22,0.489,7,1,0.875,2,0,29,16,11,15,19,0.244,0.333,0.422,17.966,7,riffle_clumpy
0,24,19,3,46,0.522,27,0.587,3,1,0.75,3,0,25,21,14,19,13,0.304,0.413,0.283,17.927,8,riffle_clumpy
0,20,19,7,46,0.435,27,0.587,5,1,0.833,2,0,28,18,14,16,16,0.304,0.348,0.348,17.992,9,riffle_clumpy
0,24,18,4,46,0.522,28,0.609,3,2,0.6,4,1,28,18,11,13,22,0.239,0.283,0.478,17.959,10,riffle_clumpy
0,23,18,5,46,0.5,28,0.609,2,1,0.667,5,1,29,17,10,16,20,0.217,0.348,0.435,17.969,11,riffle_clumpy
0,17,26,3,46,0.37,20,0.435,3,3,0.5,3,2,29,17,9,15,22,0.196,0.326,0.478,17.983,12,riffle_clumpy
0,20,26,4,50,0.4,24,0.48,1,2,0.333,2,3,35,15,11,18,21,0.22,0.36,0.42,18.013,13,riffle_clumpy
0,21,21,6,48,0.438,27,0.562,4,2,0.667,5,1,28,20,9,18,21,0.188,0.375,0.438,17.988,14,riffle_clumpy
0,18,22,5,45,0.4,23,0.511,4,2,0.667,0,3,27,18,11,19,15,0.244,0.422,0.333,17.998,15,riffle_clumpy
0,17,23,4,44,0.386,21,0.477,2,3,0.4,0,3,28,16,12,20,12,0.273,0.455,0.273,18.034,16,riffle_clumpy
0,19,29,2,50,0.38,21,0.42,3,4,0.429,2,5,31,19,13,16,21,0.26,0.32,0.42,18.018,17,riffle_clumpy
0,18,28,2,48,0.375,20,0.417,2,1,0.667,3,2,30,18,10,23,15,0.208,0.479,0.312,18.03,18,riffle_clumpy
0,19,26,3,48,0.396,22,0.458,0,1,0.0,4,2,37,11,10,10,28,0.208,0.208,0.583,18.011,19,riffle_clumpy
0,27,15,4,46,0.587,31,0.674,1,0,1.0,4,0,31,15,19,11,16,0.413,0.239,0.348,17.973,20,riffle_clumpy
0,15,26,7,48,0.312,22,0.458,1,1,0.5,4,3,22,26,8,24,16,0.167,0.5,0.333,17.971,21,riffle_clumpy
0,24,20,2,46,0.522,26,0.565,3,1,0.75,4,0,27,19,15,14,17,0.326,0.304,0.37,17.96,22,riffle_clumpy
0,21,20,5,46,0.457,26,0.565,2,3,0.4,2,2,29,17,15,17,14,0.326,0.37,0.304,17.972,23,riffle_clumpy
0,19,22,4,45,0.422,23,0.511,4,6,0.4,1,1,28,17,11,17,17,0.244,0.378,0.378,17.979,24,riffle_clumpy
0,16,26,3,45,0.356,19,0.422,5,1,0.833,2,4,30,15,10,16,19,0.222,0.356,0.422,17.98,25,riffle_clumpy
0,23,23,5,51,0.451,28,0.549,4,3,0.571,5,2,35,16,15,10,26,0.294,0.196,0.51,17.964,26,riffle_clumpy
0,20,26,1,47,0.426,21,0.447,3,2,0.6,2,2,25,22,14,13,20,0.298,0.277,0.426,17.948,27,riffle_clumpy
0,16,28,3,47,0.34,19,0.404,2,4,0.333,1,2,32,15,9,20,18,0.191,0.426,0.383,17.967,28,riffle_clumpy
0,26,17,1,44,0.591,27,0.614,6,1,0.857,1,0,21,23,18,11,15,0.409,0.25,0.341,17.974,29,riffle_clumpy
0,20,25,2,47,0.426,22,0.468,2,5,0.286,4,3,24,23,10,18,19,0.213,0.383,0.404,17.968,30,riffle_clumpy
0,24,19,3,46,0.522,27,0.587,3,2,0.6,3,0,26,20,14,18,14,0.304,0.391,0.304,17.969,31,riffle_clumpy
0,25,16,5,46,0.543,30,0.652,4,1,0.8,0,0,32,14,17,14,15,0.37,0.304,0.326,17.974,32,riffle_clumpy
0,23,21,3,47,0.489,26,0.553,6,3,0.667,1,0,19,28,18,18,11,0.383,0.383,0.234,17.991,33,riffle_clumpy
0,25,21,0,46,0.543,25,0.543,4,2,0.667,2,2,25,21,13,12,21,0.283,0.261,0.457,17.984,34,riffle_clumpy
0,18,23,4,45,0.4,22,0.489,1,5,0.167,2,3,23,22,14,18,13,0.311,0.4,0.289,17.996,35,riffle_clumpy
0,20,23,4,47,0.426,24,0.511,2,4,0.333,1,3,28,19,16,13,18,0.34,0.277,0.383,18.011,36,riffle_clumpy
0,27,16,3,46,0.587,30,0.652,2,1,0.667,3,4,31,15,15,15,16,0.326,0.326,0.348,18.019,37,riffle_clumpy
0,26,18,2,46,0.565,28,0.609,4,2,0.667,4,2,32,14,16,11,19,0.348,0.239,0.413,17.999,38,riffle_clumpy
0,21,21,4,46,0.457,25,0.543,6,4,0.6,2,1,33,13,12,13,21,0.261,0.283,0.457,18.006,39,riffle_clumpy
0,17,27,5,49,0.347,22,0.449,5,3,0.625,0,2,27,22,12,20,17,0.245,0.408,0.347,18.019,40,riffle_clumpy
0,19,27,1,47,0.404,20,0.426,3,1,0.75,2,1,33,14,11,16,20,0.234,0.34,0.426,18.036,41,riffle_clumpy
0,18,28,0,46,0.391,18,0.391,2,2,0.5,2,3,32,14,13,14,19,0.283,0.304,0.413,18.033,42,riffle_clumpy
0,11,28,7,46,0.239,18,0.391,0,3,0.0,1,1,26,20,8,25,13,0.174,0.543,0.283,18.04,43,riffle_clumpy
0,17,25,3,45,0.378,20,0.444,3,4,0.429,0,2,26,19,10,21,14,0.222,0.467,0.311,18.041,44,riffle_clumpy
0,20,20,6,46,0.435,26,0.565,5,1,0.833,3,1,34,12,11,15,20,0.239,0.326,0.435,18.036,45,riffle_clumpy
0,20,23,3,46,0.435,23,0.5,1,0,1.0,1,3,27,19,11,21,14,0.239,0.457,0.304,18.04,46,riffle_clumpy
0,19,29,0,48,0.396,19,0.396,6,1,0.857,1,5,27,21,10,20,18,0.208,0.417,0.375,18.044,47,riffle_clumpy
0,19,20,5,44,0.432,24,0.545,4,4,0.5,2,2,25,19,12,19,13,0.273,0.432,0.295,18.04,48,riffle_clumpy
0,21,24,3,48,0.438,24,0.5,6,5,0.545,3,1,26,22,13,18,17,0.271,0.375,0.354,18.029,49,riffle_clumpy
0,20,25,3,48,0.417,23,0.479,2,3,0.4,2,1,25,23,10,19,19,0.208,0.396,0.396,18.029,50,riffle_clumpy
0,19,24,3,46,0.413,22,0.478,3,1,0.75,0,1,25,21,14,16,16,0.304,0.348,0.348,18.029,51,riffle_clumpy
0,19,24,3,46,0.413,22,0.478,4,0,1.0,1,3,24,22,15,13,18,0.326,0.283,0.391,18.035,52,riffle_clumpy
0,20,22,4,46,0.435,24,0.522,1,3,0.25,4,3,28,18,9,17,20,0.196,0.37,0.435,18.029,53,riffle_clumpy
0,19,23,5,47,0.404,24,0.511,6,4,0.6,1,2,30,17,12,15,20,0.255,0.319,0.426,18.026,54,riffle_clumpy
0,19,24,6,49,0.388,25,0.51,5,4,0.556,1,1,28,21,12,21,16,0.245,0.429,0.327,18.032,55,riffle_clumpy
0,20,21,6,47,0.426,26,0.553,4,6,0.4,0,0,27,20,12,21,14,0.255,0.447,0.298,18.036,56,riffle_clumpy
0,14,25,8,47,0.298,22,0.468,0,1,0.0,2,2,31,16,12,13,22,0.255,0.277,0.468,18.042,57,riffle_clumpy
0,20,26,1,47,0.426,21,0.447,3,1,0.75,2,6,27,20,13,13,21,0.277,0.277,0.447,18.031,58,riffle_clumpy
0,14,27,7,48,0.292,21,0.438,2,3,0.4,2,3,32,16,10,15,23,0.208,0.312,0.479,18.026,59,riffle_clumpy
0,28,17,3,48,0.583,31,0.646,2,1,0.667,4,2,25,23,21,14,13,0.438,0.292,0.271,18.016,60,riffle_clumpy
0,19,24,3,46,0.413,22,0.478,1,1,0.5,0,3,33,13,12,12,22,0.261,0.261,0.478,18.022,61,riffle_clumpy
0,23,25,2,50,0.46,25,0.5,2,2,0.5,0,2,30,20,15,15,20,0.3,0.3,0.4,18.023,62,riffle_clumpy
0,26,24,4,54,0.481,30,0.556,2,0,1.0,4,2,29,25,14,19,21,0.259,0.352,0.389,18.007,63,riffle_clumpy
0,20,24,5,49,0.408,25,0.51,3,1,0.75,1,1,31,18,11,18,20,0.224,0.367,0.408,18.018,64,riffle_clumpy
0,22,26,2,50,0.44,24,0.48,2,3,0.4,4,3,24,26,14,16,20,0.28,0.32,0.4,18.01,65,riffle_clumpy
0,24,21,1,46,0.522,25,0.543,2,3,0.4,4,3,32,14,13,16,17,0.283,0.348,0.37,18.006,66,riffle_clumpy
0,21,23,3,47,0.447,24,0.511,3,3,0.5,2,2,27,20,14,16,17,0.298,0.34,0.362,18.01,67,riffle_clumpy
0,17,24,6,47,0.362,23,0.489,1,3,0.25,2,1,22,25,8,19,20,0.17,0.404,0.426,18.002,68,riffle_clumpy
0,21,21,6,48,0.438,27,0.562,6,2,0.75,1,2,32,16,10,21,17,0.208,0.438,0.354,18.002,69,riffle_clumpy
0,12,32,2,46,0.261,14,0.304,3,3,0.5,1,6,24,22,9,19,18,0.196,0.413,0.391,18.001,70,riffle_clumpy
0,20,21,5,46,0.435,25,0.543,2,2,0.5,2,2,26,20,13,18,15,0.283,0.391,0.326,18.002,71,riffle_clumpy
0,19,27,0,46,0.413,19,0.413,2,3,0.4,1,2,23,23,11,19,16,0.239,0.413,0.348,18.005,72,riffle_clumpy
0,19,21,5,45,0.422,24,0.533,3,2,0.6,2,1,31,14,10,18,17,0.222,0.4,0.378,18.008,73,riffle_clumpy
0,18,25,5,48,0.375,23,0.479,1,3,0.25,2,1,33,15,9,24,15,0.188,0.5,0.312,18.009,74,riffle_clumpy
0,20,21,3,44,0.455,23,0.523,1,2,0.333,1,0,28,16,15,14,15,0.341,0.318,0.341,18.008,75,riffle_clumpy
0,25,17,3,45,0.556,28,0.622,3,3,0.5,2,1,27,18,17,17,11,0.378,0.378,0.244,18.005,76,riffle_clumpy
0,22,25,1,48,0.458,23,0.479,2,1,0.667,4,1,28,20,10,18,20,0.208,0.375,0.417,18.0,77,riffle_clumpy
0,18,26,2,46,0.391,20,0.435,4,2,0.667,1,4,31,15,12,15,19,0.261,0.326,0.413,18.006,78,riffle_clumpy
0,18,22,7,47,0.383,25,0.532,1,4,0.2,2,2,30,17,10,22,15,0.213,0.468,0.319,18.011,79,riffle_clumpy
0,17,28,2,47,0.362,19,0.404,2,4,0.333,2,2,26,21,12,15,20,0.255,0.319,0.426,18.015,80,riffle_clumpy
0,15,26,7,48,0.312,22,0.458,3,2,0.6,0,2,32,16,10,19,19,0.208,0.396,0.396,18.02,81,riffle_clumpy
0,20,25,2,47,0.426,22,0.468,2,3,0.4,1,2,29,18,10,25,12,0.213,0.532,0.255,18.023,82,riffle_clumpy
0,19,26,2,47,0.404,21,0.447,4,2,0.667,1,4,33,14,12,20,15,0.255,0.426,0.319,18.027,83,riffle_clumpy
0,22,18,3,43,0.512,25,0.581,2,2,0.5,2,0,24,19,14,18,11,0.326,0.419,0.256,18.029,84,riffle_clumpy
0,21,27,2,50,0.42,23,0.46,5,1,0.833,4,3,30,20,12,15,23,0.24,0.3,0.46,18.03,85,riffle_clumpy
0,23,19,4,46,0.5,27,0.587,3,1,0.75,3,2,29,17,13,16,17,0.283,0.348,0.37,18.026,86,riffle_clumpy
0,15,31,2,48,0.312,17,0.354,4,2,0.667,0,3,35,13,7,16,25,0.146,0.333,0.521,18.033,87,riffle_clumpy
0,20,21,5,46,0.435,25,0.543,3,0,1.0,0,1,25,21,16,15,15,0.348,0.326,0.326,18.034,88,riffle_clumpy
0,21,23,2,46,0.457,23,0.5,5,1,0.833,4,0,34,12,12,14,20,0.261,0.304,0.435,18.032,89,riffle_clumpy
0,16,22,7,45,0.356,23,0.511,1,1,0.5,2,1,29,16,10,17,18,0.222,0.378,0.4,18.034,90,riffle_clumpy
0,24,22,3,49,0.49,27,0.551,4,1,0.8,1,1,34,15,18,11,20,0.367,0.224,0.408,18.038,91,riffle_clumpy
0,31,15,2,48,0.646,33,0.688,2,1,0.667,2,2,23,25,21,14,13,0.438,0.292,0.271,18.037,92,riffle_clumpy
0,22,19,4,45,0.489,26,0.578,2,2,0.5,3,1,25,20,13,13,19,0.289,0.289,0.422,18.03,93,riffle_clumpy
0,12,32,5,49,0.245,17,0.347,0,1,0.0,1,3,30,19,8,20,21,0.163,0.408,0.429,18.035,94,riffle_clumpy
0,21,20,5,46,0.457,26,0.565,3,1,0.75,1,2,21,25,17,16,13,0.37,0.348,0.283,18.04,95,riffle_clumpy
0,24,20,2,46,0.522,26,0.565,4,3,0.571,4,0,27,19,15,10,21,0.326,0.217,0.457,18.033,96,riffle_clumpy
0,21,22,3,46,0.457,24,0.522,3,4,0.429,0,3,30,16,13,15,18,0.283,0.326,0.391,17.9,1,riffle_clumpy
0,25,19,2,46,0.543,27,0.587,1,1,0.5,2,4,30,16,13,16,17,0.283,0.348,0.37,17.873,2,riffle_clumpy
0,17,25,4,46,0.37,21,0.457,0,4,0.0,0,5,29,17,11,15,20,0.239,0.326,0.435,18.098,3,riffle_clumpy
0,32,12,3,47,0.681,35,0.745,6,0,1.0,1,2,22,25,22,12,13,0.468,0.255,0.277,18.136,4,riffle_clumpy
0,20,21,4,45,0.444,24,0.533,3,1,0.75,0,3,29,16,13,16,16,0.289,0.356,0.356,18.194,5,riffle_clumpy
0,20,27,0,47,0.426,20,0.426,1,3,0.25,3,7,26,21,12,15,20,0.255,0.319,0.426,18.098,6,riffle_clumpy
0,23,20,1,44,0.523,24,0.545,4,0,1.0,2,1,26,18,16,14,14,0.364,0.318,0.318,18.102,7,riffle_clumpy
0,17,23,4,44,0.386,21,0.477,3,1,0.75,1,3,27,17,12,16,16,0.273,0.364,0.364,18.109,8,riffle_clumpy
0,18,28,3,49,0.367,21,0.429,3,5,0.375,5,3,28,21,11,14,24,0.224,0.286,0.49,18.022,9,riffle_clumpy
0,21,23,2,46,0.457,23,0.5,2,4,0.333,2,2,29,17,13,17,16,0.283,0.37,0.348,17.961,10,riffle_clumpy
0,22,26,5,53,0.415,27,0.509,6,7,0.462,0,5,34,19,14,16,23,0.264,0.302,0.434,18.021,11,riffle_clumpy
0,20,25,4,49,0.408,24,0.49,4,3,0.571,5,2,31,18,11,20,18,0.224,0.408,0.367,17.968,12,riffle_clumpy
0,21,26,2,49,0.429,23,0.469,3,3,0.5,4,2,24,25,13,17,19,0.265,0.347,0.388,17.944,13,riffle_clumpy
0,22,18,3,43,0.512,25,0.581,6,0,1.0,2,0,22,21,15,14,14,0.349,0.326,0.326,17.959,14,riffle_clumpy
0,26,21,2,49,0.531,28,0.571,3,1,0.75,1,4,34,15,20,11,18,0.408,0.224,0.367,17.94,15,riffle_clumpy
0,15,31,6,52,0.288,21,0.404,1,7,0.125,2,2,27,25,10,23,19,0.192,0.442,0.365,17.94,16,riffle_clumpy
0,21,24,3,48,0.438,24,0.5,5,5,0.5,3,1,29,19,14,11,23,0.292,0.229,0.479,17.879,17,riffle_clumpy
0,26,17,1,44,0.591,27,0.614,3,1,0.75,3,0,25,19,14,18,12,0.318,0.409,0.273,17.878,18,riffle_clumpy
0,19,23,2,44,0.432,21,0.477,3,1,0.75,0,1,30,14,12,20,12,0.273,0.455,0.273,17.904,19,riffle_clumpy
0,19,26,2,47,0.404,21,0.447,4,0,1.0,1,1,27,20,13,21,13,0.277,0.447,0.277,17.903,20,riffle_clumpy
0,26,17,2,45,0.578,28,0.622,7,1,0.875,3,0,27,18,16,13,16,0.356,0.289,0.356,17.915,21,riffle_clumpy
0,25,21,1,47,0.532,26,0.553,4,3,0.571,2,4,33,14,15,13,19,0.319,0.277,0.404,17.916,22,riffle_clumpy
0,16,27,3,46,0.348,19,0.413,2,2,0.5,2,2,28,18,12,20,14,0.261,0.435,0.304,17.95,23,riffle_clumpy
0,16,27,5,48,0.333,21,0.438,6,3,0.667,3,4,29,19,9,18,21,0.188,0.375,0.438,17.984,24,riffle_clumpy
0,23,20,3,46,0.5,26,0.565,2,4,0.333,4,3,24,22,13,14,19,0.283,0.304,0.413,17.97,25,riffle_clumpy
0,23,20,4,47,0.489,27,0.574,3,1,0.75,1,1,34,13,11,21,15,0.234,0.447,0.319,17.984,26,riffle_clumpy
0,17,27,6,50,0.34,23,0.46,3,3,0.5,3,4,30,20,9,22,19,0.18,0.44,0.38,17.982,27,riffle_clumpy
0,21,28,2,51,0.412,23,0.451,4,1,0.8,4,2,27,24,14,16,21,0.275,0.314,0.412,17.967,28,riffle_clumpy
0,25,19,2,46,0.543,27,0.587,3,3,0.5,1,2,29,17,16,15,15,0.348,0.326,0.326,17.973,29,riffle_clumpy
0,24,18,4,46,0.522,28,0.609,6,2,0.75,2,2,25,21,18,15,13,0.391,0.326,0.283,17.978,30,riffle_clumpy
0,26,21,1,48,0.542,27,0.562,1,2,0.333,3,1,31,17,18,13,17,0.375,0.271,0.354,17.967,31,riffle_clumpy
0,25,21,3,49,0.51,28,0.571,4,2,0.667,1,3,26,23,21,9,19,0.429,0.184,0.388,17.941,32,riffle_clumpy
0,22,18,6,46,0.478,28,0.609,6,0,1.0,4,2,26,20,15,14,17,0.326,0.304,0.37,17.936,33,riffle_clumpy
0,16,27,4,47,0.34,20,0.426,4,2,0.667,1,5,28,19,11,16,20,0.234,0.34,0.426,17.952,34,riffle_clumpy
0,21,26,4,51,0.412,25,0.49,3,5,0.375,2,0,24,27,14,21,16,0.275,0.412,0.314,17.938,35,riffle_clumpy
0,17,25,3,45,0.378,20,0.444,2,2,0.5,2,1,30,15,9,16,20,0.2,0.356,0.444,17.921,36,riffle_clumpy
0,24,20,3,47,0.511,27,0.574,0,2,0.0,2,0,27,20,16,18,13,0.34,0.383,0.277,17.92,37,riffle_clumpy
0,21,26,3,50,0.42,24,0.48,5,1,0.833,3,2,27,23,13,16,21,0.26,0.32,0.42,17.914,38,riffle_clumpy
0,19,20,6,45,0.422,25,0.556,4,1,0.8,1,1,27,18,13,19,13,0.289,0.422,0.289,17.924,39,riffle_clumpy
0,20,23,5,48,0.417,25,0.521,3,5,0.375,1,7,26,22,13,14,21,0.271,0.292,0.438,17.933,40,riffle_clumpy
0,22,24,0,46,0.478,22,0.478,3,1,0.75,2,2,28,18,18,11,17,0.391,0.239,0.37,17.949,41,riffle_clumpy
0,22,22,3,47,0.468,25,0.532,2,2,0.5,1,1,29,18,13,14,20,0.277,0.298,0.426,17.941,42,riffle_clumpy
0,21,20,5,46,0.457,26,0.565,3,0,1.0,4,3,31,15,9,17,20,0.196,0.37,0.435,17.938,43,riffle_clumpy
0,23,17,7,47,0.489,30,0.638,7,1,0.875,2,3,31,16,10,18,19,0.213,0.383,0.404,17.951,44,riffle_clumpy
0,18,25,4,47,0.383,22,0.468,4,0,1.0,1,6,34,13,12,14,21,0.255,0.298,0.447,17.95,45,riffle_clumpy
0,29,16,2,47,0.617,31,0.66,8,1,0.889,2,4,23,24,20,13,14,0.426,0.277,0.298,17.956,46,riffle_clumpy
0,25,21,2,48,0.521,27,0.562,5,4,0.556,2,1,28,20,18,13,17,0.375,0.271,0.354,17.965,47,riffle_clumpy
0,17,30,1,48,0.354,18,0.375,3,1,0.75,3,5,37,11,6,17,25,0.125,0.354,0.521,17.953,48,riffle_clumpy
0,18,27,2,47,0.383,20,0.426,2,2,0.5,1,4,37,10,10,15,22,0.213,0.319,0.468,17.966,49,riffle_clumpy
0,16,26,3,45,0.356,19,0.422,3,4,0.429,3,2,27,18,10,19,16,0.222,0.422,0.356,17.955,50,riffle_clumpy
0,24,21,1,46,0.522,25,0.543,4,2,0.667,3,2,34,12,14,17,15,0.304,0.37,0.326,17.959,51,riffle_clumpy
0,27,20,1,48,0.562,28,0.583,3,2,0.6,5,1,29,19,16,14,18,0.333,0.292,0.375,17.942,52,riffle_clumpy
0,17,23,7,47,0.362,24,0.511,2,3,0.4,2,3,29,18,12,19,16,0.255,0.404,0.34,17.95,53,riffle_clumpy
0,19,25,4,48,0.396,23,0.479,2,1,0.667,1,3,30,18,15,15,18,0.312,0.312,0.375,17.953,54,riffle_clumpy
0,20,23,3,46,0.435,23,0.5,3,3,0.5,1,2,29,17,15,14,17,0.326,0.304,0.37,17.949,55,riffle_clumpy
0,16,28,3,47,0.34,19,0.404,4,1,0.8,2,3,31,16,9,16,22,0.191,0.34,0.468,17.959,56,riffle_clumpy
0,11,30,5,46,0.239,16,0.348,1,0,1.0,1,1,32,14,3,23,20,0.065,0.5,0.435,17.972,57,riffle_clumpy
0,22,25,2,49,0.449,24,0.49,2,2,0.5,2,3,34,15,15,17,17,0.306,0.347,0.347,17.976,58,riffle_clumpy
0,19,24,2,45,0.422,21,0.467,4,2,0.667,0,2,32,13,15,13,17,0.333,0.289,0.378,17.988,59,riffle_clumpy
0,19,28,4,51,0.373,23,0.451,5,4,0.556,1,5,31,20,14,17,20,0.275,0.333,0.392,17.989,60,riffle_clumpy
0,18,25,5,48,0.375,23,0.479,4,6,0.4,2,2,24,24,12,21,15,0.25,0.438,0.312,17.984,61,riffle_clumpy
0,19,18,8,45,0.422,27,0.6,2,2,0.5,3,5,23,22,15,16,14,0.333,0.356,0.311,17.978,62,riffle_clumpy
0,19,24,3,46,0.413,22,0.478,1,3,0.25,2,2,30,16,10,15,21,0.217,0.326,0.457,17.98,63,riffle_clumpy
0,25,19,3,47,0.532,28,0.596,3,2,0.6,3,4,27,20,15,14,18,0.319,0.298,0.383,17.974,64,riffle_clumpy
0,22,26,0,48,0.458,22,0.458,2,2,0.5,2,1,28,20,16,13,19,0.333,0.271,0.396,17.972,65,riffle_clumpy
0,25,20,2,47,0.532,27,0.574,2,2,0.5,2,2,27,20,12,17,18,0.255,0.362,0.383,17.973,66,riffle_clumpy
0,23,20,4,47,0.489,27,0.574,2,0,1.0,2,1,29,18,14,14,19,0.298,0.298,0.404,17.971,67,riffle_clumpy
0,21,25,1,47,0.447,22,0.468,5,3,0.625,3,3,29,18,9,16,22,0.191,0.34,0.468,17.977,68,riffle_clumpy
0,20,25,1,46,0.435,21,0.457,4,3,0.571,1,6,30,16,13,12,21,0.283,0.261,0.457,17.977,69,riffle_clumpy
0,16,24,4,44,0.364,20,0.455,3,2,0.6,2,1,29,15,10,16,18,0.227,0.364,0.409,17.982,70,riffle_clumpy
0,22,21,4,47,0.468,26,0.553,3,0,1.0,5,2,33,14,14,16,17,0.298,0.34,0.362,17.97,71,riffle_clumpy
0,29,22,2,53,0.547,31,0.585,6,2,0.75,2,1,34,19,20,12,21,0.377,0.226,0.396,17.972,72,riffle_clumpy
0,19,25,2,46,0.413,21,0.457,1,3,0.25,4,1,28,18,13,16,17,0.283,0.348,0.37,17.967,73,riffle_clumpy
0,18,24,5,47,0.383,23,0.489,5,0,1.0,3,1,25,22,11,16,20,0.234,0.34,0.426,17.975,74,riffle_clumpy
0,21,27,1,49,0.429,22,0.449,4,4,0.5,4,2,29,20,10,17,22,0.204,0.347,0.449,17.964,75,riffle_clumpy
0,21,28,2,51,0.412,23,0.451,3,2,0.6,4,3,32,19,11,17,23,0.216,0.333,0.451,17.959,76,riffle_clumpy
0,20,27,2,49,0.408,22,0.449,4,2,0.667,2,1,25,24,11,15,23,0.224,0.306,0.469,17.956,77,riffle_clumpy
0,22,23,1,46,0.478,23,0.5,3,2,0.6,3,2,31,15,14,11,21,0.304,0.239,0.457,17.956,78,riffle_clumpy
0,11,26,9,46,0.239,20,0.435,1,1,0.5,0,1,30,16,8,20,18,0.174,0.435,0.391,17.967,79,riffle_clumpy
0,19,25,4,48,0.396,23,0.479,5,4,0.556,3,1,28,20,10,18,20,0.208,0.375,0.417,17.966,80,riffle_clumpy
0,23,25,1,49,0.469,24,0.49,2,3,0.4,1,2,33,16,13,19,17,0.265,0.388,0.347,17.966,81,riffle_clumpy
0,22,20,6,48,0.458,28,0.583,4,1,0.8,4,1,31,17,16,15,17,0.333,0.312,0.354,17.966,82,riffle_clumpy
0,15,26,6,47,0.319,21,0.447,4,1,0.8,2,3,35,12,8,16,23,0.17,0.34,0.489,17.964,83,riffle_clumpy
0,27,19,2,48,0.562,29,0.604,3,3,0.5,3,1,26,22,14,22,12,0.292,0.458,0.25,17.96,84,riffle_clumpy
0,16,27,3,46,0.348,19,0.413,2,3,0.4,2,3,32,14,9,18,19,0.196,0.391,0.413,17.964,85,riffle_clumpy
0,16,28,3,47,0.34,19,0.404,3,4,0.429,1,1,28,19,8,20,19,0.17,0.426,0.404,17.97,86,riffle_clumpy
0,20,18,7,45,0.444,27,0.6,1,4,0.2,2,0,27,18,11,16,18,0.244,0.356,0.4,17.967,87,riffle_clumpy
0,20,23,2,45,0.444,22,0.489,1,3,0.25,3,2,29,16,12,18,15,0.267,0.4,0.333,17.962,88,riffle_clumpy
0,26,18,2,46,0.565,28,0.609,3,2,0.6,3,3,23,23,15,15,16,0.326,0.326,0.348,17.955,89,riffle_clumpy
0,20,22,4,46,0.435,24,0.522,4,1,0.8,1,1,23,23,14,18,14,0.304,0.391,0.304,17.967,90,riffle_clumpy
0,27,18,1,46,0.587,28,0.609,4,3,0.571,5,1,29,17,18,13,15,0.391,0.283,0.326,17.968,91,riffle_clumpy
0,18,26,4,48,0.375,22,0.458,3,4,0.429,4,2,30,18,9,21,18,0.188,0.438,0.375,17.976,92,riffle_clumpy
0,24,19,2,45,0.533,26,0.578,8,1,0.889,2,2,24,21,13,17,15,0.289,0.378,0.333,17.976,93,riffle_clumpy
0,19,27,3,49,0.388,22,0.449,4,5,0.444,2,5,30,19,12,18,19,0.245,0.367,0.388,17.974,94,riffle_clumpy
0,22,22,5,49,0.449,27,0.551,3,1,0.75,1,2,31,18,12,15,22,0.245,0.306,0.449,17.971,95,riffle_clumpy
0,18,23,3,44,0.409,21,0.477,3,3,0.5,1,2,20,24,10,21,13,0.227,0.477,0.295,17.97,96,riffle_clumpy
0,14,27,6,47,0.298,20,0.426,4,2,0.667,1,3,30,17,8,21,18,0.17,0.447,0.383,18.419,1,riffle_clumpy
0,19,27,2,48,0.396,21,0.438,2,6,0.25,3,2,25,23,10,16,22,0.208,0.333,0.458,17.812,2,riffle_clumpy
0,17,26,3,46,0.37,20,0.435,1,4,0.2,1,3,30,16,14,15,17,0.304,0.326,0.37,17.933,3,riffle_clumpy
0,20,19,10,49,0.408,30,0.612,5,2,0.714,1,1,28,21,13,13,23,0.265,0.265,0.469,17.942,4,riffle_clumpy
0,20,19,7,46,0.435,27,0.587,1,0,1.0,3,3,28,18,14,16,16,0.304,0.348,0.348,17.932,5,riffle_clumpy
0,18,23,5,46,0.391,23,0.5,4,3,0.571,2,3,27,19,9,19,18,0.196,0.413,0.391,17.966,6,riffle_clumpy
0,16,30,3,49,0.327,19,0.388,1,1,0.5,2,0,27,22,10,17,22,0.204,0.347,0.449,17.976,7,riffle_clumpy
0,23,21,4,48,0.479,27,0.562,6,1,0.857,2,1,29,19,10,14,24,0.208,0.292,0.5,17.907,8,riffle_clumpy
0,18,26,2,46,0.391,20,0.435,4,4,0.5,2,2,29,17,12,12,22,0.261,0.261,0.478,17.892,9,riffle_clumpy
0,20,22,3,45,0.444,23,0.511,1,3,0.25,1,3,27,18,14,16,15,0.311,0.356,0.333,17.927,10,riffle_clumpy
0,20,25,3,48,0.417,23,0.479,2,3,0.4,2,2,33,15,12,16,20,0.25,0.333,0.417,17.958,11,riffle_clumpy
0,20,21,7,48,0.417,27,0.562,1,3,0.25,4,3,33,15,11,18,19,0.229,0.375,0.396,17.97,12,riffle_clumpy
0,20,26,1,47,0.426,21,0.447,5,3,0.625,2,2,26,21,12,16,19,0.255,0.34,0.404,17.982,13,riffle_clumpy
0,17,27,5,49,0.347,22,0.449,2,4,0.333,3,0,25,24,9,27,13,0.184,0.551,0.265,18.026,14,riffle_clumpy
0,19,26,5,50,0.38,24,0.48,4,3,0.571,5,3,33,17,7,19,24,0.14,0.38,0.48,18.024,15,riffle_clumpy
0,18,23,3,44,0.409,21,0.477,2,2,0.5,0,2,33,11,13,14,17,0.295,0.318,0.386,18.053,16,riffle_clumpy
0,19,25,6,50,0.38,25,0.5,4,3,0.571,2,3,30,20,6,20,24,0.12,0.4,0.48,18.055,17,riffle_clumpy
0,20,22,3,45,0.444,23,0.511,2,1,0.667,2,4,31,14,12,15,18,0.267,0.333,0.4,18.062,18,riffle_clumpy
0,21,26,2,49,0.429,23,0.469,6,1,0.857,3,2,28,21,11,18,20,0.224,0.367,0.408,18.064,19,riffle_clumpy
0,22,25,2,49,0.449,24,0.49,1,5,0.167,2,3,26,23,15,18,16,0.306,0.367,0.327,18.087,20,riffle_clumpy
0,21,16,8,45,0.467,29,0.644,5,1,0.833,3,2,26,19,13,18,14,0.289,0.4,0.311,18.108,21,riffle_clumpy
0,24,18,3,45,0.533,27,0.6,6,2,0.75,2,1,28,17,12,15,18,0.267,0.333,0.4,18.1,22,riffle_clumpy
0,20,22,4,46,0.435,24,0.522,1,2,0.333,5,3,32,14,12,13,21,0.261,0.283,0.457,18.071,23,riffle_clumpy
0,24,20,1,45,0.533,25,0.556,3,2,0.6,2,2,24,21,14,15,16,0.311,0.333,0.356,18.062,24,riffle_clumpy
0,20,24,3,47,0.426,23,0.489,3,1,0.75,3,3,30,17,12,15,20,0.255,0.319,0.426,18.061,25,riffle_clumpy
0,24,20,3,47,0.511,27,0.574,4,2,0.667,3,3,25,22,14,15,18,0.298,0.319,0.383,18.062,26,riffle_clumpy
0,19,26,1,46,0.413,20,0.435,3,1,0.75,3,1,25,21,15,18,13,0.326,0.391,0.283,18.065,27,riffle_clumpy
0,21,21,4,46,0.457,25,0.543,6,2,0.75,2,2,26,20,11,19,16,0.239,0.413,0.348,18.074,28,riffle_clumpy
0,26,22,1,49,0.531,27,0.551,0,1,0.0,4,2,29,20,13,21,15,0.265,0.429,0.306,18.071,29,riffle_clumpy
0,20,21,6,47,0.426,26,0.553,4,1,0.8,3,3,31,16,14,14,19,0.298,0.298,0.404,18.054,30,riffle_clumpy
0,21,24,2,47,0.447,23,0.489,3,1,0.75,4,2,28,19,11,14,22,0.234,0.298,0.468,18.042,31,riffle_clumpy
0,25,17,4,46,0.543,29,0.63,5,0,1.0,3,1,29,17,18,11,17,0.391,0.239,0.37,18.033,32,riffle_clumpy
0,17,32,2,51,0.333,19,0.373,5,1,0.833,3,2,34,17,7,18,26,0.137,0.353,0.51,18.031,33,riffle_clumpy
0,21,25,3,49,0.429,24,0.49,0,4,0.0,3,2,28,21,13,19,17,0.265,0.388,0.347,18.041,34,riffle_clumpy
0,21,22,2,45,0.467,23,0.511,3,0,1.0,1,2,30,15,15,17,13,0.333,0.378,0.289,18.048,35,riffle_clumpy
0,16,25,5,46,0.348,21,0.457,1,2,0.333,2,4,25,21,10,14,22,0.217,0.304,0.478,18.038,36,riffle_clumpy
0,27,16,2,45,0.6,29,0.644,6,2,0.75,4,3,28,17,14,13,18,0.311,0.289,0.4,18.033,37,riffle_clumpy
0,21,23,2,46,0.457,23,0.5,2,1,0.667,4,3,29,17,13,12,21,0.283,0.261,0.457,18.013,38,riffle_clumpy
0,28,14,2,44,0.636,30,0.682,5,0,1.0,0,0,25,19,18,18,8,0.409,0.409,0.182,18.015,39,riffle_clumpy
0,23,21,1,45,0.511,24,0.533,4,3,0.571,3,1,27,18,13,16,16,0.289,0.356,0.356,18.016,40,riffle_clumpy
0,18,29,3,50,0.36,21,0.42,3,0,1.0,0,4,27,23,12,21,17,0.24,0.42,0.34,18.03,41,riffle_clumpy
0,15,27,5,47,0.319,20,0.426,5,1,0.833,1,1,31,16,9,17,21,0.191,0.362,0.447,18.049,42,riffle_clumpy
0,18,28,2,48,0.375,20,0.417,2,4,0.333,4,3,26,22,10,17,21,0.208,0.354,0.438,18.041,43,riffle_clumpy
0,17,26,4,47,0.362,21,0.447,4,2,0.667,3,5,29,18,11,18,18,0.234,0.383,0.383,18.038,44,riffle_clumpy
0,22,21,2,45,0.489,24,0.533,4,3,0.571,2,2,26,19,14,16,15,0.311,0.356,0.333,18.035,45,riffle_clumpy
0,25,18,1,44,0.568,26,0.591,2,1,0.667,2,1,30,14,17,12,15,0.386,0.273,0.341,18.038,46,riffle_clumpy
0,14,30,3,47,0.298,17,0.362,2,1,0.667,3,0,32,15,8,13,26,0.17,0.277,0.553,18.011,47,riffle_clumpy
0,19,22,5,46,0.413,24,0.522,3,1,0.75,1,3,26,20,12,16,18,0.261,0.348,0.391,18.016,48,riffle_clumpy
0,24,17,7,48,0.5,31,0.646,2,1,0.667,3,2,32,16,16,9,23,0.333,0.188,0.479,18.001,49,riffle_clumpy
0,17,26,3,46,0.37,20,0.435,2,3,0.4,2,3,29,17,11,16,19,0.239,0.348,0.413,18.008,50,riffle_clumpy
0,15,31,1,47,0.319,16,0.34,2,2,0.5,1,3,28,19,9,19,19,0.191,0.404,0.404,18.019,51,riffle_clumpy
0,18,28,3,49,0.367,21,0.429,3,1,0.75,2,5,27,22,13,17,19,0.265,0.347,0.388,18.03,52,riffle_clumpy
0,19,23,6,48,0.396,25,0.521,1,2,0.333,1,2,32,16,12,19,17,0.25,0.396,0.354,18.033,53,riffle_clumpy
0,14,30,3,47,0.298,17,0.362,6,2,0.75,1,1,25,22,9,20,18,0.191,0.426,0.383,18.036,54,riffle_clumpy
0,28,17,4,49,0.571,32,0.653,8,4,0.667,3,2,23,26,19,15,15,0.388,0.306,0.306,18.028,55,riffle_clumpy
0,23,24,2,49,0.469,25,0.51,4,5,0.444,1,1,27,22,11,21,17,0.224,0.429,0.347,18.024,56,riffle_clumpy
0,22,24,1,47,0.468,23,0.489,6,2,0.75,3,2,24,23,17,13,17,0.362,0.277,0.362,18.027,57,riffle_clumpy
0,17,26,6,49,0.347,23,0.469,3,2,0.6,3,2,34,15,7,14,28,0.143,0.286,0.571,18.018,58,riffle_clumpy
0,23,20,3,46,0.5,26,0.565,4,1,0.8,5,0,24,22,11,18,17,0.239,0.391,0.37,18.017,59,riffle_clumpy
0,21,21,3,45,0.467,24,0.533,5,4,0.556,1,5,28,17,14,16,15,0.311,0.356,0.333,18.023,60,riffle_clumpy
0,22,19,6,47,0.468,28,0.596,8,3,0.727,2,0,28,19,13,14,20,0.277,0.298,0.426,18.035,61,riffle_clumpy
0,16,32,2,50,0.32,18,0.36,4,2,0.667,4,2,36,14,8,15,27,0.16,0.3,0.54,18.035,62,riffle_clumpy
0,18,26,1,45,0.4,19,0.422,1,3,0.25,0,4,31,14,13,15,17,0.289,0.333,0.378,18.037,63,riffle_clumpy
0,20,22,5,47,0.426,25,0.532,4,2,0.667,1,1,32,15,14,13,20,0.298,0.277,0.426,18.039,64,riffle_clumpy
0,21,22,3,46,0.457,24,0.522,2,0,1.0,1,3,25,21,14,16,16,0.304,0.348,0.348,18.044,65,riffle_clumpy
0,20,24,4,48,0.417,24,0.5,3,4,0.429,2,3,30,18,12,16,20,0.25,0.333,0.417,18.046,66,riffle_clumpy
0,17,27,2,46,0.37,19,0.413,4,4,0.5,0,2,28,18,9,17,20,0.196,0.37,0.435,18.057,67,riffle_clumpy
0,15,29,5,49,0.306,20,0.408,3,4,0.429,0,3,30,19,9,18,22,0.184,0.367,0.449,18.065,68,riffle_clumpy
0,25,21,1,47,0.532,26,0.553,6,1,0.857,2,3,28,19,17,14,16,0.362,0.298,0.34,18.067,69,riffle_clumpy
0,19,28,1,48,0.396,20,0.417,1,2,0.333,4,2,28,20,13,19,16,0.271,0.396,0.333,18.058,70,riffle_clumpy
0,20,25,4,49,0.408,24,0.49,1,5,0.167,3,3,28,21,8,20,21,0.163,0.408,0.429,18.046,71,riffle_clumpy
0,23,25,2,50,0.46,25,0.5,4,1,0.8,0,2,26,24,13,19,18,0.26,0.38,0.36,18.048,72,riffle_clumpy
0,15,24,7,46,0.326,22,0.478,2,3,0.4,3,1,27,19,6,21,19,0.13,0.457,0.413,18.043,73,riffle_clumpy
0,17,25,5,47,0.362,22,0.468,5,2,0.714,1,0,31,16,14,17,16,0.298,0.362,0.34,18.05,74,riffle_clumpy
0,26,18,2,46,0.565,28,0.609,4,0,1.0,3,0,21,25,17,17,12,0.37,0.37,0.261,18.053,75,riffle_clumpy
0,16,26,4,46,0.348,20,0.435,2,1,0.667,1,1,29,17,11,19,16,0.239,0.413,0.348,18.064,76,riffle_clumpy
0,20,23,5,48,0.417,25,0.521,1,1,0.5,3,2,34,14,13,13,22,0.271,0.271,0.458,18.069,77,riffle_clumpy
0,26,17,5,48,0.542,31,0.646,5,2,0.714,3,0,27,21,15,14,19,0.312,0.292,0.396,18.069,78,riffle_clumpy
0,26,20,2,48,0.542,28,0.583,4,0,1.0,3,2,28,20,13,18,17,0.271,0.375,0.354,18.059,79,riffle_clumpy
0,24,21,3,48,0.5,27,0.562,5,2,0.714,2,4,27,21,17,14,17,0.354,0.292,0.354,18.066,80,riffle_clumpy
0,23,23,2,48,0.479,25,0.521,5,4,0.556,1,5,24,24,14,14,20,0.292,0.292,0.417,18.064,81,riffle_clumpy
0,23,23,1,47,0.489,24,0.511,3,3,0.5,5,1,31,16,13,14,20,0.277,0.298,0.426,18.064,82,riffle_clumpy
0,23,21,2,46,0.5,25,0.543,2,2,0.5,3,3,26,20,19,11,16,0.413,0.239,0.348,18.062,83,riffle_clumpy
0,20,25,3,48,0.417,23,0.479,4,1,0.8,1,4,29,19,16,13,19,0.333,0.271,0.396,18.065,84,riffle_clumpy
0,18,26,4,48,0.375,22,0.458,4,4,0.5,3,2,33,15,12,13,23,0.25,0.271,0.479,18.067,85,riffle_clumpy
0,23,23,1,47,0.489,24,0.511,4,3,0.571,2,0,32,15,12,16,19,0.255,0.34,0.404,18.071,86,riffle_clumpy
0,16,29,2,47,0.34,18,0.383,0,1,0.0,1,1,29,18,13,17,17,0.277,0.362,0.362,18.075,87,riffle_clumpy
0,21,24,3,48,0.438,24,0.5,3,5,0.375,6,2,29,19,11,18,19,0.229,0.375,0.396,18.071,88,riffle_clumpy
0,20,22,3,45,0.444,23,0.511,1,5,0.167,1,1,27,18,15,16,14,0.333,0.356,0.311,18.076,89,riffle_clumpy
0,20,26,4,50,0.4,24,0.48,2,4,0.333,1,1,28,22,15,16,19,0.3,0.32,0.38,18.077,90,riffle_clumpy
0,14,27,5,46,0.304,19,0.413,1,1,0.5,3,2,30,16,9,16,21,0.196,0.348,0.457,18.071,91,riffle_clumpy
0,18,24,8,50,0.36,26,0.52,4,5,0.444,1,1,29,21,8,20,22,0.16,0.4,0.44,18.073,92,riffle_clumpy
0,22,22,4,48,0.458,26,0.542,1,3,0.25,4,3,31,17,15,14,19,0.312,0.292,0.396,18.065,93,riffle_clumpy
0,15,30,3,48,0.312,18,0.375,3,3,0.5,3,3,30,18,10,19,19,0.208,0.396,0.396,18.062,94,riffle_clumpy
0,20,22,3,45,0.444,23,0.511,2,2,0.5,1,3,29,16,18,14,13,0.4,0.311,0.289,18.065,95,riffle_clumpy
0,20,22,3,45,0.444,23,0.511,3,4,0.429,2,2,24,21,11,15,19,0.244,0.333,0.422,18.067,96,riffle_clumpy
0,17,29,2,48,0.354,19,0.396,0,4,0.0,1,3,32,16,7,16,25,0.146,0.333,0.521,18.514,1,riffle_clumpy
0,18,28,2,48,0.375,20,0.417,3,4,0.429,1,2,29,19,13,14,21,0.271,0.292,0.438,18.5,2,riffle_clumpy
0,17,21,8,46,0.37,25,0.543,3,3,0.5,1,1,26,20,10,16,20,0.217,0.348,0.435,18.404,3,riffle_clumpy
0,20,24,3,47,0.426,23,0.489,2,2,0.5,1,2,35,12,9,18,20,0.191,0.383,0.426,18.25,4,riffle_clumpy
0,23,20,7,50,0.46,30,0.6,3,4,0.429,0,0,25,25,17,21,12,0.34,0.42,0.24,18.158,5,riffle_clumpy
0,18,26,3,47,0.383,21,0.447,3,1,0.75,3,1,29,18,11,16,20,0.234,0.34,0.426,18.078,6,riffle_clumpy
0,20,26,2,48,0.417,22,0.458,4,4,0.5,3,1,28,20,12,19,17,0.25,0.396,0.354,18.029,7,riffle_clumpy
0,21,20,4,45,0.467,25,0.556,1,2,0.333,3,1,31,14,11,19,15,0.244,0.422,0.333,18.054,8,riffle_clumpy
0,18,29,1,48,0.375,19,0.396,2,2,0.5,4,2,34,14,9,19,20,0.188,0.396,0.417,18.052,9,riffle_clumpy
0,17,27,4,48,0.354,21,0.438,3,2,0.6,2,1,24,24,13,17,18,0.271,0.354,0.375,18.063,10,riffle_clumpy
0,16,26,6,48,0.333,22,0.458,6,3,0.667,1,5,31,17,9,19,20,0.188,0.396,0.417,18.082,11,riffle_clumpy
0,19,23,5,47,0.404,24,0.511,3,1,0.75,1,2,28,19,11,15,21,0.234,0.319,0.447,18.083,12,riffle_clumpy
0,17,23,10,50,0.34,27,0.54,7,2,0.778,1,0,31,19,10,23,17,0.2,0.46,0.34,18.095,13,riffle_clumpy
0,22,20,3,45,0.489,25,0.556,6,1,0.857,2,1,27,18,15,16,14,0.333,0.356,0.311,18.082,14,riffle_clumpy
0,16,26,4,46,0.348,20,0.435,3,5,0.375,2,3,25,21,9,19,18,0.196,0.413,0.391,18.07,15,riffle_clumpy
0,17,26,3,46,0.37,20,0.435,2,3,0.4,2,6,29,17,10,16,20,0.217,0.348,0.435,18.091,16,riffle_clumpy
0,22,26,1,49,0.449,23,0.469,2,2,0.5,3,7,32,17,14,17,18,0.286,0.347,0.367,18.042,17,riffle_clumpy
0,17,24,3,44,0.386,20,0.455,3,1,0.75,1,2,26,18,11,17,16,0.25,0.386,0.364,18.041,18,riffle_clumpy
0,22,17,4,43,0.512,26,0.605,3,1,0.75,0,1,22,21,16,18,9,0.372,0.419,0.209,18.063,19,riffle_clumpy
0,23,22,1,46,0.5,24,0.522,5,0,1.0,3,2,31,15,17,11,18,0.37,0.239,0.391,18.054,20,riffle_clumpy
0,17,26,3,46,0.37,20,0.435,3,2,0.6,2,3,31,15,10,15,21,0.217,0.326,0.457,18.061,21,riffle_clumpy
0,11,33,1,45,0.244,12,0.267,1,3,0.25,0,3,31,14,9,17,19,0.2,0.378,0.422,18.089,22,riffle_clumpy
0,23,23,6,52,0.442,29,0.558,1,0,1.0,2,3,36,16,9,21,22,0.173,0.404,0.423,18.1,23,riffle_clumpy
0,24,21,3,48,0.5,27,0.562,1,2,0.333,3,2,33,15,11,14,23,0.229,0.292,0.479,18.098,24,riffle_clumpy
0,15,27,5,47,0.319,20,0.426,2,2,0.5,1,3,31,16,8,20,19,0.17,0.426,0.404,18.106,25,riffle_clumpy
0,20,25,3,48,0.417,23,0.479,2,3,0.4,5,3,29,19,10,17,21,0.208,0.354,0.438,18.093,26,riffle_clumpy
0,17,24,5,46,0.37,22,0.478,2,3,0.4,0,2,29,17,12,17,17,0.261,0.37,0.37,18.111,27,riffle_clumpy
0,20,25,1,46,0.435,21,0.457,2,3,0.4,0,2,31,15,12,16,18,0.261,0.348,0.391,18.127,28,riffle_clumpy
0,24,25,1,50,0.48,25,0.5,4,0,1.0,3,2,31,19,11,20,19,0.22,0.4,0.38,18.125,29,riffle_clumpy
0,17,25,3,45,0.378,20,0.444,2,2,0.5,2,4,26,19,10,21,14,0.222,0.467,0.311,18.123,30,riffle_clumpy
0,18,25,4,47,0.383,22,0.468,1,2,0.333,2,4,29,18,10,16,21,0.213,0.34,0.447,18.092,31,riffle_clumpy
0,27,17,1,45,0.6,28,0.622,2,2,0.5,4,1,29,16,16,9,20,0.356,0.2,0.444,18.073,32,riffle_clumpy
0,28,20,2,50,0.56,30,0.6,2,1,0.667,3,5,28,22,14,14,22,0.28,0.28,0.44,18.049,33,riffle_clumpy
0,14,30,3,47,0.298,17,0.362,2,3,0.4,3,3,31,16,9,15,23,0.191,0.319,0.489,18.046,34,riffle_clumpy
0,16,29,1,46,0.348,17,0.37,2,1,0.667,2,1,27,19,12,15,19,0.261,0.326,0.413,18.056,35,riffle_clumpy
0,19,23,5,47,0.404,24,0.511,4,2,0.667,2,3,29,18,13,15,19,0.277,0.319,0.404,18.056,36,riffle_clumpy
0,22,23,3,48,0.458,25,0.521,7,3,0.7,2,4,29,19,13,15,20,0.271,0.312,0.417,18.066,37,riffle_clumpy
0,19,22,4,45,0.422,23,0.511,6,1,0.857,2,3,25,20,13,18,14,0.289,0.4,0.311,18.067,38,riffle_clumpy
0,25,20,0,45,0.556,25,0.556,6,1,0.857,3,1,30,15,13,17,15,0.289,0.378,0.333,18.059,39,riffle_clumpy
0,16,27,3,46,0.348,19,0.413,1,2,0.333,1,2,31,15,11,14,21,0.239,0.304,0.457,18.051,40,riffle_clumpy
0,19,24,2,45,0.422,21,0.467,0,2,0.0,2,0,29,16,8,16,21,0.178,0.356,0.467,18.049,41,riffle_clumpy
0,20,23,2,45,0.444,22,0.489,1,2,0.333,2,1,26,19,14,15,16,0.311,0.333,0.356,18.034,42,riffle_clumpy
0,17,30,6,53,0.321,23,0.434,3,2,0.6,3,5,36,17,7,19,27,0.132,0.358,0.509,18.024,43,riffle_clumpy
0,19,25,4,48,0.396,23,0.479,3,1,0.75,1,3,32,16,8,17,23,0.167,0.354,0.479,18.02,44,riffle_clumpy
0,18,26,2,46,0.391,20,0.435,1,3,0.25,1,1,27,19,15,16,15,0.326,0.348,0.326,18.028,45,riffle_clumpy
0,21,22,5,48,0.438,26,0.542,1,2,0.333,2,3,27,21,13,14,21,0.271,0.292,0.438,18.025,46,riffle_clumpy
0,20,24,4,48,0.417,24,0.5,3,1,0.75,1,1,30,18,15,14,19,0.312,0.292,0.396,18.023,47,riffle_clumpy
0,21,25,1,47,0.447,22,0.468,4,0,1.0,2,3,30,17,12,16,19,0.255,0.34,0.404,18.022,48,riffle_clumpy
0,20,24,5,49,0.408,25,0.51,3,2,0.6,4,0,24,25,10,24,15,0.204,0.49,0.306,18.034,49,riffle_clumpy
0,21,24,1,46,0.457,22,0.478,2,0,1.0,1,2,29,17,13,17,16,0.283,0.37,0.348,18.03,50,riffle_clumpy
0,18,25,3,46,0.391,21,0.457,3,1,0.75,1,2,27,19,13,16,17,0.283,0.348,0.37,18.031,51,riffle_clumpy
0,23,21,2,46,0.5,25,0.543,3,1,0.75,2,1,29,17,14,15,17,0.304,0.326,0.37,18.032,52,riffle_clumpy
0,20,22,5,47,0.426,25,0.532,5,1,0.833,3,2,33,14,11,8,28,0.234,0.17,0.596,18.019,53,riffle_clumpy
0,25,18,3,46,0.543,28,0.609,5,3,0.625,3,2,31,15,13,12,21,0.283,0.261,0.457,18.021,54,riffle_clumpy
0,25,15,5,45,0.556,30,0.667,1,5,0.167,3,1,19,26,17,15,13,0.378,0.333,0.289,18.018,55,riffle_clumpy
0,19,24,4,47,0.404,23,0.489,2,2,0.5,4,3,28,19,13,13,21,0.277,0.277,0.447,18.015,56,riffle_clumpy
0,17,28,3,48,0.354,20,0.417,2,5,0.286,2,4,28,20,12,22,14,0.25,0.458,0.292,18.027,57,riffle_clumpy
0,18,22,6,46,0.391,24,0.522,3,1,0.75,3,1,28,18,10,15,21,0.217,0.326,0.457,18.024,58,riffle_clumpy
0,18,30,2,50,0.36,20,0.4,8,1,0.889,1,4,34,16,12,13,25,0.24,0.26,0.5,18.035,59,riffle_clumpy
0,20,18,8,46,0.435,28,0.609,2,3,0.4,0,2,26,20,12,22,12,0.261,0.478,0.261,18.037,60,riffle_clumpy
0,21,24,6,51,0.412,27,0.529,1,2,0.333,4,1,32,19,10,19,22,0.196,0.373,0.431,18.03,61,riffle_clumpy
0,25,20,2,47,0.532,27,0.574,2,0,1.0,3,3,30,17,15,10,22,0.319,0.213,0.468,18.027,62,riffle_clumpy
0,23,22,1,46,0.5,24,0.522,3,3,0.5,3,1,29,17,14,13,19,0.304,0.283,0.413,18.027,63,riffle_clumpy
0,26,16,1,43,0.605,27,0.628,7,1,0.875,4,2,23,20,17,13,13,0.395,0.302,0.302,18.012,64,riffle_clumpy
0,24,26,2,52,0.462,26,0.5,6,4,0.6,2,1,27,25,11,21,20,0.212,0.404,0.385,18.018,65,riffle_clumpy
0,20,24,1,45,0.444,21,0.467,3,5,0.375,3,3,28,17,10,14,21,0.222,0.311,0.467,18.018,66,riffle_clumpy
0,20,23,4,47,0.426,24,0.511,5,2,0.714,1,6,32,15,9,14,24,0.191,0.298,0.511,18.022,67,riffle_clumpy
0,17,27,3,47,0.362,20,0.426,4,3,0.571,3,3,29,18,8,16,23,0.17,0.34,0.489,18.027,68,riffle_clumpy
0,19,25,2,46,0.413,21,0.457,6,2,0.75,1,5,26,20,14,16,16,0.304,0.348,0.348,18.036,69,riffle_clumpy
0,22,20,2,44,0.5,24,0.545,3,3,0.5,0,2,22,22,16,17,11,0.364,0.386,0.25,18.043,70,riffle_clumpy
0,20,25,2,47,0.426,22,0.468,2,2,0.5,2,1,33,14,11,13,23,0.234,0.277,0.489,18.05,71,riffle_clumpy
0,20,29,1,50,0.4,21,0.42,4,1,0.8,5,4,27,23,12,16,22,0.24,0.32,0.44,18.037,72,riffle_clumpy
0,21,23,3,47,0.447,24,0.511,5,2,0.714,2,2,26,21,13,13,21,0.277,0.277,0.447,18.037,73,riffle_clumpy
0,21,27,3,51,0.412,24,0.471,2,0,1.0,3,1,24,27,13,21,17,0.255,0.412,0.333,18.031,74,riffle_clumpy
0,27,13,5,45,0.6,32,0.711,4,1,0.8,1,0,26,19,17,14,14,0.378,0.311,0.311,18.03,75,riffle_clumpy
0,22,21,6,49,0.449,28,0.571,5,3,0.625,1,4,32,17,16,14,19,0.327,0.286,0.388,18.041,76,riffle_clumpy
0,18,25,5,48,0.375,23,0.479,1,1,0.5,3,2,31,17,8,15,25,0.167,0.312,0.521,18.036,77,riffle_clumpy
0,25,11,7,43,0.581,32,0.744,0,0,0,1,1,28,15,16,13,14,0.372,0.302,0.326,18.04,78,riffle_clumpy
0,25,20,2,47,0.532,27,0.574,3,3,0.5,2,3,28,19,17,11,19,0.362,0.234,0.404,18.041,79,riffle_clumpy
0,23,23,1,47,0.489,24,0.511,3,2,0.6,0,4,29,18,12,20,15,0.255,0.426,0.319,18.043,80,riffle_clumpy
0,22,23,2,47,0.468,24,0.511,4,2,0.667,0,3,29,18,13,11,23,0.277,0.234,0.489,18.04,81,riffle_clumpy
0,15,27,7,49,0.306,22,0.449,2,1,0.667,4,3,38,11,9,14,26,0.184,0.286,0.531,18.033,82,riffle_clumpy
0,24,21,6,51,0.471,30,0.588,3,4,0.429,5,2,29,22,12,15,24,0.235,0.294,0.471,18.029,83,riffle_clumpy
0,16,26,6,48,0.333,22,0.458,1,3,0.25,1,3,33,15,12,15,21,0.25,0.312,0.438,18.035,84,riffle_clumpy
0,23,22,3,48,0.479,26,0.542,2,2,0.5,2,3,27,21,13,20,15,0.271,0.417,0.312,18.037,85,riffle_clumpy
0,24,23,4,51,0.471,28,0.549,4,3,0.571,2,0,30,21,14,19,18,0.275,0.373,0.353,18.039,86,riffle_clumpy
0,20,26,5,51,0.392,25,0.49,5,0,1.0,3,4,31,20,10,18,23,0.196,0.353,0.451,18.035,87,riffle_clumpy
0,20,27,0,47,0.426,20,0.426,3,1,0.75,2,3,37,10,11,15,21,0.234,0.319,0.447,18.037,88,riffle_clumpy
0,22,21,2,45,0.489,24,0.533,4,1,0.8,1,2,27,18,16,17,12,0.356,0.378,0.267,18.042,89,riffle_clumpy
0,20,23,5,48,0.417,25,0.521,1,4,0.2,1,5,25,23,12,17,19,0.25,0.354,0.396,18.043,90,riffle_clumpy
0,18,26,4,48,0.375,22,0.458,3,3,0.5,4,4,32,16,8,19,21,0.167,0.396,0.438,18.044,91,riffle_clumpy
0,14,29,5,48,0.292,19,0.396,1,8,0.111,1,4,26,22,8,22,18,0.167,0.458,0.375,18.046,92,riffle_clumpy
0,18,29,2,49,0.367,20,0.408,3,1,0.75,3,4,31,18,8,18,23,0.163,0.367,0.469,18.043,93,riffle_clumpy
0,23,20,4,47,0.489,27,0.574,3,1,0.75,4,1,27,20,14,18,15,0.298,0.383,0.319,18.04,94,riffle_clumpy
0,29,16,1,46,0.63,30,0.652,4,1,0.8,2,1,25,21,20,12,14,0.435,0.261,0.304,18.037,95,riffle_clumpy
0,19,23,4,46,0.413,23,0.5,2,4,0.333,3,1,29,17,9,18,19,0.196,0.391,0.413,18.034,96,riffle_clumpy
0,22,21,4,47,0.468,26,0.553,6,3,0.667,1,0,29,18,13,14,20,0.277,0.298,0.426,17.312,1,riffle_clumpy
0,15,20,10,45,0.333,25,0.556,5,3,0.625,1,3,29,16,8,16,21,0.178,0.356,0.467,18.0,2,riffle_clumpy
0,18,24,8,50,0.36,26,0.52,0,0,0,4,2,32,18,6,15,29,0.12,0.3,0.58,17.912,3,riffle_clumpy
0,22,24,1,47,0.468,23,0.489,2,1,0.667,2,1,26,21,15,16,16,0.319,0.34,0.34,17.927,4,riffle_clumpy
0,20,25,3,48,0.417,23,0.479,2,1,0.667,1,4,32,16,14,14,20,0.292,0.292,0.417,17.98,5,riffle_clumpy
0,16,29,3,48,0.333,19,0.396,4,4,0.5,1,3,34,14,11,17,20,0.229,0.354,0.417,18.062,6,riffle_clumpy
0,22,23,2,47,0.468,24,0.511,4,2,0.667,2,0,29,18,16,13,18,0.34,0.277,0.383,17.961,7,riffle_clumpy
0,21,26,0,47,0.447,21,0.447,3,0,1.0,4,2,26,21,15,12,20,0.319,0.255,0.426,17.891,8,riffle_clumpy
0,11,31,3,45,0.244,14,0.311,4,1,0.8,0,5,37,8,11,15,19,0.244,0.333,0.422,17.898,9,riffle_clumpy
0,19,22,4,45,0.422,23,0.511,4,2,0.667,3,2,22,23,12,22,11,0.267,0.489,0.244,17.915,10,riffle_clumpy
0,18,27,3,48,0.375,21,0.438,3,3,0.5,4,4,30,18,7,18,23,0.146,0.375,0.479,17.917,11,riffle_clumpy
0,15,29,4,48,0.312,19,0.396,3,3,0.5,4,4,27,21,7,17,24,0.146,0.354,0.5,17.934,12,riffle_clumpy
0,16,29,4,49,0.327,20,0.408,4,2,0.667,2,5,30,19,9,19,21,0.184,0.388,0.429,17.966,13,riffle_clumpy
0,19,25,7,51,0.373,26,0.51,1,1,0.5,2,1,29,22,9,22,20,0.176,0.431,0.392,17.956,14,riffle_clumpy
0,19,26,3,48,0.396,22,0.458,2,1,0.667,1,4,34,14,11,17,20,0.229,0.354,0.417,17.991,15,riffle_clumpy
0,21,20,7,48,0.438,28,0.583,2,2,0.5,0,2,29,19,12,11,25,0.25,0.229,0.521,17.987,16,riffle_clumpy
0,19,23,3,45,0.422,22,0.489,2,3,0.4,2,4,30,15,15,11,19,0.333,0.244,0.422,17.971,17,riffle_clumpy
0,14,30,4,48,0.292,18,0.375,2,3,0.4,5,1,31,17,6,18,24,0.125,0.375,0.5,17.989,18,riffle_clumpy
0,16,26,7,49,0.327,23,0.469,1,2,0.333,3,5,32,17,9,17,23,0.184,0.347,0.469,17.995,19,riffle_clumpy
0,24,16,6,46,0.522,30,0.652,2,3,0.4,3,2,24,22,12,16,18,0.261,0.348,0.391,17.99,20,riffle_clumpy
0,24,20,2,46,0.522,26,0.565,2,0,1.0,0,0,24,22,16,14,16,0.348,0.304,0.348,18.003,21,riffle_clumpy
0,22,16,7,45,0.489,29,0.644,5,2,0.714,3,1,26,19,11,18,16,0.244,0.4,0.356,18.034,22,riffle_clumpy
0,18,26,1,45,0.4,19,0.422,2,1,0.667,2,3,30,15,11,15,19,0.244,0.333,0.422,18.028,23,riffle_clumpy
0,20,23,4,47,0.426,24,0.511,1,1,0.5,2,2,31,16,12,19,16,0.255,0.404,0.34,18.03,24,riffle_clumpy
0,23,25,2,50,0.46,25,0.5,1,4,0.2,4,4,33,17,13,11,26,0.26,0.22,0.52,18.004,25,riffle_clumpy
0,20,26,3,49,0.408,23,0.469,2,1,0.667,4,3,29,20,9,18,22,0.184,0.367,0.449,17.97,26,riffle_clumpy
0,14,31,2,47,0.298,16,0.34,3,4,0.429,3,4,29,18,7,18,22,0.149,0.383,0.468,17.97,27,riffle_clumpy
0,18,28,3,49,0.367,21,0.429,5,2,0.714,5,2,29,20,9,18,22,0.184,0.367,0.449,17.979,28,riffle_clumpy
0,16,26,6,48,0.333,22,0.458,2,2,0.5,1,3,32,16,10,16,22,0.208,0.333,0.458,18.001,29,riffle_clumpy
0,20,26,1,47,0.426,21,0.447,4,5,0.444,2,1,27,20,12,18,17,0.255,0.383,0.362,18.003,30,riffle_clumpy
0,24,23,0,47,0.511,24,0.511,2,4,0.333,2,2,26,21,15,16,16,0.319,0.34,0.34,18.0,31,riffle_clumpy
0,20,23,3,46,0.435,23,0.5,3,1,0.75,1,3,29,17,16,12,18,0.348,0.261,0.391,18.014,32,riffle_clumpy
0,14,30,4,48,0.292,18,0.375,2,2,0.5,2,4,33,15,10,13,25,0.208,0.271,0.521,18.012,33,riffle_clumpy
0,20,24,3,47,0.426,23,0.489,2,3,0.4,2,2,27,20,13,18,16,0.277,0.383,0.34,18.003,34,riffle_clumpy
0,19,19,6,44,0.432,25,0.568,3,2,0.6,1,1,35,9,13,11,20,0.295,0.25,0.455,18.019,35,riffle_clumpy
0,23,19,4,46,0.5,27,0.587,3,3,0.5,3,0,28,18,16,10,20,0.348,0.217,0.435,18.023,36,riffle_clumpy
0,19,17,8,44,0.432,27,0.614,2,2,0.5,0,0,27,17,15,13,16,0.341,0.295,0.364,18.036,37,riffle_clumpy
0,19,25,4,48,0.396,23,0.479,1,2,0.333,7,1,30,18,7,18,23,0.146,0.375,0.479,18.045,38,riffle_clumpy
0,20,23,4,47,0.426,24,0.511,4,3,0.571,3,3,30,17,11,15,21,0.234,0.319,0.447,18.049,39,riffle_clumpy
0,17,26,6,49,0.347,23,0.469,3,1,0.75,2,3,31,18,9,17,23,0.184,0.347,0.469,18.046,40,riffle_clumpy
0,15,26,6,47,0.319,21,0.447,1,1,0.5,3,4,31,16,8,17,22,0.17,0.362,0.468,18.045,41,riffle_clumpy
0,20,20,6,46,0.435,26,0.565,2,3,0.4,1,3,24,22,14,12,20,0.304,0.261,0.435,18.051,42,riffle_clumpy
0,26,20,0,46,0.565,26,0.565,5,1,0.833,3,0,27,19,19,10,17,0.413,0.217,0.37,18.05,43,riffle_clumpy
0,24,20,1,45,0.533,25,0.556,7,1,0.875,1,1,19,26,19,16,10,0.422,0.356,0.222,18.054,44,riffle_clumpy
0,18,27,3,48,0.375,21,0.438,3,2,0.6,1,4,29,19,11,19,18,0.229,0.396,0.375,18.046,45,riffle_clumpy
0,17,22,6,45,0.378,23,0.511,2,1,0.667,3,0,25,20,9,19,17,0.2,0.422,0.378,18.049,46,riffle_clumpy
0,22,21,2,45,0.489,24,0.533,4,3,0.571,3,2,31,14,15,9,21,0.333,0.2,0.467,18.044,47,riffle_clumpy
0,18,26,3,47,0.383,21,0.447,0,2,0.0,4,4,33,14,15,17,15,0.319,0.362,0.319,18.042,48,riffle_clumpy
0,24,19,5,48,0.5,29,0.604,3,3,0.5,3,2,31,17,12,17,19,0.25,0.354,0.396,18.046,49,riffle_clumpy
0,23,20,3,46,0.5,26,0.565,5,1,0.833,1,4,31,15,14,13,19,0.304,0.283,0.413,18.057,50,riffle_clumpy
0,19,23,6,48,0.396,25,0.521,1,2,0.333,4,2,29,19,8,20,20,0.167,0.417,0.417,18.056,51,riffle_clumpy
0,18,24,5,47,0.383,23,0.489,4,6,0.4,5,0,27,20,9,18,20,0.191,0.383,0.426,18.051,52,riffle_clumpy
0,18,26,2,46,0.391,20,0.435,3,2,0.6,1,1,29,17,9,15,22,0.196,0.326,0.478,18.05,53,riffle_clumpy
0,17,23,5,45,0.378,22,0.489,3,3,0.5,1,1,22,23,13,13,19,0.289,0.289,0.422,18.059,54,riffle_clumpy
0,19,23,3,45,0.422,22,0.489,6,1,0.857,2,2,25,20,10,18,17,0.222,0.4,0.378,18.049,55,riffle_clumpy
0,17,24,5,46,0.37,22,0.478,2,2,0.5,2,1,31,15,13,13,20,0.283,0.283,0.435,18.051,56,riffle_clumpy
0,21,23,1,45,0.467,22,0.489,4,2,0.667,1,1,27,18,14,13,18,0.311,0.289,0.4,18.047,57,riffle_clumpy
0,23,24,6,53,0.434,29,0.547,7,3,0.7,1,3,29,24,15,19,19,0.283,0.358,0.358,18.05,58,riffle_clumpy
0,32,14,0,46,0.696,32,0.696,6,3,0.667,1,1,26,20,22,10,14,0.478,0.217,0.304,18.052,59,riffle_clumpy
0,21,19,6,46,0.457,27,0.587,2,2,0.5,4,2,26,20,15,14,17,0.326,0.304,0.37,18.048,60,riffle_clumpy
0,19,26,1,46,0.413,20,0.435,2,3,0.4,1,3,27,19,11,19,16,0.239,0.413,0.348,18.057,61,riffle_clumpy
0,27,24,2,53,0.509,29,0.547,6,2,0.75,5,3,29,24,16,13,24,0.302,0.245,0.453,18.047,62,riffle_clumpy
0,17,27,5,49,0.347,22,0.449,2,1,0.667,2,4,32,17,10,17,22,0.204,0.347,0.449,18.04,63,riffle_clumpy
0,22,23,1,46,0.478,23,0.5,4,4,0.5,2,2,23,23,8,21,17,0.174,0.457,0.37,18.04,64,riffle_clumpy
0,18,23,7,48,0.375,25,0.521,2,2,0.5,0,1,29,19,11,16,21,0.229,0.333,0.438,18.049,65,riffle_clumpy
0,16,28,5,49,0.327,21,0.429,6,3,0.667,1,2,27,22,8,18,23,0.163,0.367,0.469,18.053,66,riffle_clumpy
0,16,29,2,47,0.34,18,0.383,3,2,0.6,0,3,29,18,12,15,20,0.255,0.319,0.426,18.055,67,riffle_clumpy
0,21,26,2,49,0.429,23,0.469,1,1,0.5,4,6,33,16,9,13,27,0.184,0.265,0.551,18.051,68,riffle_clumpy
0,15,24,6,45,0.333,21,0.467,1,2,0.333,2,2,31,14,9,17,19,0.2,0.378,0.422,18.052,69,riffle_clumpy
0,21,21,5,47,0.447,26,0.553,3,2,0.6,3,1,30,17,11,16,20,0.234,0.34,0.426,18.052,70,riffle_clumpy
0,16,28,4,48,0.333,20,0.417,0,3,0.0,2,3,32,16,12,14,22,0.25,0.292,0.458,18.046,71,riffle_clumpy
0,19,26,1,46,0.413,20,0.435,1,4,0.2,1,2,25,21,12,15,19,0.261,0.326,0.413,18.048,72,riffle_clumpy
0,14,26,8,48,0.292,22,0.458,2,3,0.4,2,4,27,21,8,23,17,0.167,0.479,0.354,18.047,73,riffle_clumpy
0,19,28,0,47,0.404,19,0.404,5,3,0.625,1,2,29,18,8,15,24,0.17,0.319,0.511,18.041,74,riffle_clumpy
0,16,25,5,46,0.348,21,0.457,3,4,0.429,0,2,27,19,14,16,16,0.304,0.348,0.348,18.043,75,riffle_clumpy
0,16,27,3,46,0.348,19,0.413,1,2,0.333,3,2,28,18,7,19,20,0.152,0.413,0.435,18.037,76,riffle_clumpy
0,23,19,5,47,0.489,28,0.596,1,2,0.333,2,0,29,18,9,19,19,0.191,0.404,0.404,18.042,77,riffle_clumpy
0,18,26,3,47,0.383,21,0.447,1,1,0.5,3,2,27,20,12,16,19,0.255,0.34,0.404,18.035,78,riffle_clumpy
0,26,20,0,46,0.565,26,0.565,7,2,0.778,3,4,29,17,18,12,16,0.391,0.261,0.348,18.031,79,riffle_clumpy
0,23,21,2,46,0.5,25,0.543,2,0,1.0,5,1,28,18,11,13,22,0.239,0.283,0.478,18.029,80,riffle_clumpy
0,14,27,4,45,0.311,18,0.4,2,4,0.333,1,1,26,19,8,23,14,0.178,0.511,0.311,18.036,81,riffle_clumpy
0,21,23,3,47,0.447,24,0.511,2,5,0.286,2,2,28,19,15,14,18,0.319,0.298,0.383,18.037,82,riffle_clumpy
0,19,25,4,48,0.396,23,0.479,6,2,0.75,2,1,32,16,11,19,18,0.229,0.396,0.375,18.04,83,riffle_clumpy
0,21,25,2,48,0.438,23,0.479,3,2,0.6,2,2,32,16,13,12,23,0.271,0.25,0.479,18.038,84,riffle_clumpy
0,21,26,2,49,0.429,23,0.469,2,2,0.5,3,0,36,13,12,18,19,0.245,0.367,0.388,18.039,85,riffle_clumpy
0,21,26,2,49,0.429,23,0.469,1,2,0.333,3,5,32,17,13,15,21,0.265,0.306,0.429,18.036,86,riffle_clumpy
0,21,21,5,47,0.447,26,0.553,6,2,0.75,3,2,29,18,15,12,20,0.319,0.255,0.426,18.026,87,riffle_clumpy
0,23,23,0,46,0.5,23,0.5,3,4,0.429,2,0,22,24,19,13,14,0.413,0.283,0.304,18.026,88,riffle_clumpy
0,20,27,3,50,0.4,23,0.46,1,4,0.2,1,3,28,22,14,14,22,0.28,0.28,0.44,18.032,89,riffle_clumpy
0,19,26,2,47,0.404,21,0.447,2,3,0.4,1,2,30,17,13,16,18,0.277,0.34,0.383,18.03,90,riffle_clumpy
0,23,24,0,47,0.489,23,0.489,1,1,0.5,2,0,23,24,15,15,17,0.319,0.319,0.362,18.032,91,riffle_clumpy
0,19,24,5,48,0.396,24,0.5,2,3,0.4,1,2,30,18,13,16,19,0.271,0.333,0.396,18.039,92,riffle_clumpy
0,18,25,3,46,0.391,21,0.457,2,5,0.286,1,1,27,19,14,13,19,0.304,0.283,0.413,18.045,93,riffle_clumpy
0,22,22,3,47,0.468,25,0.532,2,3,0.4,1,1,28,19,15,16,16,0.319,0.34,0.34,18.049,94,riffle_clumpy
0,18,28,3,49,0.367,21,0.429,2,2,0.5,0,1,31,18,10,22,17,0.204,0.449,0.347,18.054,95,riffle_clumpy
0,18,23,5,46,0.391,23,0.5,3,2,0.6,2,2,29,17,8,14,24,0.174,0.304,0.522,18.046,96,riffle_clumpy
0,22,20,4,46,0.478,26,0.565,4,2,0.667,2,3,32,14,17,11,18,0.37,0.239,0.391,18.174,1,riffle_clumpy
0,13,28,4,45,0.289,17,0.378,0,2,0.0,0,2,30,15,9,18,18,0.2,0.4,0.4,18.358,2,riffle_clumpy
0,21,23,4,48,0.438,25,0.521,2,2,0.5,2,2,31,17,13,17,18,0.271,0.354,0.375,18.443,3,riffle_clumpy
0,25,20,2,47,0.532,27,0.574,1,2,0.333,2,2,31,16,15,15,17,0.319,0.319,0.362,18.219,4,riffle_clumpy
0,26,16,4,46,0.565,30,0.652,6,0,1.0,2,4,27,19,15,12,19,0.326,0.261,0.413,18.214,5,riffle_clumpy
0,15,26,4,45,0.333,19,0.422,1,2,0.333,1,1,30,15,13,15,17,0.289,0.333,0.378,18.292,6,riffle_clumpy
0,14,26,5,45,0.311,19,0.422,1,3,0.25,1,3,23,22,7,20,18,0.156,0.444,0.4,18.192,7,riffle_clumpy
0,16,26,6,48,0.333,22,0.458,1,2,0.333,2,5,30,18,6,18,24,0.125,0.375,0.5,18.19,8,riffle_clumpy
0,25,24,0,49,0.51,25,0.51,1,4,0.2,5,2,29,20,14,15,20,0.286,0.306,0.408,18.103,9,riffle_clumpy
0,20,26,2,48,0.417,22,0.458,3,1,0.75,1,5,34,14,17,10,21,0.354,0.208,0.438,18.09,10,riffle_clumpy
0,20,22,3,45,0.444,23,0.511,3,1,0.75,0,2,26,19,11,22,12,0.244,0.489,0.267,18.096,11,riffle_clumpy
0,16,31,3,50,0.32,19,0.38,5,5,0.5,2,6,30,20,10,19,21,0.2,0.38,0.42,18.126,12,riffle_clumpy
0,24,20,5,49,0.49,29,0.592,3,1,0.75,1,2,32,17,15,15,19,0.306,0.306,0.388,18.136,13,riffle_clumpy
0,20,21,4,45,0.444,24,0.533,4,3,0.571,3,3,25,20,11,16,18,0.244,0.356,0.4,18.147,14,riffle_clumpy
0,17,28,3,48,0.354,20,0.417,3,2,0.6,1,3,26,22,11,18,19,0.229,0.375,0.396,18.107,15,riffle_clumpy
0,26,19,1,46,0.565,27,0.587,3,2,0.6,2,3,26,20,16,13,17,0.348,0.283,0.37,18.05,16,riffle_clumpy
0,18,27,1,46,0.391,19,0.413,1,3,0.25,1,5,32,14,11,14,21,0.239,0.304,0.457,18.075,17,riffle_clumpy
0,16,27,4,47,0.34,20,0.426,0,3,0.0,2,2,28,19,9,14,24,0.191,0.298,0.511,18.048,18,riffle_clumpy
0,27,18,1,46,0.587,28,0.609,5,0,1.0,2,3,26,20,19,9,18,0.413,0.196,0.391,18.058,19,riffle_clumpy
0,19,24,5,48,0.396,24,0.5,1,2,0.333,2,4,33,15,13,14,21,0.271,0.292,0.438,18.066,20,riffle_clumpy
0,20,25,0,45,0.444,20,0.444,4,1,0.8,4,1,18,27,12,18,15,0.267,0.4,0.333,18.037,21,riffle_clumpy
0,20,22,4,46,0.435,24,0.522,3,1,0.75,4,0,30,16,7,20,19,0.152,0.435,0.413,18.03,22,riffle_clumpy
0,22,26,1,49,0.449,23,0.469,4,5,0.444,3,2,29,20,12,15,22,0.245,0.306,0.449,18.022,23,riffle_clumpy
0,18,25,3,46,0.391,21,0.457,4,2,0.667,2,0,34,12,13,14,19,0.283,0.304,0.413,18.039,24,riffle_clumpy
0,12,30,3,45,0.267,15,0.333,1,2,0.333,2,4,29,16,8,19,18,0.178,0.422,0.4,18.061,25,riffle_clumpy
0,21,23,3,47,0.447,24,0.511,3,1,0.75,5,3,30,17,12,13,22,0.255,0.277,0.468,18.066,26,riffle_clumpy
0,18,27,3,48,0.375,21,0.438,2,2,0.5,3,2,27,21,9,20,19,0.188,0.417,0.396,18.054,27,riffle_clumpy
0,19,21,7,47,0.404,26,0.553,3,1,0.75,0,1,33,14,12,17,18,0.255,0.362,0.383,18.053,28,riffle_clumpy
0,26,19,1,46,0.565,27,0.587,4,0,1.0,1,1,25,21,19,10,17,0.413,0.217,0.37,18.035,29,riffle_clumpy
0,26,21,3,50,0.52,29,0.58,9,0,1.0,2,2,22,28,20,13,17,0.4,0.26,0.34,18.029,30,riffle_clumpy
0,22,26,2,50,0.44,24,0.48,1,3,0.25,5,3,33,17,10,17,23,0.2,0.34,0.46,18.018,31,riffle_clumpy
0,23,20,4,47,0.489,27,0.574,9,1,0.9,2,1,32,15,14,14,19,0.298,0.298,0.404,18.035,32,riffle_clumpy
0,17,28,4,49,0.347,21,0.429,0,1,0.0,2,2,33,16,10,11,28,0.204,0.224,0.571,18.049,33,riffle_clumpy
0,23,17,6,46,0.5,29,0.63,2,0,1.0,5,1,34,12,14,9,23,0.304,0.196,0.5,18.049,34,riffle_clumpy
0,19,24,3,46,0.413,22,0.478,3,1,0.75,2,1,33,13,14,16,16,0.304,0.348,0.348,18.045,35,riffle_clumpy
0,22,21,3,46,0.478,25,0.543,1,1,0.5,2,2,32,14,13,13,20,0.283,0.283,0.435,18.032,36,riffle_clumpy
0,21,26,1,48,0.438,22,0.458,1,5,0.167,5,3,26,22,9,15,24,0.188,0.312,0.5,17.994,37,riffle_clumpy
0,22,23,5,50,0.44,27,0.54,4,0,1.0,3,3,31,19,15,16,19,0.3,0.32,0.38,17.991,38,riffle_clumpy
0,25,17,3,45,0.556,28,0.622,6,1,0.857,0,2,32,13,14,15,16,0.311,0.333,0.356,18.004,39,riffle_clumpy
0,18,30,2,50,0.36,20,0.4,3,4,0.429,2,1,32,18,10,21,19,0.2,0.42,0.38,18.017,40,riffle_clumpy
0,17,27,5,49,0.347,22,0.449,3,0,1.0,2,2,29,20,10,19,20,0.204,0.388,0.408,18.027,41,riffle_clumpy
0,16,27,5,48,0.333,21,0.438,0,1,0.0,0,0,37,11,13,19,16,0.271,0.396,0.333,18.048,42,riffle_clumpy
0,21,23,3,47,0.447,24,0.511,2,1,0.667,2,2,27,20,16,15,16,0.34,0.319,0.34,18.051,43,riffle_clumpy
0,26,20,4,50,0.52,30,0.6,3,4,0.429,2,1,22,28,19,19,12,0.38,0.38,0.24,18.05,44,riffle_clumpy
0,17,30,2,49,0.347,19,0.388,1,1,0.5,3,3,28,21,12,16,21,0.245,0.327,0.429,18.056,45,riffle_clumpy
0,19,27,4,50,0.38,23,0.46,1,4,0.2,4,4,26,24,11,20,19,0.22,0.4,0.38,18.067,46,riffle_clumpy
0,23,21,4,48,0.479,27,0.562,4,0,1.0,5,3,33,15,14,11,23,0.292,0.229,0.479,18.055,47,riffle_clumpy
0,21,24,4,49,0.429,25,0.51,6,3,0.667,3,3,35,14,6,14,29,0.122,0.286,0.592,18.052,48,riffle_clumpy
0,21,23,2,46,0.457,23,0.5,4,1,0.8,2,4,30,16,9,15,22,0.196,0.326,0.478,18.048,49,riffle_clumpy
0,21,25,1,47,0.447,22,0.468,2,6,0.25,2,2,33,14,13,16,18,0.277,0.34,0.383,18.044,50,riffle_clumpy
0,18,25,3,46,0.391,21,0.457,2,2,0.5,1,4,29,17,12,18,16,0.261,0.391,0.348,18.037,51,riffle_clumpy
0,25,18,5,48,0.521,30,0.625,5,0,1.0,2,2,28,20,14,15,19,0.292,0.312,0.396,18.034,52,riffle_clumpy
0,21,25,5,51,0.412,26,0.51,0,2,0.0,6,3,27,24,10,20,21,0.196,0.392,0.412,18.032,53,riffle_clumpy
0,16,29,1,46,0.348,17,0.37,4,2,0.667,1,3,25,21,12,13,21,0.261,0.283,0.457,18.04,54,riffle_clumpy
0,14,29,4,47,0.298,18,0.383,2,4,0.333,1,4,31,16,7,18,22,0.149,0.383,0.468,18.043,55,riffle_clumpy
0,18,28,0,46,0.391,18,0.391,4,4,0.5,1,6,30,16,13,11,22,0.283,0.239,0.478,18.056,56,riffle_clumpy
0,20,22,6,48,0.417,26,0.542,2,4,0.333,2,3,32,16,11,21,16,0.229,0.438,0.333,18.055,57,riffle_clumpy
0,26,15,5,46,0.565,31,0.674,5,1,0.833,1,3,27,19,16,18,12,0.348,0.391,0.261,18.054,58,riffle_clumpy
0,15,24,7,46,0.326,22,0.478,3,2,0.6,2,2,28,18,14,16,16,0.304,0.348,0.348,18.058,59,riffle_clumpy
0,16,25,5,46,0.348,21,0.457,4,2,0.667,0,3,34,12,8,17,21,0.174,0.37,0.457,18.071,60,riffle_clumpy
0,16,26,4,46,0.348,20,0.435,2,4,0.333,1,3,28,18,12,16,18,0.261,0.348,0.391,18.069,61,riffle_clumpy
0,21,22,6,49,0.429,27,0.551,5,1,0.833,0,4,28,21,16,10,23,0.327,0.204,0.469,18.076,62,riffle_clumpy
0,19,22,5,46,0.413,24,0.522,3,1,0.75,2,2,32,14,10,21,15,0.217,0.457,0.326,18.079,63,riffle_clumpy
0,27,19,2,48,0.562,29,0.604,2,1,0.667,1,1,29,19,19,14,15,0.396,0.292,0.312,18.086,64,riffle_clumpy
0,22,28,1,51,0.431,23,0.451,6,3,0.667,2,2,31,20,12,16,23,0.235,0.314,0.451,18.088,65,riffle_clumpy
0,17,23,4,44,0.386,21,0.477,3,1,0.75,1,0,23,21,11,20,13,0.25,0.455,0.295,18.083,66,riffle_clumpy
0,17,26,4,47,0.362,21,0.447,3,4,0.429,1,1,27,20,9,17,21,0.191,0.362,0.447,18.088,67,riffle_clumpy
0,17,28,2,47,0.362,19,0.404,1,1,0.5,2,6,33,14,13,15,19,0.277,0.319,0.404,18.094,68,riffle_clumpy
0,20,19,4,43,0.465,24,0.558,6,2,0.75,2,1,25,18,15,15,13,0.349,0.349,0.302,18.091,69,riffle_clumpy
0,18,26,4,48,0.375,22,0.458,2,2,0.5,1,2,35,13,12,11,25,0.25,0.229,0.521,18.097,70,riffle_clumpy
0,20,20,5,45,0.444,25,0.556,2,1,0.667,1,3,25,20,15,14,16,0.333,0.311,0.356,18.096,71,riffle_clumpy
0,16,28,3,47,0.34,19,0.404,1,2,0.333,1,4,33,14,10,13,24,0.213,0.277,0.511,18.093,72,riffle_clumpy
0,22,21,5,48,0.458,27,0.562,1,3,0.25,2,2,23,25,16,16,16,0.333,0.333,0.333,18.094,73,riffle_clumpy
0,17,26,3,46,0.37,20,0.435,3,3,0.5,1,2,25,21,14,15,17,0.304,0.326,0.37,18.104,74,riffle_clumpy
0,28,17,2,47,0.596,30,0.638,4,1,0.8,1,2,27,20,17,14,16,0.362,0.298,0.34,18.101,75,riffle_clumpy
0,25,19,3,47,0.532,28,0.596,4,1,0.8,2,1,28,19,13,18,16,0.277,0.383,0.34,18.106,76,riffle_clumpy
0,22,23,2,47,0.468,24,0.511,3,0,1.0,3,4,27,20,12,19,16,0.255,0.404,0.34,18.108,77,riffle_clumpy
0,28,19,1,48,0.583,29,0.604,5,0,1.0,3,1,24,24,13,18,17,0.271,0.375,0.354,18.103,78,riffle_clumpy
0,26,17,5,48,0.542,31,0.646,5,3,0.625,2,1,31,17,15,16,17,0.312,0.333,0.354,18.11,79,riffle_clumpy
0,27,19,3,49,0.551,30,0.612,3,2,0.6,4,2,32,17,15,14,20,0.306,0.286,0.408,18.109,80,riffle_clumpy
0,21,20,3,44,0.477,24,0.545,1,3,0.25,2,1,30,14,13,14,17,0.295,0.318,0.386,18.111,81,riffle_clumpy
0,23,21,2,46,0.5,25,0.543,2,2,0.5,4,0,29,17,14,16,16,0.304,0.348,0.348,18.108,82,riffle_clumpy
0,18,26,1,45,0.4,19,0.422,2,1,0.667,2,3,29,16,10,17,18,0.222,0.378,0.4,18.108,83,riffle_clumpy
0,20,21,5,46,0.435,25,0.543,3,2,0.6,1,3,27,19,15,17,14,0.326,0.37,0.304,18.113,84,riffle_clumpy
0,19,26,3,48,0.396,22,0.458,3,6,0.333,2,2,29,19,10,16,22,0.208,0.333,0.458,18.114,85,riffle_clumpy
0,26,22,2,50,0.52,28,0.56,3,2,0.6,2,0,28,22,18,18,14,0.36,0.36,0.28,18.117,86,riffle_clumpy
0,23,26,4,53,0.434,27,0.509,4,4,0.5,4,3,32,21,14,14,25,0.264,0.264,0.472,18.119,87,riffle_clumpy
0,21,24,4,49,0.429,25,0.51,2,0,1.0,5,1,28,21,11,20,18,0.224,0.408,0.367,18.113,88,riffle_clumpy
0,26,18,3,47,0.553,29,0.617,4,1,0.8,3,0,25,22,12,24,11,0.255,0.511,0.234,18.108,89,riffle_clumpy
0,19,27,5,51,0.373,24,0.471,1,5,0.167,2,2,34,17,11,16,24,0.216,0.314,0.471,18.107,90,riffle_clumpy
0,16,28,5,49,0.327,21,0.429,3,3,0.5,1,2,34,15,8,18,23,0.163,0.367,0.469,18.109,91,riffle_clumpy
0,24,16,6,46,0.522,30,0.652,3,1,0.75,1,3,29,17,18,15,13,0.391,0.326,0.283,18.11,92,riffle_clumpy
0,19,24,4,47,0.404,23,0.489,2,0,1.0,3,1,30,17,12,20,15,0.255,0.426,0.319,18.102,93,riffle_clumpy
0,18,23,5,46,0.391,23,0.5,3,0,1.0,1,1,33,13,14,19,13,0.304,0.413,0.283,18.107,94,riffle_clumpy
0,27,22,2,51,0.529,29,0.569,2,0,1.0,4,2,29,22,15,18,18,0.294,0.353,0.353,18.099,95,riffle_clumpy
0,18,26,5,49,0.367,23,0.469,1,4,0.2,0,4,27,22,11,19,19,0.224,0.388,0.388,18.108,96,riffle_clumpy
0,24,15,8,47,0.511,32,0.681,3,2,0.6,2,1,35,12,12,18,17,0.255,0.383,0.362,18.241,1,riffle_clumpy
0,20,24,2,46,0.435,22,0.478,4,2,0.667,0,2,28,18,12,16,18,0.261,0.348,0.391,18.448,2,riffle_clumpy
0,21,21,3,45,0.467,24,0.533,5,5,0.5,5,2,25,20,13,16,16,0.289,0.356,0.356,18.576,3,riffle_clumpy
0,21,23,3,47,0.447,24,0.511,3,4,0.429,4,2,26,21,15,13,19,0.319,0.277,0.404,18.456,4,riffle_clumpy
0,18,25,4,47,0.383,22,0.468,1,0,1.0,4,1,30,17,10,16,21,0.213,0.34,0.447,18.034,5,riffle_clumpy
0,24,22,1,47,0.511,25,0.532,3,0,1.0,5,3,33,14,13,12,22,0.277,0.255,0.468,18.132,6,riffle_clumpy
0,16,25,6,47,0.34,22,0.468,2,2,0.5,2,3,27,20,9,19,19,0.191,0.404,0.404,18.101,7,riffle_clumpy
0,32,14,2,48,0.667,34,0.708,5,0,1.0,6,1,30,18,20,11,17,0.417,0.229,0.354,18.064,8,riffle_clumpy
0,18,26,4,48,0.375,22,0.458,1,3,0.25,1,2,33,15,9,18,21,0.188,0.375,0.438,18.049,9,riffle_clumpy
0,19,25,3,47,0.404,22,0.468,7,5,0.583,3,1,26,21,10,20,17,0.213,0.426,0.362,18.074,10,riffle_clumpy
0,23,22,2,47,0.489,25,0.532,1,2,0.333,4,0,29,18,13,14,20,0.277,0.298,0.426,18.064,11,riffle_clumpy
0,22,19,2,43,0.512,24,0.558,4,1,0.8,1,0,20,23,19,15,9,0.442,0.349,0.209,18.112,12,riffle_clumpy
0,23,21,3,47,0.489,26,0.553,3,3,0.5,4,0,25,22,12,16,19,0.255,0.34,0.404,18.099,13,riffle_clumpy
0,21,24,1,46,0.457,22,0.478,2,1,0.667,2,1,33,13,14,16,16,0.304,0.348,0.348,18.124,14,riffle_clumpy
0,21,24,2,47,0.447,23,0.489,3,4,0.429,4,1,26,21,12,14,21,0.255,0.298,0.447,18.116,15,riffle_clumpy
0,16,25,7,48,0.333,23,0.479,3,1,0.75,5,4,31,17,7,14,27,0.146,0.292,0.562,18.101,16,riffle_clumpy
0,19,25,4,48,0.396,23,0.479,4,3,0.571,2,1,23,25,13,20,15,0.271,0.417,0.312,18.099,17,riffle_clumpy
0,18,27,4,49,0.367,22,0.449,3,3,0.5,1,1,26,23,12,20,17,0.245,0.408,0.347,18.109,18,riffle_clumpy
0,20,24,2,46,0.435,22,0.478,7,2,0.778,1,3,28,18,12,15,19,0.261,0.326,0.413,18.116,19,riffle_clumpy
0,21,28,0,49,0.429,21,0.429,2,1,0.667,2,2,37,12,13,18,18,0.265,0.367,0.367,18.092,20,riffle_clumpy
0,19,30,1,50,0.38,20,0.4,3,3,0.5,2,4,31,19,11,13,26,0.22,0.26,0.52,18.078,21,riffle_clumpy
0,21,18,6,45,0.467,27,0.6,2,3,0.4,1,2,26,19,15,17,13,0.333,0.378,0.289,18.073,22,riffle_clumpy
0,22,22,2,46,0.478,24,0.522,3,1,0.75,4,1,29,17,14,13,19,0.304,0.283,0.413,18.082,23,riffle_clumpy
0,23,20,4,47,0.489,27,0.574,5,1,0.833,0,4,31,16,16,17,14,0.34,0.362,0.298,18.095,24,riffle_clumpy
0,23,20,3,46,0.5,26,0.565,6,2,0.75,0,3,34,12,14,15,17,0.304,0.326,0.37,18.096,25,riffle_clumpy
0,19,30,1,50,0.38,20,0.4,2,3,0.4,4,3,32,18,6,20,24,0.12,0.4,0.48,18.066,26,riffle_clumpy
0,15,25,4,44,0.341,19,0.432,1,3,0.25,0,0,25,19,14,12,18,0.318,0.273,0.409,18.088,27,riffle_clumpy
0,20,26,2,48,0.417,22,0.458,2,5,0.286,2,4,30,18,10,17,21,0.208,0.354,0.438,18.084,28,riffle_clumpy
0,21,24,2,47,0.447,23,0.489,7,3,0.7,2,0,26,21,12,19,16,0.255,0.404,0.34,18.092,29,riffle_clumpy
0,20,27,3,50,0.4,23,0.46,2,4,0.333,0,6,27,23,14,19,17,0.28,0.38,0.34,18.107,30,riffle_clumpy
0,24,22,5,51,0.471,29,0.569,6,1,0.857,4,1,31,20,16,17,18,0.314,0.333,0.353,18.122,31,riffle_clumpy
0,23,18,4,45,0.511,27,0.6,3,0,1.0,1,2,26,19,15,15,15,0.333,0.333,0.333,18.113,32,riffle_clumpy
0,20,27,1,48,0.417,21,0.438,4,4,0.5,2,5,30,18,15,15,18,0.312,0.312,0.375,18.113,33,riffle_clumpy
0,23,19,4,46,0.5,27,0.587,5,3,0.625,1,4,30,16,14,13,19,0.304,0.283,0.413,18.112,34,riffle_clumpy
0,23,20,3,46,0.5,26,0.565,5,1,0.833,2,3,28,18,15,14,17,0.326,0.304,0.37,18.122,35,riffle_clumpy
0,16,28,2,46,0.348,18,0.391,4,1,0.8,2,1,31,15,10,14,22,0.217,0.304,0.478,18.111,36,riffle_clumpy
0,23,18,3,44,0.523,26,0.591,4,1,0.8,3,1,24,20,15,15,14,0.341,0.341,0.318,18.096,37,riffle_clumpy
0,21,20,2,43,0.488,23,0.535,4,0,1.0,2,3,28,15,16,14,13,0.372,0.326,0.302,18.086,38,riffle_clumpy
0,14,31,5,50,0.28,19,0.38,2,1,0.667,0,4,35,15,9,21,20,0.18,0.42,0.4,18.101,39,riffle_clumpy
0,20,23,3,46,0.435,23,0.5,2,1,0.667,3,1,21,25,14,19,13,0.304,0.413,0.283,18.088,40,riffle_clumpy
0,22,20,5,47,0.468,27,0.574,4,4,0.5,2,1,27,20,16,16,15,0.34,0.34,0.319,18.09,41,riffle_clumpy
0,15,26,5,46,0.326,20,0.435,3,3,0.5,2,4,30,16,9,17,20,0.196,0.37,0.435,18.097,42,riffle_clumpy
0,18,25,2,45,0.4,20,0.444,4,2,0.667,1,4,30,15,12,14,19,0.267,0.311,0.422,18.092,43,riffle_clumpy
0,16,27,4,47,0.34,20,0.426,1,2,0.333,4,3,32,15,9,17,21,0.191,0.362,0.447,18.083,44,riffle_clumpy
0,19,24,2,45,0.422,21,0.467,4,2,0.667,2,0,22,23,11,18,16,0.244,0.4,0.356,18.09,45,riffle_clumpy
0,22,27,1,50,0.44,23,0.46,0,3,0.0,4,2,26,24,11,20,19,0.22,0.4,0.38,18.086,46,riffle_clumpy
0,20,22,6,48,0.417,26,0.542,3,3,0.5,4,5,31,17,11,16,21,0.229,0.333,0.438,18.074,47,riffle_clumpy
0,18,25,3,46,0.391,21,0.457,4,2,0.667,1,2,31,15,12,16,18,0.261,0.348,0.391,18.069,48,riffle_clumpy
0,25,20,2,47,0.532,27,0.574,2,3,0.4,3,2,29,18,12,16,19,0.255,0.34,0.404,18.078,49,riffle_clumpy
0,20,24,2,46,0.435,22,0.478,2,2,0.5,3,3,32,14,12,15,19,0.261,0.326,0.413,18.084,50,riffle_clumpy
0,18,22,5,45,0.4,23,0.511,4,2,0.667,1,2,20,25,11,17,17,0.244,0.378,0.378,18.072,51,riffle_clumpy
0,24,22,4,50,0.48,28,0.56,6,0,1.0,2,2,30,20,16,17,17,0.32,0.34,0.34,18.077,52,riffle_clumpy
0,18,24,6,48,0.375,24,0.5,2,1,0.667,4,1,27,21,9,20,19,0.188,0.417,0.396,18.066,53,riffle_clumpy
0,18,29,0,47,0.383,18,0.383,3,0,1.0,4,4,27,20,12,17,18,0.255,0.362,0.383,18.057,54,riffle_clumpy
0,17,25,4,46,0.37,21,0.457,5,7,0.417,0,2,22,24,12,20,14,0.261,0.435,0.304,18.063,55,riffle_clumpy
0,18,19,8,45,0.4,26,0.578,3,2,0.6,2,2,24,21,14,16,15,0.311,0.356,0.333,18.073,56,riffle_clumpy
0,15,29,2,46,0.326,17,0.37,0,4,0.0,1,6,24,22,8,19,19,0.174,0.413,0.413,18.069,57,riffle_clumpy
0,23,22,2,47,0.489,25,0.532,3,1,0.75,6,1,21,26,10,19,18,0.213,0.404,0.383,18.067,58,riffle_clumpy
0,21,22,3,46,0.457,24,0.522,8,2,0.8,2,3,29,17,11,15,20,0.239,0.326,0.435,18.061,59,riffle_clumpy
0,21,20,6,47,0.447,27,0.574,3,2,0.6,5,2,24,23,13,16,18,0.277,0.34,0.383,18.055,60,riffle_clumpy
0,15,30,2,47,0.319,17,0.362,0,1,0.0,2,1,26,21,9,24,14,0.191,0.511,0.298,18.061,61,riffle_clumpy
0,20,24,4,48,0.417,24,0.5,2,1,0.667,0,3,32,16,16,13,19,0.333,0.271,0.396,18.068,62,riffle_clumpy
0,15,26,7,48,0.312,22,0.458,3,1,0.75,1,3,31,17,9,18,21,0.188,0.375,0.438,18.078,63,riffle_clumpy
0,17,27,4,48,0.354,21,0.438,1,4,0.2,2,2,32,16,7,14,27,0.146,0.292,0.562,18.07,64,riffle_clumpy
0,18,27,2,47,0.383,20,0.426,1,1,0.5,1,0,31,16,14,15,18,0.298,0.319,0.383,18.075,65,riffle_clumpy
0,20,19,6,45,0.444,26,0.578,3,4,0.429,1,2,28,17,14,19,12,0.311,0.422,0.267,18.08,66,riffle_clumpy
0,16,23,5,44,0.364,21,0.477,4,2,0.667,1,1,27,17,10,16,18,0.227,0.364,0.409,18.089,67,riffle_clumpy
0,20,26,4,50,0.4,24,0.48,2,7,0.222,1,2,30,20,14,17,19,0.28,0.34,0.38,18.087,68,riffle_clumpy
0,25,20,7,52,0.481,32,0.615,5,3,0.625,1,1,30,22,16,14,22,0.308,0.269,0.423,18.089,69,riffle_clumpy
0,22,21,4,47,0.468,26,0.553,3,1,0.75,3,2,29,18,14,17,16,0.298,0.362,0.34,18.085,70,riffle_clumpy
0,20,24,3,47,0.426,23,0.489,4,1,0.8,2,1,29,18,12,13,22,0.255,0.277,0.468,18.089,71,riffle_clumpy
0,22,21,3,46,0.478,25,0.543,2,2,0.5,2,2,25,21,11,19,16,0.239,0.413,0.348,18.084,72,riffle_clumpy
0,20,24,4,48,0.417,24,0.5,2,4,0.333,3,2,24,24,13,16,19,0.271,0.333,0.396,18.086,73,riffle_clumpy
0,27,16,5,48,0.562,32,0.667,8,1,0.889,2,1,24,24,18,12,18,0.375,0.25,0.375,18.079,74,riffle_clumpy
0,18,23,5,46,0.391,23,0.5,4,0,1.0,3,3,27,19,9,15,22,0.196,0.326,0.478,18.076,75,riffle_clumpy
0,17,24,4,45,0.378,21,0.467,0,4,0.0,3,1,27,18,10,17,18,0.222,0.378,0.4,18.084,76,riffle_clumpy
0,19,26,2,47,0.404,21,0.447,2,1,0.667,3,4,30,17,13,12,22,0.277,0.255,0.468,18.086,77,riffle_clumpy
0,23,23,3,49,0.469,26,0.531,2,2,0.5,1,3,32,17,17,11,21,0.347,0.224,0.429,18.086,78,riffle_clumpy
0,14,27,5,46,0.304,19,0.413,2,4,0.333,2,3,28,18,9,20,17,0.196,0.435,0.37,18.085,79,riffle_clumpy
0,14,24,9,47,0.298,23,0.489,7,4,0.636,1,2,28,19,9,22,16,0.191,0.468,0.34,18.089,80,riffle_clumpy
0,19,23,4,46,0.413,23,0.5,4,3,0.571,1,2,30,16,15,12,19,0.326,0.261,0.413,18.09,81,riffle_clumpy
0,27,17,4,48,0.562,31,0.646,2,4,0.333,1,2,28,20,21,12,15,0.438,0.25,0.312,18.088,82,riffle_clumpy
0,18,27,1,46,0.391,19,0.413,3,3,0.5,2,4,22,24,14,20,12,0.304,0.435,0.261,18.093,83,riffle_clumpy
0,21,25,3,49,0.429,24,0.49,2,2,0.5,3,1,29,20,10,20,19,0.204,0.408,0.388,18.089,84,riffle_clumpy
0,22,21,4,47,0.468,26,0.553,1,2,0.333,4,2,27,20,16,15,16,0.34,0.319,0.34,18.087,85,riffle_clumpy
0,25,19,4,48,0.521,29,0.604,3,4,0.429,5,1,23,25,15,19,14,0.312,0.396,0.292,18.083,86,riffle_clumpy
0,22,24,1,47,0.468,23,0.489,3,3,0.5,3,3,30,17,12,17,18,0.255,0.362,0.383,18.082,87,riffle_clumpy
0,25,17,4,46,0.543,29,0.63,3,2,0.6,1,2,29,17,19,13,14,0.413,0.283,0.304,18.081,88,riffle_clumpy
0,18,26,3,47,0.383,21,0.447,2,4,0.333,1,3,32,15,11,19,17,0.234,0.404,0.362,18.079,89,riffle_clumpy
0,19,25,4,48,0.396,23,0.479,4,4,0.5,3,4,29,19,11,14,23,0.229,0.292,0.479,18.076,90,riffle_clumpy
0,21,23,3,47,0.447,24,0.511,1,2,0.333,2,1,27,20,15,14,18,0.319,0.298,0.383,18.072,91,riffle_clumpy
0,23,26,0,49,0.469,23,0.469,5,2,0.714,2,1,30,19,15,13,21,0.306,0.265,0.429,18.077,92,riffle_clumpy
0,22,26,1,49,0.449,23,0.469,5,4,0.556,2,2,24,25,16,12,21,0.327,0.245,0.429,18.076,93,riffle_clumpy
0,24,19,2,45,0.533,26,0.578,2,4,0.333,0,2,24,21,15,17,13,0.333,0.378,0.289,18.083,94,riffle_clumpy
0,22,24,2,48,0.458,24,0.5,5,3,0.625,3,3,24,24,13,15,20,0.271,0.312,0.417,18.08,95,riffle_clumpy
0,16,30,0,46,0.348,16,0.348,3,2,0.6,2,1,32,14,8,22,16,0.174,0.478,0.348,18.078,96,riffle_clumpy
0,23,20,3,46,0.5,26,0.565,2,4,0.333,3,0,27,19,8,18,20,0.174,0.391,0.435,18.355,1,riffle_clumpy
0,20,21,5,46,0.435,25,0.543,3,4,0.429,3,1,26,20,12,17,17,0.261,0.37,0.37,18.614,2,riffle_clumpy
0,19,27,4,50,0.38,23,0.46,4,2,0.667,2,6,31,19,13,13,24,0.26,0.26,0.48,18.398,3,riffle_clumpy
0,15,26,4,45,0.333,19,0.422,3,7,0.3,2,3,27,18,11,15,19,0.244,0.333,0.422,18.179,4,riffle_clumpy
0,22,24,2,48,0.458,24,0.5,3,0,1.0,3,1,31,17,16,15,17,0.333,0.312,0.354,18.088,5,riffle_clumpy
0,26,16,7,49,0.531,33,0.673,5,2,0.714,6,3,33,16,10,9,30,0.204,0.184,0.612,17.942,6,riffle_clumpy
0,15,30,2,47,0.319,17,0.362,2,1,0.667,3,2,29,18,6,23,18,0.128,0.489,0.383,17.952,7,riffle_clumpy
0,22,22,1,45,0.489,23,0.511,4,1,0.8,2,3,26,19,16,11,18,0.356,0.244,0.4,17.966,8,riffle_clumpy
0,25,15,6,46,0.543,31,0.674,4,1,0.8,4,3,24,22,18,13,15,0.391,0.283,0.326,17.98,9,riffle_clumpy
0,28,15,3,46,0.609,31,0.674,5,2,0.714,3,3,29,17,19,12,15,0.413,0.261,0.326,17.985,10,riffle_clumpy
0,19,26,1,46,0.413,20,0.435,2,4,0.333,4,1,26,20,12,11,23,0.261,0.239,0.5,18.003,11,riffle_clumpy
0,17,26,4,47,0.362,21,0.447,3,1,0.75,1,2,29,18,11,16,20,0.234,0.34,0.426,17.976,12,riffle_clumpy
0,27,18,3,48,0.562,30,0.625,5,2,0.714,2,3,21,27,18,13,17,0.375,0.271,0.354,17.997,13,riffle_clumpy
0,23,24,0,47,0.489,23,0.489,3,2,0.6,3,3,29,18,14,13,20,0.298,0.277,0.426,17.992,14,riffle_clumpy
0,20,29,1,50,0.4,21,0.42,1,1,0.5,3,0,34,16,12,21,17,0.24,0.42,0.34,17.988,15,riffle_clumpy
0,23,17,6,46,0.5,29,0.63,5,3,0.625,3,1,24,22,11,18,17,0.239,0.391,0.37,17.987,16,riffle_clumpy
0,26,19,0,45,0.578,26,0.578,3,2,0.6,3,1,24,21,15,16,14,0.333,0.356,0.311,17.977,17,riffle_clumpy
0,18,25,2,45,0.4,20,0.444,5,2,0.714,2,1,27,18,10,16,19,0.222,0.356,0.422,17.99,18,riffle_clumpy
0,20,24,3,47,0.426,23,0.489,4,1,0.8,2,4,33,14,15,13,19,0.319,0.277,0.404,17.958,19,riffle_clumpy
0,19,24,4,47,0.404,23,0.489,4,1,0.8,3,3,26,21,10,18,19,0.213,0.383,0.404,17.966,20,riffle_clumpy
0,23,22,3,48,0.479,26,0.542,2,4,0.333,3,0,30,18,13,17,18,0.271,0.354,0.375,17.971,21,riffle_clumpy
0,27,17,2,46,0.587,29,0.63,4,1,0.8,4,3,27,19,17,11,18,0.37,0.239,0.391,17.967,22,riffle_clumpy
0,22,23,2,47,0.468,24,0.511,4,3,0.571,3,3,24,23,14,19,14,0.298,0.404,0.298,17.97,23,riffle_clumpy
0,17,28,2,47,0.362,19,0.404,2,1,0.667,1,2,26,21,9,20,18,0.191,0.426,0.383,17.982,24,riffle_clumpy
0,19,24,6,49,0.388,25,0.51,5,3,0.625,2,6,34,15,14,11,24,0.286,0.224,0.49,17.981,25,riffle_clumpy
0,21,26,3,50,0.42,24,0.48,4,4,0.5,6,1,32,18,7,15,28,0.14,0.3,0.56,17.955,26,riffle_clumpy
0,24,16,7,47,0.511,31,0.66,3,2,0.6,2,1,23,24,20,16,11,0.426,0.34,0.234,17.956,27,riffle_clumpy
0,19,24,2,45,0.422,21,0.467,2,3,0.4,1,0,27,18,11,16,18,0.244,0.356,0.4,17.977,28,riffle_clumpy
0,23,22,1,46,0.5,24,0.522,6,2,0.75,1,4,31,15,16,11,19,0.348,0.239,0.413,17.994,29,riffle_clumpy
0,20,25,2,47,0.426,22,0.468,4,1,0.8,2,2,29,18,14,14,19,0.298,0.298,0.404,18.001,30,riffle_clumpy
0,24,20,1,45,0.533,25,0.556,3,0,1.0,1,2,27,18,15,17,13,0.333,0.378,0.289,18.017,31,riffle_clumpy
0,19,23,7,49,0.388,26,0.531,2,4,0.333,2,2,23,26,13,21,15,0.265,0.429,0.306,18.009,32,riffle_clumpy
0,25,21,1,47,0.532,26,0.553,4,1,0.8,3,1,24,23,16,17,14,0.34,0.362,0.298,17.999,33,riffle_clumpy
0,22,28,4,54,0.407,26,0.481,3,2,0.6,1,7,32,22,18,17,19,0.333,0.315,0.352,17.997,34,riffle_clumpy
0,15,30,2,47,0.319,17,0.362,1,3,0.25,3,2,30,17,10,18,19,0.213,0.383,0.404,18.009,35,riffle_clumpy
0,24,22,0,46,0.522,24,0.522,5,3,0.625,2,4,30,16,15,10,21,0.326,0.217,0.457,18.011,36,riffle_clumpy
0,16,27,4,47,0.34,20,0.426,3,4,0.429,2,3,30,17,13,13,21,0.277,0.277,0.447,17.999,37,riffle_clumpy
0,20,19,8,47,0.426,28,0.596,5,1,0.833,2,4,26,21,15,16,16,0.319,0.34,0.34,18.006,38,riffle_clumpy
0,18,27,2,47,0.383,20,0.426,3,2,0.6,2,1,31,16,11,11,25,0.234,0.234,0.532,18.005,39,riffle_clumpy
0,28,18,1,47,0.596,29,0.617,9,1,0.9,3,0,34,13,18,16,13,0.383,0.34,0.277,18.021,40,riffle_clumpy
0,19,24,4,47,0.404,23,0.489,1,0,1.0,3,2,31,16,12,12,23,0.255,0.255,0.489,18.026,41,riffle_clumpy
0,25,22,1,48,0.521,26,0.542,9,3,0.75,5,1,28,20,13,12,23,0.271,0.25,0.479,18.02,42,riffle_clumpy
0,10,29,8,47,0.213,18,0.383,1,3,0.25,1,2,35,12,5,18,24,0.106,0.383,0.511,18.017,43,riffle_clumpy
0,17,28,3,48,0.354,20,0.417,3,1,0.75,2,1,39,9,11,13,24,0.229,0.271,0.5,18.021,44,riffle_clumpy
0,16,24,5,45,0.356,21,0.467,3,1,0.75,2,0,30,15,8,16,21,0.178,0.356,0.467,18.031,45,riffle_clumpy
0,17,27,2,46,0.37,19,0.413,0,1,0.0,3,1,32,14,13,12,21,0.283,0.261,0.457,18.043,46,riffle_clumpy
0,19,25,3,47,0.404,22,0.468,7,3,0.7,1,1,24,23,11,21,15,0.234,0.447,0.319,18.054,47,riffle_clumpy
0,19,29,3,51,0.373,22,0.431,3,4,0.429,2,6,32,19,15,17,19,0.294,0.333,0.373,18.059,48,riffle_clumpy
0,19,25,3,47,0.404,22,0.468,2,0,1.0,1,2,27,20,9,19,19,0.191,0.404,0.404,18.063,49,riffle_clumpy
0,13,27,7,47,0.277,20,0.426,1,3,0.25,2,3,35,12,8,15,24,0.17,0.319,0.511,18.072,50,riffle_clumpy
0,24,17,4,45,0.533,28,0.622,6,0,1.0,4,4,31,14,14,11,20,0.311,0.244,0.444,18.076,51,riffle_clumpy
0,21,22,3,46,0.457,24,0.522,3,3,0.5,2,1,28,18,11,14,21,0.239,0.304,0.457,18.081,52,riffle_clumpy
0,25,23,2,50,0.5,27,0.54,4,6,0.4,0,2,23,27,17,16,17,0.34,0.32,0.34,18.083,53,riffle_clumpy
0,21,21,4,46,0.457,25,0.543,4,1,0.8,1,3,26,20,15,13,18,0.326,0.283,0.391,18.088,54,riffle_clumpy
0,19,29,2,50,0.38,21,0.42,2,5,0.286,0,4,25,25,15,20,15,0.3,0.4,0.3,18.092,55,riffle_clumpy
0,22,19,3,44,0.5,25,0.568,4,0,1.0,3,3,28,16,18,10,16,0.409,0.227,0.364,18.1,56,riffle_clumpy
0,17,24,5,46,0.37,22,0.478,2,0,1.0,2,6,23,23,10,19,17,0.217,0.413,0.37,18.102,57,riffle_clumpy
0,19,20,8,47,0.404,27,0.574,4,1,0.8,1,2,29,18,11,18,18,0.234,0.383,0.383,18.106,58,riffle_clumpy
0,23,21,2,46,0.5,25,0.543,4,1,0.8,2,0,27,19,13,16,17,0.283,0.348,0.37,18.117,59,riffle_clumpy
0,21,24,3,48,0.438,24,0.5,3,2,0.6,1,3,25,23,15,18,15,0.312,0.375,0.312,18.126,60,riffle_clumpy
0,27,16,4,47,0.574,31,0.66,4,1,0.8,2,1,28,19,16,15,16,0.34,0.319,0.34,18.126,61,riffle_clumpy
0,18,28,2,48,0.375,20,0.417,3,1,0.75,1,3,26,22,15,14,19,0.312,0.292,0.396,18.126,62,riffle_clumpy
0,19,27,2,48,0.396,21,0.438,3,3,0.5,3,1,26,22,10,18,20,0.208,0.375,0.417,18.119,63,riffle_clumpy
0,17,29,2,48,0.354,19,0.396,1,1,0.5,2,2,36,12,9,16,23,0.188,0.333,0.479,18.105,64,riffle_clumpy
0,21,21,5,47,0.447,26,0.553,4,2,0.667,2,4,24,23,15,19,13,0.319,0.404,0.277,18.094,65,riffle_clumpy
0,14,30,4,48,0.292,18,0.375,1,2,0.333,1,1,31,17,7,19,22,0.146,0.396,0.458,18.089,66,riffle_clumpy
0,20,25,4,49,0.408,24,0.49,2,2,0.5,3,4,30,19,13,13,23,0.265,0.265,0.469,18.087,67,riffle_clumpy
0,16,29,3,48,0.333,19,0.396,3,2,0.6,2,0,26,22,8,21,19,0.167,0.438,0.396,18.082,68,riffle_clumpy
0,16,27,4,47,0.34,20,0.426,1,3,0.25,1,0,28,19,10,19,18,0.213,0.404,0.383,18.084,69,riffle_clumpy
0,18,21,7,46,0.391,25,0.543,3,2,0.6,1,4,27,19,12,19,15,0.261,0.413,0.326,18.082,70,riffle_clumpy
0,21,21,3,45,0.467,24,0.533,4,6,0.4,3,0,33,12,10,15,20,0.222,0.333,0.444,18.09,71,riffle_clumpy
0,25,19,1,45,0.556,26,0.578,2,1,0.667,3,1,29,16,14,15,16,0.311,0.333,0.356,18.086,72,riffle_clumpy
0,24,17,4,45,0.533,28,0.622,2,5,0.286,3,1,25,20,18,14,13,0.4,0.311,0.289,18.087,73,riffle_clumpy
0,27,17,1,45,0.6,28,0.622,7,2,0.778,2,1,28,17,15,14,16,0.333,0.311,0.356,18.083,74,riffle_clumpy
0,17,26,5,48,0.354,22,0.458,1,4,0.2,3,2,28,20,8,21,19,0.167,0.438,0.396,18.086,75,riffle_clumpy
0,15,33,3,51,0.294,18,0.353,1,4,0.2,2,5,36,15,5,20,26,0.098,0.392,0.51,18.088,76,riffle_clumpy
0,23,21,3,47,0.489,26,0.553,1,3,0.25,2,1,31,16,13,18,16,0.277,0.383,0.34,18.088,77,riffle_clumpy
0,15,28,5,48,0.312,20,0.417,4,1,0.8,2,2,36,12,9,20,19,0.188,0.417,0.396,18.1,78,riffle_clumpy
0,15,25,6,46,0.326,21,0.457,3,0,1.0,2,2,22,24,9,18,19,0.196,0.391,0.413,18.095,79,riffle_clumpy
0,18,25,3,46,0.391,21,0.457,1,4,0.2,2,1,24,22,11,22,13,0.239,0.478,0.283,18.102,80,riffle_clumpy
0,24,20,3,47,0.511,27,0.574,2,0,1.0,1,4,32,15,16,12,19,0.34,0.255,0.404,18.105,81,riffle_clumpy
0,21,24,4,49,0.429,25,0.51,4,1,0.8,1,3,29,20,14,15,20,0.286,0.306,0.408,18.105,82,riffle_clumpy
0,26,17,1,44,0.591,27,0.614,5,0,1.0,0,3,29,15,22,9,13,0.5,0.205,0.295,18.105,83,riffle_clumpy
0,19,21,4,44,0.432,23,0.523,2,2,0.5,0,2,26,18,15,16,13,0.341,0.364,0.295,18.102,84,riffle_clumpy
0,18,23,4,45,0.4,22,0.489,5,1,0.833,0,2,28,17,11,17,17,0.244,0.378,0.378,18.105,85,riffle_clumpy
0,22,22,3,47,0.468,25,0.532,1,4,0.2,4,1,30,17,10,17,20,0.213,0.362,0.426,18.103,86,riffle_clumpy
0,10,35,3,48,0.208,13,0.271,0,6,0.0,2,5,30,18,7,19,22,0.146,0.396,0.458,18.105,87,riffle_clumpy
0,19,22,7,48,0.396,26,0.542,0,2,0.0,2,1,24,24,11,22,15,0.229,0.458,0.312,18.104,88,riffle_clumpy
0,18,23,7,48,0.375,25,0.521,2,1,0.667,4,1,34,14,11,15,22,0.229,0.312,0.458,18.107,89,riffle_clumpy
0,17,27,3,47,0.362,20,0.426,4,0,1.0,3,4,32,15,10,14,23,0.213,0.298,0.489,18.108,90,riffle_clumpy
0,17,28,2,47,0.362,19,0.404,1,1,0.5,1,1,27,20,10,21,16,0.213,0.447,0.34,18.113,91,riffle_clumpy
0,27,20,2,49,0.551,29,0.592,8,2,0.8,3,1,25,24,19,13,17,0.388,0.265,0.347,18.11,92,riffle_clumpy
0,24,20,2,46,0.522,26,0.565,2,1,0.667,3,1,28,18,14,16,16,0.304,0.348,0.348,18.106,93,riffle_clumpy
0,25,21,3,49,0.51,28,0.571,5,4,0.556,3,3,25,24,16,11,22,0.327,0.224,0.449,18.113,94,riffle_clumpy
0,18,30,2,50,0.36,20,0.4,0,2,0.0,3,2,23,27,8,22,20,0.16,0.44,0.4,18.118,95,riffle_clumpy
0,16,26,4,46,0.348,20,0.435,0,5,0.0,2,1,24,22,11,20,15,0.239,0.435,0.326,18.12,96,riffle_clumpy
0,22,22,4,48,0.458,26,0.542,2,2,0.5,5,2,34,14,11,12,25,0.229,0.25,0.521,17.594,1,riffle_clumpy
0,20,25,2,47,0.426,22,0.468,6,2,0.75,2,1,28,19,14,15,18,0.298,0.319,0.383,17.825,2,riffle_clumpy
0,23,24,2,49,0.469,25,0.51,3,3,0.5,2,2,28,21,13,18,18,0.265,0.367,0.367,17.964,3,riffle_clumpy
0,22,24,3,49,0.449,25,0.51,3,3,0.5,3,2,30,19,14,13,22,0.286,0.265,0.449,18.026,4,riffle_clumpy
0,21,22,4,47,0.447,25,0.532,6,2,0.75,3,4,28,19,13,17,17,0.277,0.362,0.362,18.022,5,riffle_clumpy
0,23,22,1,46,0.5,24,0.522,4,0,1.0,1,1,30,16,17,13,16,0.37,0.283,0.348,18.012,6,riffle_clumpy
0,22,25,3,50,0.44,25,0.5,3,4,0.429,1,3,26,24,15,19,16,0.3,0.38,0.32,18.042,7,riffle_clumpy
0,14,33,0,47,0.298,14,0.298,1,3,0.25,0,2,27,20,11,22,14,0.234,0.468,0.298,18.023,8,riffle_clumpy
0,27,19,5,51,0.529,32,0.627,4,1,0.8,1,1,30,21,14,18,19,0.275,0.353,0.373,18.081,9,riffle_clumpy
0,24,20,2,46,0.522,26,0.565,5,0,1.0,2,0,28,18,17,14,15,0.37,0.304,0.326,18.109,10,riffle_clumpy
0,19,21,4,44,0.432,23,0.523,2,2,0.5,0,1,27,17,14,17,13,0.318,0.386,0.295,18.111,11,riffle_clumpy
0,21,21,5,47,0.447,26,0.553,4,1,0.8,4,1,26,21,14,15,18,0.298,0.319,0.383,18.092,12,riffle_clumpy
0,13,28,4,45,0.289,17,0.378,2,2,0.5,0,2,24,21,9,19,17,0.2,0.422,0.378,18.112,13,riffle_clumpy
0,22,18,4,44,0.5,26,0.591,7,3,0.7,1,0,23,21,17,12,15,0.386,0.273,0.341,18.129,14,riffle_clumpy
0,19,27,1,47,0.404,20,0.426,3,1,0.75,4,2,31,16,10,15,22,0.213,0.319,0.468,18.089,15,riffle_clumpy
0,16,25,7,48,0.333,23,0.479,1,0,1.0,2,4,30,18,13,15,20,0.271,0.312,0.417,18.072,16,riffle_clumpy
0,21,18,6,45,0.467,27,0.6,4,2,0.667,3,0,21,24,11,17,17,0.244,0.378,0.378,18.073,17,riffle_clumpy
0,24,23,1,48,0.5,25,0.521,3,4,0.429,2,2,25,23,12,17,19,0.25,0.354,0.396,18.074,18,riffle_clumpy
0,20,20,6,46,0.435,26,0.565,2,2,0.5,2,2,29,17,11,13,22,0.239,0.283,0.478,18.051,19,riffle_clumpy
0,18,27,1,46,0.391,19,0.413,1,4,0.2,3,1,26,20,10,18,18,0.217,0.391,0.391,18.009,20,riffle_clumpy
0,24,21,1,46,0.522,25,0.543,10,0,1.0,0,3,28,18,18,14,14,0.391,0.304,0.304,18.005,21,riffle_clumpy
0,19,28,0,47,0.404,19,0.404,4,1,0.8,1,3,25,22,13,12,22,0.277,0.255,0.468,18.013,22,riffle_clumpy
0,22,21,3,46,0.478,25,0.543,2,1,0.667,2,3,27,19,14,17,15,0.304,0.37,0.326,17.997,23,riffle_clumpy
0,19,27,1,47,0.404,20,0.426,6,1,0.857,3,2,31,16,9,13,25,0.191,0.277,0.532,17.964,24,riffle_clumpy
0,19,26,4,49,0.388,23,0.469,0,5,0.0,1,1,32,17,12,15,22,0.245,0.306,0.449,17.977,25,riffle_clumpy
0,17,23,6,46,0.37,23,0.5,2,2,0.5,2,3,29,17,8,22,16,0.174,0.478,0.348,17.978,26,riffle_clumpy
0,20,21,5,46,0.435,25,0.543,3,1,0.75,2,4,32,14,16,11,19,0.348,0.239,0.413,17.995,27,riffle_clumpy
0,14,28,5,47,0.298,19,0.404,1,4,0.2,1,1,32,15,7,20,20,0.149,0.426,0.426,18.013,28,riffle_clumpy
0,19,28,1,48,0.396,20,0.417,4,5,0.444,2,2,31,17,11,16,21,0.229,0.333,0.438,18.022,29,riffle_clumpy
0,23,20,6,49,0.469,29,0.592,5,3,0.625,6,0,23,26,12,17,20,0.245,0.347,0.408,18.018,30,riffle_clumpy
0,23,22,0,45,0.511,23,0.511,3,5,0.375,2,1,26,19,13,18,14,0.289,0.4,0.311,18.023,31,riffle_clumpy
0,15,23,9,47,0.319,24,0.511,3,2,0.6,1,3,27,20,11,14,22,0.234,0.298,0.468,18.033,32,riffle_clumpy
0,24,21,2,47,0.511,26,0.553,3,1,0.75,2,1,27,20,13,15,19,0.277,0.319,0.404,18.033,33,riffle_clumpy
0,17,25,4,46,0.37,21,0.457,0,4,0.0,2,1,26,20,13,17,16,0.283,0.37,0.348,18.034,34,riffle_clumpy
0,29,13,2,44,0.659,31,0.705,3,2,0.6,2,4,24,20,21,9,14,0.477,0.205,0.318,18.029,35,riffle_clumpy
0,21,25,2,48,0.438,23,0.479,5,5,0.5,2,1,29,19,9,23,16,0.188,0.479,0.333,18.046,36,riffle_clumpy
0,21,25,4,50,0.42,25,0.5,5,3,0.625,1,2,28,22,16,17,17,0.32,0.34,0.34,18.042,37,riffle_clumpy
0,19,24,3,46,0.413,22,0.478,5,2,0.714,1,2,32,14,10,15,21,0.217,0.326,0.457,18.053,38,riffle_clumpy
0,19,25,2,46,0.413,21,0.457,3,3,0.5,3,0,34,12,13,12,21,0.283,0.261,0.457,18.049,39,riffle_clumpy
0,24,16,5,45,0.533,29,0.644,2,4,0.333,5,1,28,17,12,15,18,0.267,0.333,0.4,18.028,40,riffle_clumpy
0,24,24,1,49,0.49,25,0.51,4,2,0.667,1,1,31,18,15,18,16,0.306,0.367,0.327,18.023,41,riffle_clumpy
0,22,22,3,47,0.468,25,0.532,1,3,0.25,4,2,28,19,15,11,21,0.319,0.234,0.447,18.003,42,riffle_clumpy
0,19,27,2,48,0.396,21,0.438,1,4,0.2,1,5,28,20,12,16,20,0.25,0.333,0.417,17.995,43,riffle_clumpy
0,19,25,4,48,0.396,23,0.479,0,0,0,3,2,26,22,11,19,18,0.229,0.396,0.375,18.004,44,riffle_clumpy
0,20,23,3,46,0.435,23,0.5,4,0,1.0,0,1,28,18,14,12,20,0.304,0.261,0.435,18.006,45,riffle_clumpy
0,23,19,5,47,0.489,28,0.596,2,3,0.4,2,1,28,19,13,15,19,0.277,0.319,0.404,18.004,46,riffle_clumpy
0,21,23,1,45,0.467,22,0.489,5,3,0.625,3,0,28,17,15,13,17,0.333,0.289,0.378,18.005,47,riffle_clumpy
0,21,20,7,48,0.438,28,0.583,1,2,0.333,1,0,27,21,13,17,18,0.271,0.354,0.375,18.006,48,riffle_clumpy
0,19,20,5,44,0.432,24,0.545,4,3,0.571,3,1,26,18,11,16,17,0.25,0.364,0.386,18.004,49,riffle_clumpy
0,21,25,3,49,0.429,24,0.49,3,3,0.5,2,5,34,15,15,14,20,0.306,0.286,0.408,18.0,50,riffle_clumpy
0,24,18,2,44,0.545,26,0.591,4,1,0.8,1,3,25,19,16,15,13,0.364,0.341,0.295,17.996,51,riffle_clumpy
0,23,22,2,47,0.489,25,0.532,7,2,0.778,0,3,30,17,14,16,17,0.298,0.34,0.362,18.001,52,riffle_clumpy
0,21,23,5,49,0.429,26,0.531,2,1,0.667,4,2,28,21,15,15,19,0.306,0.306,0.388,17.988,53,riffle_clumpy
0,23,25,0,48,0.479,23,0.479,1,1,0.5,5,5,29,19,11,11,26,0.229,0.229,0.542,17.981,54,riffle_clumpy
0,25,21,5,51,0.49,30,0.588,3,1,0.75,4,5,32,19,17,12,22,0.333,0.235,0.431,17.982,55,riffle_clumpy
0,20,22,3,45,0.444,23,0.511,1,3,0.25,3,0,30,15,13,16,16,0.289,0.356,0.356,17.985,56,riffle_clumpy
0,24,18,4,46,0.522,28,0.609,0,0,0,2,2,27,19,14,14,18,0.304,0.304,0.391,17.982,57,riffle_clumpy
0,18,24,6,48,0.375,24,0.5,5,2,0.714,3,2,33,15,10,17,21,0.208,0.354,0.438,17.982,58,riffle_clumpy
0,16,27,3,46,0.348,19,0.413,2,4,0.333,1,4,25,21,14,17,15,0.304,0.37,0.326,17.986,59,riffle_clumpy
0,15,29,5,49,0.306,20,0.408,2,3,0.4,2,1,28,21,6,24,19,0.122,0.49,0.388,18.003,60,riffle_clumpy
0,20,21,5,46,0.435,25,0.543,3,1,0.75,1,1,30,16,15,15,16,0.326,0.326,0.348,18.006,61,riffle_clumpy
0,16,27,3,46,0.348,19,0.413,6,3,0.667,2,3,26,20,10,18,18,0.217,0.391,0.391,18.009,62,riffle_clumpy
0,17,26,4,47,0.362,21,0.447,1,4,0.2,4,3,29,18,11,16,20,0.234,0.34,0.426,18.011,63,riffle_clumpy
0,20,31,0,51,0.392,20,0.392,0,0,0,2,2,32,19,14,18,19,0.275,0.353,0.373,18.016,64,riffle_clumpy
0,19,28,5,52,0.365,24,0.462,1,3,0.25,1,1,34,18,10,20,22,0.192,0.385,0.423,18.018,65,riffle_clumpy
0,17,24,4,45,0.378,21,0.467,5,0,1.0,3,2,26,19,13,16,16,0.289,0.356,0.356,18.014,66,riffle_clumpy
0,27,20,3,50,0.54,30,0.6,6,2,0.75,2,1,24,26,16,15,19,0.32,0.3,0.38,18.004,67,riffle_clumpy
0,25,19,3,47,0.532,28,0.596,4,1,0.8,2,0,28,19,16,13,18,0.34,0.277,0.383,17.999,68,riffle_clumpy
0,27,19,1,47,0.574,28,0.596,8,0,1.0,1,2,25,22,19,16,12,0.404,0.34,0.255,18.001,69,riffle_clumpy
0,26,16,3,45,0.578,29,0.644,8,2,0.8,2,1,19,26,17,16,12,0.378,0.356,0.267,18.006,70,riffle_clumpy
0,20,19,7,46,0.435,27,0.587,1,2,0.333,2,4,34,12,15,11,20,0.326,0.239,0.435,18.015,71,riffle_clumpy
0,13,30,4,47,0.277,17,0.362,1,2,0.333,4,4,27,20,6,23,18,0.128,0.489,0.383,18.018,72,riffle_clumpy
0,24,20,2,46,0.522,26,0.565,4,1,0.8,3,1,23,23,14,18,14,0.304,0.391,0.304,18.023,73,riffle_clumpy
0,18,27,2,47,0.383,20,0.426,2,2,0.5,4,3,26,21,11,18,18,0.234,0.383,0.383,18.009,74,riffle_clumpy
0,18,24,3,45,0.4,21,0.467,1,2,0.333,3,1,26,19,10,19,16,0.222,0.422,0.356,18.004,75,riffle_clumpy
0,22,25,2,49,0.449,24,0.49,6,1,0.857,0,1,28,21,12,23,14,0.245,0.469,0.286,18.011,76,riffle_clumpy
0,23,24,0,47,0.489,23,0.489,4,2,0.667,7,2,29,18,11,15,21,0.234,0.319,0.447,18.007,77,riffle_clumpy
0,20,22,2,44,0.455,22,0.5,4,2,0.667,2,1,28,16,15,10,19,0.341,0.227,0.432,18.008,78,riffle_clumpy
0,18,27,4,49,0.367,22,0.449,3,2,0.6,1,0,29,20,8,21,20,0.163,0.429,0.408,18.014,79,riffle_clumpy
0,23,22,2,47,0.489,25,0.532,3,3,0.5,4,4,26,21,13,12,22,0.277,0.255,0.468,18.01,80,riffle_clumpy
0,32,11,3,46,0.696,35,0.761,4,0,1.0,1,4,33,13,20,9,17,0.435,0.196,0.37,18.007,81,riffle_clumpy
0,22,22,4,48,0.458,26,0.542,4,6,0.4,2,1,25,23,9,19,20,0.188,0.396,0.417,18.001,82,riffle_clumpy
0,20,20,6,46,0.435,26,0.565,4,0,1.0,4,3,26,20,12,16,18,0.261,0.348,0.391,18.002,83,riffle_clumpy
0,16,21,8,45,0.356,24,0.533,3,3,0.5,3,2,30,15,8,17,20,0.178,0.378,0.444,18.001,84,riffle_clumpy
0,21,23,5,49,0.429,26,0.531,3,2,0.6,3,2,34,15,12,14,23,0.245,0.286,0.469,17.995,85,riffle_clumpy
0,18,26,2,46,0.391,20,0.435,4,2,0.667,0,3,24,22,17,14,15,0.37,0.304,0.326,18.005,86,riffle_clumpy
0,21,24,2,47,0.447,23,0.489,3,2,0.6,3,2,30,17,12,13,22,0.255,0.277,0.468,18.002,87,riffle_clumpy
0,27,16,2,45,0.6,29,0.644,4,0,1.0,3,1,26,19,19,14,12,0.422,0.311,0.267,18.009,88,riffle_clumpy
0,18,28,0,46,0.391,18,0.391,1,2,0.333,1,1,28,18,9,17,20,0.196,0.37,0.435,18.007,89,riffle_clumpy
0,22,26,1,49,0.449,23,0.469,2,1,0.667,3,0,28,21,11,18,20,0.224,0.367,0.408,18.003,90,riffle_clumpy
0,16,27,4,47,0.34,20,0.426,2,2,0.5,1,1,28,19,11,18,18,0.234,0.383,0.383,18.008,91,riffle_clumpy
0,17,26,2,45,0.378,19,0.422,2,3,0.4,3,2,29,16,6,20,19,0.133,0.444,0.422,18.005,92,riffle_clumpy
0,24,20,2,46,0.522,26,0.565,4,5,0.444,0,1,29,17,14,14,18,0.304,0.304,0.391,18.008,93,riffle_clumpy
0,27,18,4,49,0.551,31,0.633,4,2,0.667,3,3,31,18,11,19,19,0.224,0.388,0.388,18.008,94,riffle_clumpy
0,19,22,5,46,0.413,24,0.522,3,5,0.375,3,1,31,15,12,17,17,0.261,0.37,0.37,18.013,95,riffle_clumpy
0,18,30,3,51,0.353,21,0.412,1,2,0.333,2,4,33,18,9,19,23,0.176,0.373,0.451,18.015,96,riffle_clumpy
0,13,25,10,48,0.271,23,0.479,4,3,0.571,2,5,36,12,6,16,26,0.125,0.333,0.542,18.514,1,riffle_clumpy
0,20,23,5,48,0.417,25,0.521,3,1,0.75,3,1,28,20,12,14,22,0.25,0.292,0.458,18.176,2,riffle_clumpy
0,20,23,3,46,0.435,23,0.5,1,2,0.333,2,0,25,21,11,19,16,0.239,0.413,0.348,18.175,3,riffle_clumpy
0,18,23,6,47,0.383,24,0.511,4,2,0.667,4,3,29,18,9,17,21,0.191,0.362,0.447,18.055,4,riffle_clumpy
0,15,31,3,49,0.306,18,0.367,3,1,0.75,1,5,30,19,7,22,20,0.143,0.449,0.408,18.139,5,riffle_clumpy
0,25,17,4,46,0.543,29,0.63,3,1,0.75,2,1,35,11,16,13,17,0.348,0.283,0.37,18.177,6,riffle_clumpy
0,17,28,1,46,0.37,18,0.391,3,4,0.429,2,6,25,21,9,18,19,0.196,0.391,0.413,18.146,7,riffle_clumpy
0,19,25,5,49,0.388,24,0.49,3,3,0.5,2,1,28,21,12,20,17,0.245,0.408,0.347,18.145,8,riffle_clumpy
0,28,14,3,45,0.622,31,0.689,5,3,0.625,1,0,23,22,14,16,15,0.311,0.356,0.333,18.151,9,riffle_clumpy
0,21,21,6,48,0.438,27,0.562,3,2,0.6,0,2,33,15,14,17,17,0.292,0.354,0.354,18.162,10,riffle_clumpy
0,22,27,3,52,0.423,25,0.481,1,2,0.333,3,4,24,28,13,22,17,0.25,0.423,0.327,18.128,11,riffle_clumpy
0,22,18,6,46,0.478,28,0.609,1,1,0.5,5,2,27,19,13,11,22,0.283,0.239,0.478,18.078,12,riffle_clumpy
0,20,24,4,48,0.417,24,0.5,4,1,0.8,3,1,33,15,12,14,22,0.25,0.292,0.458,18.077,13,riffle_clumpy
0,17,29,5,51,0.333,22,0.431,2,5,0.286,3,2,26,25,12,20,19,0.235,0.392,0.373,18.073,14,riffle_clumpy
0,16,28,3,47,0.34,19,0.404,0,4,0.0,0,5,28,19,12,15,20,0.255,0.319,0.426,18.065,15,riffle_clumpy
0,22,20,6,48,0.458,28,0.583,2,1,0.667,1,3,26,22,14,20,14,0.292,0.417,0.292,18.04,16,riffle_clumpy
0,16,28,3,47,0.34,19,0.404,1,4,0.2,4,2,29,18,9,16,22,0.191,0.34,0.468,18.0,17,riffle_clumpy
0,22,17,8,47,0.468,30,0.638,4,1,0.8,1,2,28,19,16,18,13,0.34,0.383,0.277,17.998,18,riffle_clumpy
0,24,18,5,47,0.511,29,0.617,5,2,0.714,3,2,24,23,11,14,22,0.234,0.298,0.468,17.97,19,riffle_clumpy
0,19,25,5,49,0.388,24,0.49,3,0,1.0,1,4,27,22,13,15,21,0.265,0.306,0.429,17.968,20,riffle_clumpy
0,17,25,2,44,0.386,19,0.432,1,3,0.25,0,3,32,12,15,16,13,0.341,0.364,0.295,17.985,21,riffle_clumpy
0,20,24,2,46,0.435,22,0.478,4,2,0.667,1,0,28,18,14,20,12,0.304,0.435,0.261,18.011,22,riffle_clumpy
0,20,22,3,45,0.444,23,0.511,7,3,0.7,0,2,25,20,12,15,18,0.267,0.333,0.4,18.001,23,riffle_clumpy
0,14,28,4,46,0.304,18,0.391,1,1,0.5,0,0,31,15,11,16,19,0.239,0.348,0.413,18.004,24,riffle_clumpy
0,19,26,0,45,0.422,19,0.422,2,2,0.5,2,1,31,14,12,17,16,0.267,0.378,0.356,17.981,25,riffle_clumpy
0,26,23,1,50,0.52,27,0.54,2,5,0.286,1,0,22,28,12,21,17,0.24,0.42,0.34,17.988,26,riffle_clumpy
0,27,20,2,49,0.551,29,0.592,3,3,0.5,0,4,28,21,18,14,17,0.367,0.286,0.347,17.995,27,riffle_clumpy
0,20,22,2,44,0.455,22,0.5,2,2,0.5,2,0,24,20,13,18,13,0.295,0.409,0.295,18.016,28,riffle_clumpy
0,21,27,1,49,0.429,22,0.449,4,0,1.0,1,3,28,21,13,16,20,0.265,0.327,0.408,18.038,29,riffle_clumpy
0,23,21,4,48,0.479,27,0.562,3,5,0.375,3,1,23,25,11,23,14,0.229,0.479,0.292,18.054,30,riffle_clumpy
0,27,16,1,44,0.614,28,0.636,1,1,0.5,2,2,21,23,21,12,11,0.477,0.273,0.25,18.035,31,riffle_clumpy
0,17,30,1,48,0.354,18,0.375,2,0,1.0,1,5,29,19,13,15,20,0.271,0.312,0.417,18.035,32,riffle_clumpy
0,19,23,4,46,0.413,23,0.5,3,1,0.75,0,3,24,22,18,15,13,0.391,0.326,0.283,18.043,33,riffle_clumpy
0,25,19,3,47,0.532,28,0.596,6,1,0.857,2,2,23,24,14,18,15,0.298,0.383,0.319,18.033,34,riffle_clumpy
0,24,19,4,47,0.511,28,0.596,7,0,1.0,4,3,33,14,8,17,22,0.17,0.362,0.468,18.024,35,riffle_clumpy
0,25,27,1,53,0.472,26,0.491,3,3,0.5,4,2,28,25,11,15,27,0.208,0.283,0.509,17.999,36,riffle_clumpy
0,20,29,4,53,0.377,24,0.453,3,6,0.333,2,7,35,18,12,14,27,0.226,0.264,0.509,17.984,37,riffle_clumpy
0,22,19,5,46,0.478,27,0.587,7,2,0.778,2,2,27,19,11,18,17,0.239,0.391,0.37,18.003,38,riffle_clumpy
0,18,21,8,47,0.383,26,0.553,1,1,0.5,1,4,29,18,11,20,16,0.234,0.426,0.34,18.007,39,riffle_clumpy
0,20,24,2,46,0.435,22,0.478,3,1,0.75,4,1,28,18,8,19,19,0.174,0.413,0.413,18.011,40,riffle_clumpy
0,16,28,3,47,0.34,19,0.404,1,4,0.2,4,2,28,19,9,13,25,0.191,0.277,0.532,18.028,41,riffle_clumpy
0,24,21,4,49,0.49,28,0.571,5,2,0.714,1,1,26,23,12,21,16,0.245,0.429,0.327,18.04,42,riffle_clumpy
0,22,24,3,49,0.449,25,0.51,2,2,0.5,4,2,32,17,12,15,22,0.245,0.306,0.449,18.035,43,riffle_clumpy
0,18,26,5,49,0.367,23,0.469,3,0,1.0,1,0,32,17,11,19,19,0.224,0.388,0.388,18.038,44,riffle_clumpy
0,19,26,2,47,0.404,21,0.447,4,2,0.667,0,1,26,21,15,19,13,0.319,0.404,0.277,18.032,45,riffle_clumpy
0,19,24,3,46,0.413,22,0.478,1,3,0.25,4,2,27,19,10,15,21,0.217,0.326,0.457,18.035,46,riffle_clumpy
0,24,21,2,47,0.511,26,0.553,3,3,0.5,3,0,22,25,9,21,17,0.191,0.447,0.362,18.026,47,riffle_clumpy
0,28,13,4,45,0.622,32,0.711,3,0,1.0,1,2,30,15,23,10,12,0.511,0.222,0.267,18.025,48,riffle_clumpy
0,17,27,5,49,0.347,22,0.449,1,4,0.2,2,3,34,15,7,21,21,0.143,0.429,0.429,18.032,49,riffle_clumpy
0,18,21,6,45,0.4,24,0.533,5,0,1.0,2,3,26,19,12,17,16,0.267,0.378,0.356,18.036,50,riffle_clumpy
0,18,26,5,49,0.367,23,0.469,0,2,0.0,1,3,24,25,13,16,20,0.265,0.327,0.408,18.041,51,riffle_clumpy
0,20,25,1,46,0.435,21,0.457,3,2,0.6,3,3,25,21,13,17,16,0.283,0.37,0.348,18.044,52,riffle_clumpy
0,20,22,3,45,0.444,23,0.511,4,1,0.8,0,0,30,15,14,14,17,0.311,0.311,0.378,18.043,53,riffle_clumpy
0,21,26,2,49,0.429,23,0.469,8,2,0.8,1,4,28,21,14,18,17,0.286,0.367,0.347,18.042,54,riffle_clumpy
0,22,21,5,48,0.458,27,0.562,3,1,0.75,3,3,32,16,14,10,24,0.292,0.208,0.5,18.056,55,riffle_clumpy
0,19,28,3,50,0.38,22,0.44,4,0,1.0,3,2,32,18,11,20,19,0.22,0.4,0.38,18.059,56,riffle_clumpy
0,21,25,4,50,0.42,25,0.5,1,2,0.333,2,2,28,22,9,23,18,0.18,0.46,0.36,18.061,57,riffle_clumpy
0,19,22,5,46,0.413,24,0.522,1,1,0.5,2,2,25,21,13,15,18,0.283,0.326,0.391,18.063,58,riffle_clumpy
0,17,24,5,46,0.37,22,0.478,2,1,0.667,4,3,30,16,11,10,25,0.239,0.217,0.543,18.059,59,riffle_clumpy
0,22,20,2,44,0.5,24,0.545,4,2,0.667,2,1,25,19,13,16,15,0.295,0.364,0.341,18.06,60,riffle_clumpy
0,23,22,1,46,0.5,24,0.522,2,1,0.667,0,4,29,17,15,19,12,0.326,0.413,0.261,18.063,61,riffle_clumpy
0,22,20,5,47,0.468,27,0.574,3,2,0.6,2,3,28,19,17,14,16,0.362,0.298,0.34,18.061,62,riffle_clumpy
0,26,20,0,46,0.565,26,0.565,4,3,0.571,1,1,28,18,19,17,10,0.413,0.37,0.217,18.068,63,riffle_clumpy
0,16,30,2,48,0.333,18,0.375,5,1,0.833,1,5,31,17,9,16,23,0.188,0.333,0.479,18.059,64,riffle_clumpy
0,25,17,5,47,0.532,30,0.638,5,2,0.714,3,1,29,18,16,15,16,0.34,0.319,0.34,18.056,65,riffle_clumpy
0,17,23,7,47,0.362,24,0.511,2,3,0.4,1,2,29,18,13,17,17,0.277,0.362,0.362,18.056,66,riffle_clumpy
0,25,23,2,50,0.5,27,0.54,5,2,0.714,2,1,31,19,14,16,20,0.28,0.32,0.4,18.049,67,riffle_clumpy
0,24,18,3,45,0.533,27,0.6,3,2,0.6,2,2,19,26,17,15,13,0.378,0.333,0.289,18.054,68,riffle_clumpy
0,19,22,5,46,0.413,24,0.522,3,2,0.6,2,0,32,14,11,16,19,0.239,0.348,0.413,18.062,69,riffle_clumpy
0,21,23,2,46,0.457,23,0.5,1,0,1.0,3,2,28,18,12,19,15,0.261,0.413,0.326,18.049,70,riffle_clumpy
0,21,19,6,46,0.457,27,0.587,4,5,0.444,2,2,23,23,15,16,15,0.326,0.348,0.326,18.045,71,riffle_clumpy
0,25,20,2,47,0.532,27,0.574,4,1,0.8,3,1,30,17,13,13,21,0.277,0.277,0.447,18.039,72,riffle_clumpy
0,17,30,1,48,0.354,18,0.375,5,5,0.5,0,6,26,22,8,24,16,0.167,0.5,0.333,18.042,73,riffle_clumpy
0,25,18,3,46,0.543,28,0.609,4,3,0.571,1,1,29,17,10,13,23,0.217,0.283,0.5,18.037,74,riffle_clumpy
0,22,26,0,48,0.458,22,0.458,5,4,0.556,4,3,25,23,14,14,20,0.292,0.292,0.417,18.036,75,riffle_clumpy
0,22,23,1,46,0.478,23,0.5,2,5,0.286,4,2,20,26,13,18,15,0.283,0.391,0.326,18.028,76,riffle_clumpy
0,21,26,3,50,0.42,24,0.48,3,1,0.75,2,1,30,20,14,14,22,0.28,0.28,0.44,18.036,77,riffle_clumpy
0,20,25,3,48,0.417,23,0.479,5,2,0.714,2,2,34,14,10,13,25,0.208,0.271,0.521,18.042,78,riffle_clumpy
0,19,26,2,47,0.404,21,0.447,6,2,0.75,4,1,26,21,10,19,18,0.213,0.404,0.383,18.042,79,riffle_clumpy
0,18,22,4,44,0.409,22,0.5,4,0,1.0,1,3,32,12,11,16,17,0.25,0.364,0.386,18.042,80,riffle_clumpy
0,16,25,5,46,0.348,21,0.457,3,0,1.0,2,1,27,19,11,19,16,0.239,0.413,0.348,18.042,81,riffle_clumpy
0,23,24,3,50,0.46,26,0.52,4,1,0.8,4,2,31,19,11,18,21,0.22,0.36,0.42,18.03,82,riffle_clumpy
0,24,21,2,47,0.511,26,0.553,5,4,0.556,1,2,27,20,16,13,18,0.34,0.277,0.383,18.029,83,riffle_clumpy
0,13,28,4,45,0.289,17,0.378,2,1,0.667,1,3,25,20,10,22,13,0.222,0.489,0.289,18.03,84,riffle_clumpy
0,18,26,6,50,0.36,24,0.48,0,5,0.0,3,5,29,21,10,21,19,0.2,0.42,0.38,18.029,85,riffle_clumpy
0,25,19,1,45,0.556,26,0.578,2,1,0.667,2,4,28,17,17,11,17,0.378,0.244,0.378,18.024,86,riffle_clumpy
0,17,25,5,47,0.362,22,0.468,2,4,0.333,2,1,28,19,8,18,21,0.17,0.383,0.447,18.029,87,riffle_clumpy
0,23,19,3,45,0.511,26,0.578,4,2,0.667,2,0,24,21,18,15,12,0.4,0.333,0.267,18.029,88,riffle_clumpy
0,21,23,1,45,0.467,22,0.489,4,1,0.8,2,2,24,21,16,11,18,0.356,0.244,0.4,18.027,89,riffle_clumpy
0,26,15,3,44,0.591,29,0.659,2,1,0.667,2,2,23,21,14,21,9,0.318,0.477,0.205,18.029,90,riffle_clumpy
0,23,20,3,46,0.5,26,0.565,4,3,0.571,2,1,29,17,12,15,19,0.261,0.326,0.413,18.024,91,riffle_clumpy
0,23,20,4,47,0.489,27,0.574,3,0,1.0,1,1,31,16,17,14,16,0.362,0.298,0.34,18.019,92,riffle_clumpy
0,17,28,2,47,0.362,19,0.404,2,4,0.333,2,5,33,14,11,14,22,0.234,0.298,0.468,18.015,93,riffle_clumpy
0,19,22,6,47,0.404,25,0.532,5,4,0.556,2,2,26,21,10,15,22,0.213,0.319,0.468,18.014,94,riffle_clumpy
0,20,22,3,45,0.444,23,0.511,2,4,0.333,0,1,31,14,15,16,14,0.333,0.356,0.311,18.017,95,riffle_clumpy
0,22,23,1,46,0.478,23,0.5,2,5,0.286,4,1,32,14,13,12,21,0.283,0.261,0.457,18.012,96,riffle_clumpy
0,17,23,6,46,0.37,23,0.5,2,3,0.4,4,0,33,13,7,16,23,0.152,0.348,0.5,18.0,1,riffle_clumpy
0,20,24,2,46,0.435,22,0.478,5,3,0.625,0,0,28,18,14,14,18,0.304,0.304,0.391,17.985,2,riffle_clumpy
0,23,24,0,47,0.489,23,0.489,3,3,0.5,4,2,26,21,12,15,20,0.255,0.319,0.426,17.882,3,riffle_clumpy
0,24,17,4,45,0.533,28,0.622,4,0,1.0,2,4,29,16,19,12,14,0.422,0.267,0.311,17.922,4,riffle_clumpy
0,22,26,3,51,0.431,25,0.49,6,7,0.462,2,2,22,29,13,22,16,0.255,0.431,0.314,18.021,5,riffle_clumpy
0,20,24,2,46,0.435,22,0.478,2,0,1.0,2,1,26,20,11,14,21,0.239,0.304,0.457,18.0,6,riffle_clumpy
0,17,27,1,45,0.378,18,0.4,2,3,0.4,3,2,22,23,12,20,13,0.267,0.444,0.289,17.901,7,riffle_clumpy
0,22,24,2,48,0.458,24,0.5,2,4,0.333,3,3,31,17,14,11,23,0.292,0.229,0.479,17.914,8,riffle_clumpy
0,15,27,4,46,0.326,19,0.413,4,1,0.8,2,4,31,15,8,20,18,0.174,0.435,0.391,17.954,9,riffle_clumpy
0,25,23,2,50,0.5,27,0.54,5,3,0.625,3,2,28,22,14,14,22,0.28,0.28,0.44,17.993,10,riffle_clumpy
0,22,26,3,51,0.431,25,0.49,2,0,1.0,1,2,35,16,11,15,25,0.216,0.294,0.49,18.003,11,riffle_clumpy
0,24,20,2,46,0.522,26,0.565,9,2,0.818,3,1,28,18,12,16,18,0.261,0.348,0.391,17.969,12,riffle_clumpy
0,17,26,3,46,0.37,20,0.435,0,5,0.0,2,0,32,14,10,17,19,0.217,0.37,0.413,17.992,13,riffle_clumpy
0,19,25,5,49,0.388,24,0.49,4,3,0.571,2,2,30,19,9,17,23,0.184,0.347,0.469,17.945,14,riffle_clumpy
0,25,20,1,46,0.543,26,0.565,4,1,0.8,1,1,28,18,13,15,18,0.283,0.326,0.391,17.976,15,riffle_clumpy
0,15,29,3,47,0.319,18,0.383,4,2,0.667,3,0,31,16,6,21,20,0.128,0.447,0.426,17.977,16,riffle_clumpy
0,17,25,4,46,0.37,21,0.457,2,3,0.4,3,1,30,16,9,19,18,0.196,0.413,0.391,17.99,17,riffle_clumpy
0,23,22,2,47,0.489,25,0.532,4,1,0.8,3,3,26,21,15,8,24,0.319,0.17,0.511,18.0,18,riffle_clumpy
0,25,18,2,45,0.556,27,0.6,2,1,0.667,4,2,29,16,16,15,14,0.356,0.333,0.311,17.989,19,riffle_clumpy
0,19,28,2,49,0.388,21,0.429,1,1,0.5,2,2,34,15,9,15,25,0.184,0.306,0.51,18.012,20,riffle_clumpy
0,26,19,2,47,0.553,28,0.596,6,0,1.0,3,1,29,18,15,16,16,0.319,0.34,0.34,17.99,21,riffle_clumpy
0,24,19,3,46,0.522,27,0.587,3,1,0.75,3,2,23,23,17,11,18,0.37,0.239,0.391,17.926,22,riffle_clumpy
0,19,25,1,45,0.422,20,0.444,3,2,0.6,2,2,27,18,13,15,17,0.289,0.333,0.378,17.942,23,riffle_clumpy
0,17,26,4,47,0.362,21,0.447,2,2,0.5,1,2,30,17,8,21,18,0.17,0.447,0.383,17.953,24,riffle_clumpy
0,23,23,1,47,0.489,24,0.511,3,2,0.6,2,2,27,20,15,15,17,0.319,0.319,0.362,17.945,25,riffle_clumpy
0,22,19,4,45,0.489,26,0.578,5,2,0.714,0,2,27,18,15,15,15,0.333,0.333,0.333,17.958,26,riffle_clumpy
0,20,20,3,43,0.465,23,0.535,5,0,1.0,0,1,25,18,13,19,11,0.302,0.442,0.256,17.973,27,riffle_clumpy
0,21,18,6,45,0.467,27,0.6,4,1,0.8,1,3,31,14,13,13,19,0.289,0.289,0.422,17.964,28,riffle_clumpy
0,22,22,3,47,0.468,25,0.532,3,2,0.6,1,1,32,15,11,18,18,0.234,0.383,0.383,17.968,29,riffle_clumpy
0,17,22,8,47,0.362,25,0.532,4,0,1.0,1,2,29,18,11,20,16,0.234,0.426,0.34,17.971,30,riffle_clumpy
0,19,28,2,49,0.388,21,0.429,5,2,0.714,3,5,29,20,14,15,20,0.286,0.306,0.408,17.963,31,riffle_clumpy
0,22,22,4,48,0.458,26,0.542,3,4,0.429,0,2,31,17,15,15,18,0.312,0.312,0.375,17.984,32,riffle_clumpy
0,16,28,2,46,0.348,18,0.391,3,3,0.5,1,2,31,15,7,14,25,0.152,0.304,0.543,18.003,33,riffle_clumpy
0,19,22,5,46,0.413,24,0.522,2,1,0.667,1,2,24,22,15,15,16,0.326,0.326,0.348,18.002,34,riffle_clumpy
0,21,23,3,47,0.447,24,0.511,3,0,1.0,1,1,30,17,10,20,17,0.213,0.426,0.362,18.019,35,riffle_clumpy
0,26,18,2,46,0.565,28,0.609,3,2,0.6,1,3,28,18,20,11,15,0.435,0.239,0.326,18.014,36,riffle_clumpy
0,29,15,4,48,0.604,33,0.688,2,1,0.667,4,1,31,17,18,12,18,0.375,0.25,0.375,18.02,37,riffle_clumpy
0,19,24,4,47,0.404,23,0.489,6,3,0.667,2,4,29,18,14,11,22,0.298,0.234,0.468,18.038,38,riffle_clumpy
0,18,31,3,52,0.346,21,0.404,2,2,0.5,4,2,36,16,8,20,24,0.154,0.385,0.462,18.048,39,riffle_clumpy
0,16,26,3,45,0.356,19,0.422,0,1,0.0,0,3,32,13,12,18,15,0.267,0.4,0.333,18.03,40,riffle_clumpy
0,20,27,4,51,0.392,24,0.471,5,2,0.714,0,3,28,23,16,17,18,0.314,0.333,0.353,18.038,41,riffle_clumpy
0,24,21,3,48,0.5,27,0.562,4,1,0.8,3,4,30,18,14,16,18,0.292,0.333,0.375,18.028,42,riffle_clumpy
0,17,24,3,44,0.386,20,0.455,3,1,0.75,1,4,25,19,11,14,19,0.25,0.318,0.432,18.028,43,riffle_clumpy
0,19,24,3,46,0.413,22,0.478,3,3,0.5,2,1,28,18,8,16,22,0.174,0.348,0.478,18.017,44,riffle_clumpy
0,16,27,2,45,0.356,18,0.4,2,1,0.667,0,1,27,18,12,17,16,0.267,0.378,0.356,17.998,45,riffle_clumpy
0,23,22,1,46,0.5,24,0.522,4,3,0.571,2,2,23,23,12,17,17,0.261,0.37,0.37,18.003,46,riffle_clumpy
0,20,24,5,49,0.408,25,0.51,3,3,0.5,1,2,31,18,15,18,16,0.306,0.367,0.327,17.999,47,riffle_clumpy
0,19,22,3,44,0.432,22,0.5,2,3,0.4,3,1,26,18,13,16,15,0.295,0.364,0.341,17.99,48,riffle_clumpy
0,18,27,3,48,0.375,21,0.438,1,2,0.333,3,2,33,15,10,19,19,0.208,0.396,0.396,17.993,49,riffle_clumpy
0,21,20,5,46,0.457,26,0.565,2,1,0.667,1,1,25,21,13,20,13,0.283,0.435,0.283,18.0,50,riffle_clumpy
0,14,32,3,49,0.286,17,0.347,3,1,0.75,2,5,29,20,9,23,17,0.184,0.469,0.347,18.01,51,riffle_clumpy
0,17,27,2,46,0.37,19,0.413,4,3,0.571,1,0,29,17,11,19,16,0.239,0.413,0.348,18.017,52,riffle_clumpy
0,23,21,3,47,0.489,26,0.553,2,1,0.667,1,2,28,19,15,16,16,0.319,0.34,0.34,18.025,53,riffle_clumpy
0,19,24,6,49,0.388,25,0.51,3,0,1.0,3,1,26,23,10,17,22,0.204,0.347,0.449,18.027,54,riffle_clumpy
0,27,19,4,50,0.54,31,0.62,8,4,0.667,4,1,31,19,16,16,18,0.32,0.32,0.36,18.022,55,riffle_clumpy
0,20,23,2,45,0.444,22,0.489,1,2,0.333,2,0,19,26,11,25,9,0.244,0.556,0.2,18.036,56,riffle_clumpy
0,16,28,3,47,0.34,19,0.404,2,2,0.5,3,5,27,20,11,14,22,0.234,0.298,0.468,18.043,57,riffle_clumpy
0,18,24,2,44,0.409,20,0.455,6,0,1.0,0,3,28,16,15,13,16,0.341,0.295,0.364,18.045,58,riffle_clumpy
0,26,21,5,52,0.5,31,0.596,4,1,0.8,3,2,29,23,13,21,18,0.25,0.404,0.346,18.044,59,riffle_clumpy
0,19,27,3,49,0.388,22,0.449,3,0,1.0,3,3,26,23,12,17,20,0.245,0.347,0.408,18.038,60,riffle_clumpy
0,20,25,2,47,0.426,22,0.468,2,1,0.667,1,5,26,21,13,16,18,0.277,0.34,0.383,18.037,61,riffle_clumpy
0,23,22,4,49,0.469,27,0.551,1,4,0.2,2,4,28,21,20,12,17,0.408,0.245,0.347,18.039,62,riffle_clumpy
0,21,25,1,47,0.447,22,0.468,3,0,1.0,5,3,32,15,15,11,21,0.319,0.234,0.447,18.033,63,riffle_clumpy
0,25,17,5,47,0.532,30,0.638,7,1,0.875,3,2,25,22,13,17,17,0.277,0.362,0.362,18.034,64,riffle_clumpy
0,16,27,4,47,0.34,20,0.426,1,1,0.5,1,1,31,16,12,17,18,0.255,0.362,0.383,18.036,65,riffle_clumpy
0,23,24,2,49,0.469,25,0.51,3,1,0.75,1,0,32,17,9,18,22,0.184,0.367,0.449,18.031,66,riffle_clumpy
0,24,21,3,48,0.5,27,0.562,2,0,1.0,3,1,29,19,13,14,21,0.271,0.292,0.438,18.033,67,riffle_clumpy
0,23,19,3,45,0.511,26,0.578,4,3,0.571,4,1,22,23,17,14,14,0.378,0.311,0.311,18.034,68,riffle_clumpy
0,24,20,1,45,0.533,25,0.556,4,3,0.571,2,2,25,20,13,18,14,0.289,0.4,0.311,18.029,69,riffle_clumpy
0,25,19,5,49,0.51,30,0.612,4,1,0.8,5,4,35,14,16,13,20,0.327,0.265,0.408,18.025,70,riffle_clumpy
0,23,19,5,47,0.489,28,0.596,0,1,0.0,4,2,31,16,14,14,19,0.298,0.298,0.404,18.03,71,riffle_clumpy
0,14,31,0,45,0.311,14,0.311,0,5,0.0,2,1,25,20,10,16,19,0.222,0.356,0.422,18.026,72,riffle_clumpy
0,21,23,3,47,0.447,24,0.511,5,1,0.833,3,3,32,15,10,13,24,0.213,0.277,0.511,18.034,73,riffle_clumpy
0,20,23,4,47,0.426,24,0.511,1,4,0.2,1,1,19,28,11,22,14,0.234,0.468,0.298,18.033,74,riffle_clumpy
0,23,23,3,49,0.469,26,0.531,2,1,0.667,3,2,27,22,11,24,14,0.224,0.49,0.286,18.037,75,riffle_clumpy
0,18,26,3,47,0.383,21,0.447,2,1,0.667,1,3,28,19,12,16,19,0.255,0.34,0.404,18.042,76,riffle_clumpy
0,20,22,4,46,0.435,24,0.522,3,2,0.6,4,1,29,17,11,12,23,0.239,0.261,0.5,18.042,77,riffle_clumpy
0,21,20,5,46,0.457,26,0.565,5,0,1.0,3,1,25,21,10,21,15,0.217,0.457,0.326,18.035,78,riffle_clumpy
0,17,26,3,46,0.37,20,0.435,5,2,0.714,0,1,24,22,14,14,18,0.304,0.304,0.391,18.042,79,riffle_clumpy
0,20,21,4,45,0.444,24,0.533,3,1,0.75,2,3,26,19,15,16,14,0.333,0.356,0.311,18.041,80,riffle_clumpy
0,24,21,2,47,0.511,26,0.553,1,1,0.5,3,3,35,12,15,17,15,0.319,0.362,0.319,18.034,81,riffle_clumpy
0,21,24,2,47,0.447,23,0.489,3,2,0.6,1,3,34,13,12,14,21,0.255,0.298,0.447,18.035,82,riffle_clumpy
0,19,22,5,46,0.413,24,0.522,4,2,0.667,0,2,32,14,11,13,22,0.239,0.283,0.478,18.041,83,riffle_clumpy
0,19,25,4,48,0.396,23,0.479,3,2,0.6,0,1,33,15,14,12,22,0.292,0.25,0.458,18.042,84,riffle_clumpy
0,16,28,2,46,0.348,18,0.391,4,4,0.5,1,2,31,15,9,12,25,0.196,0.261,0.543,18.033,85,riffle_clumpy
0,21,25,4,50,0.42,25,0.5,2,5,0.286,3,2,33,17,11,16,23,0.22,0.32,0.46,18.031,86,riffle_clumpy
0,19,26,2,47,0.404,21,0.447,1,2,0.333,1,2,29,18,12,13,22,0.255,0.277,0.468,18.031,87,riffle_clumpy
0,17,27,4,48,0.354,21,0.438,2,1,0.667,0,1,23,25,9,22,17,0.188,0.458,0.354,18.037,88,riffle_clumpy
0,20,22,3,45,0.444,23,0.511,1,3,0.25,2,0,28,17,13,17,15,0.289,0.378,0.333,18.042,89,riffle_clumpy
0,21,20,4,45,0.467,25,0.556,2,2,0.5,2,2,26,19,16,13,16,0.356,0.289,0.356,18.044,90,riffle_clumpy
0,22,26,1,49,0.449,23,0.469,0,4,0.0,1,4,28,21,15,15,19,0.306,0.306,0.388,18.039,91,riffle_clumpy
0,19,22,6,47,0.404,25,0.532,2,3,0.4,1,1,31,16,12,14,21,0.255,0.298,0.447,18.036,92,riffle_clumpy
0,25,19,1,45,0.556,26,0.578,0,1,0.0,1,4,26,19,17,14,14,0.378,0.311,0.311,18.031,93,riffle_clumpy
0,22,21,5,48,0.458,27,0.562,3,2,0.6,2,3,27,21,12,17,19,0.25,0.354,0.396,18.031,94,riffle_clumpy
0,26,19,1,46,0.565,27,0.587,6,0,1.0,4,1,32,14,16,11,19,0.348,0.239,0.413,18.031,95,riffle_clumpy
0,23,23,1,47,0.489,24,0.511,5,4,0.556,2,6,36,11,15,14,18,0.319,0.298,0.383,18.029,96,riffle_clumpy
0,20,23,4,47,0.426,24,0.511,4,3,0.571,2,1,26,21,11,20,16,0.234,0.426,0.34,18.467,1,riffle_clumpy
0,23,19,2,44,0.523,25,0.568,5,4,0.556,1,0,25,19,12,19,13,0.273,0.432,0.295,18.362,2,riffle_clumpy
0,20,29,1,50,0.4,21,0.42,2,4,0.333,2,3,29,21,15,18,17,0.3,0.36,0.34,18.317,3,riffle_clumpy
0,18,24,5,47,0.383,23,0.489,4,0,1.0,3,3,25,22,12,17,18,0.255,0.362,0.383,18.327,4,riffle_clumpy
0,25,20,1,46,0.543,26,0.565,5,2,0.714,3,1,26,20,14,17,15,0.304,0.37,0.326,18.287,5,riffle_clumpy
0,21,25,1,47,0.447,22,0.468,4,1,0.8,2,5,31,16,14,16,17,0.298,0.34,0.362,18.129,6,riffle_clumpy
0,20,26,1,47,0.426,21,0.447,5,2,0.714,3,1,28,19,8,18,21,0.17,0.383,0.447,18.056,7,riffle_clumpy
0,15,33,2,50,0.3,17,0.34,2,2,0.5,1,4,30,20,10,20,20,0.2,0.4,0.4,18.136,8,riffle_clumpy
0,20,24,4,48,0.417,24,0.5,1,3,0.25,1,1,34,14,12,18,18,0.25,0.375,0.375,18.18,9,riffle_clumpy
0,22,21,3,46,0.478,25,0.543,4,2,0.667,0,1,26,20,17,13,16,0.37,0.283,0.348,18.211,10,riffle_clumpy
0,20,24,4,48,0.417,24,0.5,4,2,0.667,5,2,32,16,12,15,21,0.25,0.312,0.438,18.196,11,riffle_clumpy
0,22,26,2,50,0.44,24,0.48,3,1,0.75,6,2,30,20,10,17,23,0.2,0.34,0.46,18.083,12,riffle_clumpy
0,16,26,5,47,0.34,21,0.447,2,2,0.5,2,2,25,22,11,18,18,0.234,0.383,0.383,18.103,13,riffle_clumpy
0,19,25,3,47,0.404,22,0.468,3,3,0.5,1,1,29,18,15,16,16,0.319,0.34,0.34,18.096,14,riffle_clumpy
0,19,24,2,45,0.422,21,0.467,6,2,0.75,1,1,26,19,13,15,17,0.289,0.333,0.378,18.117,15,riffle_clumpy
0,19,18,8,45,0.422,27,0.6,3,1,0.75,0,3,29,16,13,18,14,0.289,0.4,0.311,18.124,16,riffle_clumpy
0,21,23,4,48,0.438,25,0.521,4,1,0.8,0,1,29,19,7,22,19,0.146,0.458,0.396,18.113,17,riffle_clumpy
0,19,25,1,45,0.422,20,0.444,5,3,0.625,0,2,29,16,13,11,21,0.289,0.244,0.467,18.115,18,riffle_clumpy
0,22,22,5,49,0.449,27,0.551,1,2,0.333,4,3,28,21,16,14,19,0.327,0.286,0.388,18.107,19,riffle_clumpy
0,19,25,2,46,0.413,21,0.457,4,1,0.8,3,4,27,19,10,18,18,0.217,0.391,0.391,18.1,20,riffle_clumpy
0,19,22,4,45,0.422,23,0.511,4,1,0.8,3,1,26,19,11,15,19,0.244,0.333,0.422,18.115,21,riffle_clumpy
0,25,17,2,44,0.568,27,0.614,2,0,1.0,2,2,28,16,17,13,14,0.386,0.295,0.318,18.112,22,riffle_clumpy
0,21,23,3,47,0.447,24,0.511,4,3,0.571,3,2,27,20,9,19,19,0.191,0.404,0.404,18.103,23,riffle_clumpy
0,19,21,7,47,0.404,26,0.553,3,3,0.5,2,3,33,14,11,16,20,0.234,0.34,0.426,18.106,24,riffle_clumpy
0,17,28,2,47,0.362,19,0.404,3,2,0.6,3,4,28,19,9,19,19,0.191,0.404,0.404,18.098,25,riffle_clumpy
0,28,19,1,48,0.583,29,0.604,2,0,1.0,4,2,33,15,19,8,21,0.396,0.167,0.438,18.087,26,riffle_clumpy
0,23,21,3,47,0.489,26,0.553,4,1,0.8,3,3,30,17,15,14,18,0.319,0.298,0.383,18.103,27,riffle_clumpy
0,22,21,4,47,0.468,26,0.553,5,4,0.556,1,3,30,17,15,11,21,0.319,0.234,0.447,18.106,28,riffle_clumpy
0,20,23,0,43,0.465,20,0.465,7,2,0.778,1,3,27,16,15,15,13,0.349,0.349,0.302,18.106,29,riffle_clumpy
0,20,25,2,47,0.426,22,0.468,2,3,0.4,3,3,25,22,12,15,20,0.255,0.319,0.426,18.12,30,riffle_clumpy
0,13,29,3,45,0.289,16,0.356,4,2,0.667,0,3,26,19,10,20,15,0.222,0.444,0.333,18.116,31,riffle_clumpy
0,22,25,3,50,0.44,25,0.5,4,4,0.5,4,5,28,22,11,20,19,0.22,0.4,0.38,18.116,32,riffle_clumpy
0,20,22,4,46,0.435,24,0.522,4,3,0.571,1,0,26,20,10,19,17,0.217,0.413,0.37,18.128,33,riffle_clumpy
0,22,21,2,45,0.489,24,0.533,7,0,1.0,2,1,25,20,16,14,15,0.356,0.311,0.333,18.116,34,riffle_clumpy
0,16,26,5,47,0.34,21,0.447,1,3,0.25,2,5,28,19,7,20,20,0.149,0.426,0.426,18.11,35,riffle_clumpy
0,17,31,0,48,0.354,17,0.354,1,5,0.167,1,4,31,17,13,15,20,0.271,0.312,0.417,18.113,36,riffle_clumpy
0,24,23,1,48,0.5,25,0.521,5,3,0.625,2,7,33,15,13,14,21,0.271,0.292,0.438,18.102,37,riffle_clumpy
0,23,22,1,46,0.5,24,0.522,0,1,0.0,5,2,26,20,14,17,15,0.304,0.37,0.326,18.087,38,riffle_clumpy
0,15,24,7,46,0.326,22,0.478,3,4,0.429,2,5,32,14,5,18,23,0.109,0.391,0.5,18.1,39,riffle_clumpy
0,26,14,2,42,0.619,28,0.667,6,3,0.667,2,2,24,18,19,13,10,0.452,0.31,0.238,18.093,40,riffle_clumpy
0,19,25,2,46,0.413,21,0.457,3,5,0.375,3,1,26,20,12,17,17,0.261,0.37,0.37,18.079,41,riffle_clumpy
0,19,30,0,49,0.388,19,0.388,5,4,0.556,1,1,29,20,12,14,23,0.245,0.286,0.469,18.066,42,riffle_clumpy
0,16,29,1,46,0.348,17,0.37,3,5,0.375,1,3,33,13,11,16,19,0.239,0.348,0.413,18.081,43,riffle_clumpy
0,24,23,2,49,0.49,26,0.531,4,1,0.8,1,0,29,20,16,18,15,0.327,0.367,0.306,18.08,44,riffle_clumpy
0,16,21,9,46,0.348,25,0.543,1,2,0.333,2,1,25,21,9,21,16,0.196,0.457,0.348,18.087,45,riffle_clumpy
0,22,22,4,48,0.458,26,0.542,8,1,0.889,2,1,28,20,9,18,21,0.188,0.375,0.438,18.09,46,riffle_clumpy
0,18,23,3,44,0.409,21,0.477,3,4,0.429,2,0,27,17,11,18,15,0.25,0.409,0.341,18.107,47,riffle_clumpy
0,22,23,2,47,0.468,24,0.511,1,1,0.5,3,1,24,23,13,19,15,0.277,0.404,0.319,18.112,48,riffle_clumpy
0,19,26,5,50,0.38,24,0.48,1,0,1.0,5,3,35,15,10,17,23,0.2,0.34,0.46,18.09,49,riffle_clumpy
0,18,30,1,49,0.367,19,0.388,3,4,0.429,0,1,23,26,10,21,18,0.204,0.429,0.367,18.108,50,riffle_clumpy
0,20,17,10,47,0.426,30,0.638,1,3,0.25,2,3,26,21,15,14,18,0.319,0.298,0.383,18.105,51,riffle_clumpy
0,25,21,2,48,0.521,27,0.562,2,1,0.667,1,2,27,21,16,15,17,0.333,0.312,0.354,18.111,52,riffle_clumpy
0,23,18,4,45,0.511,27,0.6,2,2,0.5,3,2,27,18,14,16,15,0.311,0.356,0.333,18.103,53,riffle_clumpy
0,22,20,2,44,0.5,24,0.545,1,4,0.2,2,2,30,14,16,16,12,0.364,0.364,0.273,18.103,54,riffle_clumpy
0,17,24,5,46,0.37,22,0.478,3,2,0.6,2,10,29,17,12,15,19,0.261,0.326,0.413,18.106,55,riffle_clumpy
0,20,22,4,46,0.435,24,0.522,2,4,0.333,3,2,35,11,13,14,19,0.283,0.304,0.413,18.111,56,riffle_clumpy
0,22,24,0,46,0.478,22,0.478,7,4,0.636,1,1,30,16,17,15,14,0.37,0.326,0.304,18.11,57,riffle_clumpy
0,18,27,3,48,0.375,21,0.438,1,2,0.333,2,2,31,17,11,19,18,0.229,0.396,0.375,18.111,58,riffle_clumpy
0,18,27,1,46,0.391,19,0.413,1,0,1.0,1,1,26,20,14,13,19,0.304,0.283,0.413,18.106,59,riffle_clumpy
0,18,27,2,47,0.383,20,0.426,4,2,0.667,1,5,34,13,14,14,19,0.298,0.298,0.404,18.102,60,riffle_clumpy
0,30,11,3,44,0.682,33,0.75,3,0,1.0,2,1,23,21,18,16,10,0.409,0.364,0.227,18.098,61,riffle_clumpy
0,22,22,4,48,0.458,26,0.542,0,3,0.0,2,3,32,16,15,18,15,0.312,0.375,0.312,18.106,62,riffle_clumpy
0,24,16,6,46,0.522,30,0.652,5,2,0.714,1,3,23,23,17,16,13,0.37,0.348,0.283,18.109,63,riffle_clumpy
0,19,26,3,48,0.396,22,0.458,4,4,0.5,3,4,24,24,13,18,17,0.271,0.375,0.354,18.102,64,riffle_clumpy
0,18,25,4,47,0.383,22,0.468,3,2,0.6,3,7,26,21,14,13,20,0.298,0.277,0.426,18.102,65,riffle_clumpy
0,19,24,4,47,0.404,23,0.489,7,2,0.778,1,4,25,22,6,20,21,0.128,0.426,0.447,18.101,66,riffle_clumpy
0,28,17,3,48,0.583,31,0.646,7,3,0.7,4,2,29,19,15,14,19,0.312,0.292,0.396,18.1,67,riffle_clumpy
0,17,26,3,46,0.37,20,0.435,2,2,0.5,2,2,28,18,6,20,20,0.13,0.435,0.435,18.095,68,riffle_clumpy
0,21,21,4,46,0.457,25,0.543,3,0,1.0,1,1,31,15,9,16,21,0.196,0.348,0.457,18.098,69,riffle_clumpy
0,21,25,1,47,0.447,22,0.468,5,4,0.556,4,0,25,22,12,16,19,0.255,0.34,0.404,18.093,70,riffle_clumpy
0,25,23,4,52,0.481,29,0.558,5,2,0.714,2,1,26,26,14,18,20,0.269,0.346,0.385,18.096,71,riffle_clumpy
0,19,22,7,48,0.396,26,0.542,5,4,0.556,2,2,33,15,11,13,24,0.229,0.271,0.5,18.089,72,riffle_clumpy
0,20,23,3,46,0.435,23,0.5,5,1,0.833,2,1,27,19,15,13,18,0.326,0.283,0.391,18.086,73,riffle_clumpy
0,16,27,3,46,0.348,19,0.413,2,4,0.333,2,3,28,18,10,14,22,0.217,0.304,0.478,18.093,74,riffle_clumpy
0,18,24,3,45,0.4,21,0.467,2,1,0.667,1,1,25,20,14,18,13,0.311,0.4,0.289,18.097,75,riffle_clumpy
0,22,26,3,51,0.431,25,0.49,4,3,0.571,2,1,26,25,17,22,12,0.333,0.431,0.235,18.094,76,riffle_clumpy
0,22,22,2,46,0.478,24,0.522,1,2,0.333,0,1,26,20,18,15,13,0.391,0.326,0.283,18.104,77,riffle_clumpy
0,25,21,1,47,0.532,26,0.553,6,5,0.545,4,3,28,19,13,14,20,0.277,0.298,0.426,18.093,78,riffle_clumpy
0,18,24,4,46,0.391,22,0.478,2,2,0.5,1,2,28,18,12,19,15,0.261,0.413,0.326,18.097,79,riffle_clumpy
0,26,18,1,45,0.578,27,0.6,0,1,0.0,3,1,23,22,17,16,12,0.378,0.356,0.267,18.091,80,riffle_clumpy
0,23,29,1,53,0.434,24,0.453,5,2,0.714,4,4,26,27,11,22,20,0.208,0.415,0.377,18.089,81,riffle_clumpy
0,21,23,3,47,0.447,24,0.511,2,4,0.333,4,2,33,14,13,16,18,0.277,0.34,0.383,18.085,82,riffle_clumpy
0,17,28,2,47,0.362,19,0.404,2,3,0.4,1,2,30,17,14,19,14,0.298,0.404,0.298,18.085,83,riffle_clumpy
0,22,25,2,49,0.449,24,0.49,2,2,0.5,1,3,28,21,13,21,15,0.265,0.429,0.306,18.082,84,riffle_clumpy
0,20,24,1,45,0.444,21,0.467,5,5,0.5,2,2,27,18,12,13,20,0.267,0.289,0.444,18.084,85,riffle_clumpy
0,21,25,1,47,0.447,22,0.468,4,1,0.8,3,3,28,19,13,15,19,0.277,0.319,0.404,18.084,86,riffle_clumpy
0,22,21,1,44,0.5,23,0.523,5,1,0.833,2,3,30,14,14,11,19,0.318,0.25,0.432,18.087,87,riffle_clumpy
0,19,25,5,49,0.388,24,0.49,2,3,0.4,2,2,32,17,14,13,22,0.286,0.265,0.449,18.09,88,riffle_clumpy
0,18,22,5,45,0.4,23,0.511,1,3,0.25,3,0,27,18,12,17,16,0.267,0.378,0.356,18.089,89,riffle_clumpy
0,19,23,2,44,0.432,21,0.477,5,1,0.833,1,3,23,21,15,15,14,0.341,0.341,0.318,18.093,90,riffle_clumpy
0,16,27,4,47,0.34,20,0.426,0,3,0.0,0,3,28,19,13,15,19,0.277,0.319,0.404,18.102,91,riffle_clumpy
0,20,23,5,48,0.417,25,0.521,6,3,0.667,1,2,30,18,4,22,22,0.083,0.458,0.458,18.096,92,riffle_clumpy
0,17,26,3,46,0.37,20,0.435,2,2,0.5,2,2,33,13,8,15,23,0.174,0.326,0.5,18.098,93,riffle_clumpy
0,21,25,2,48,0.438,23,0.479,3,3,0.5,2,1,26,22,13,16,19,0.271,0.333,0.396,18.089,94,riffle_clumpy
0,19,22,6,47,0.404,25,0.532,1,3,0.25,1,2,30,17,10,16,21,0.213,0.34,0.447,18.091,95,riffle_clumpy
0,18,28,3,49,0.367,21,0.429,3,0,1.0,4,2,31,18,12,15,22,0.245,0.306,0.449,18.081,96,riffle_clumpy
0,25,19,4,48,0.521,29,0.604,3,3,0.5,5,1,28,20,15,11,22,0.312,0.229,0.458,17.6,1,riffle_clumpy
0,23,19,4,46,0.5,27,0.587,2,1,0.667,1,1,27,19,15,15,16,0.326,0.326,0.348,17.625,2,riffle_clumpy
0,21,23,4,48,0.438,25,0.521,1,1,0.5,6,1,32,16,9,14,25,0.188,0.292,0.521,17.633,3,riffle_clumpy
0,20,23,5,48,0.417,25,0.521,3,2,0.6,1,1,31,17,11,14,23,0.229,0.292,0.479,17.8,4,riffle_clumpy
0,20,26,0,46,0.435,20,0.435,3,1,0.75,2,2,23,23,12,14,20,0.261,0.304,0.435,17.867,5,riffle_clumpy
0,20,27,2,49,0.408,22,0.449,6,5,0.545,1,2,25,24,10,22,17,0.204,0.449,0.347,18.045,6,riffle_clumpy
0,18,27,3,48,0.375,21,0.438,2,4,0.333,3,4,24,24,12,17,19,0.25,0.354,0.396,18.044,7,riffle_clumpy
0,19,25,4,48,0.396,23,0.479,7,1,0.875,2,2,28,20,10,17,21,0.208,0.354,0.438,17.979,8,riffle_clumpy
0,28,20,1,49,0.571,29,0.592,6,2,0.75,3,3,31,18,15,11,23,0.306,0.224,0.469,17.981,9,riffle_clumpy
0,18,33,1,52,0.346,19,0.365,5,4,0.556,1,4,31,21,10,22,20,0.192,0.423,0.385,18.027,10,riffle_clumpy
0,20,25,3,48,0.417,23,0.479,2,4,0.333,1,3,28,20,15,21,12,0.312,0.438,0.25,17.987,11,riffle_clumpy
0,27,18,2,47,0.574,29,0.617,8,4,0.667,4,3,24,23,16,13,18,0.34,0.277,0.383,17.98,12,riffle_clumpy
0,17,29,3,49,0.347,20,0.408,2,3,0.4,1,3,34,15,10,19,20,0.204,0.388,0.408,18.05,13,riffle_clumpy
0,20,25,2,47,0.426,22,0.468,1,3,0.25,3,3,25,22,8,21,18,0.17,0.447,0.383,18.032,14,riffle_clumpy
0,15,26,5,46,0.326,20,0.435,4,0,1.0,2,3,30,16,8,22,16,0.174,0.478,0.348,18.045,15,riffle_clumpy
0,17,28,3,48,0.354,20,0.417,3,4,0.429,0,2,34,14,13,16,19,0.271,0.333,0.396,18.109,16,riffle_clumpy
0,25,20,2,47,0.532,27,0.574,5,3,0.625,1,1,29,18,17,14,16,0.362,0.298,0.34,18.087,17,riffle_clumpy
0,25,19,4,48,0.521,29,0.604,4,1,0.8,2,1,25,23,18,16,14,0.375,0.333,0.292,18.094,18,riffle_clumpy
0,24,20,1,45,0.533,25,0.556,4,2,0.667,2,3,26,19,15,12,18,0.333,0.267,0.4,18.086,19,riffle_clumpy
0,16,28,2,46,0.348,18,0.391,1,3,0.25,2,2,29,17,11,17,18,0.239,0.37,0.391,18.099,20,riffle_clumpy
0,22,22,1,45,0.489,23,0.511,3,4,0.429,2,5,25,20,13,15,17,0.289,0.333,0.378,18.1,21,riffle_clumpy
0,26,16,4,46,0.565,30,0.652,3,2,0.6,1,1,27,19,12,20,14,0.261,0.435,0.304,18.113,22,riffle_clumpy
0,22,22,1,45,0.489,23,0.511,1,4,0.2,3,0,23,22,15,18,12,0.333,0.4,0.267,18.125,23,riffle_clumpy
0,16,23,8,47,0.34,24,0.511,1,3,0.25,2,1,28,19,11,19,17,0.234,0.404,0.362,18.109,24,riffle_clumpy
0,18,25,3,46,0.391,21,0.457,2,4,0.333,0,0,26,20,14,20,12,0.304,0.435,0.261,18.117,25,riffle_clumpy
0,26,22,0,48,0.542,26,0.542,2,1,0.667,2,3,33,15,15,13,20,0.312,0.271,0.417,18.128,26,riffle_clumpy
0,18,23,7,48,0.375,25,0.521,2,4,0.333,3,1,30,18,9,18,21,0.188,0.375,0.438,18.138,27,riffle_clumpy
0,23,17,3,43,0.535,26,0.605,5,1,0.833,2,0,20,23,17,15,11,0.395,0.349,0.256,18.113,28,riffle_clumpy
0,22,21,2,45,0.489,24,0.533,3,1,0.75,3,0,27,18,13,16,16,0.289,0.356,0.356,18.101,29,riffle_clumpy
0,20,24,4,48,0.417,24,0.5,4,1,0.8,1,3,25,23,12,22,14,0.25,0.458,0.292,18.096,30,riffle_clumpy
0,20,21,5,46,0.435,25,0.543,1,3,0.25,2,2,28,18,12,17,17,0.261,0.37,0.37,18.103,31,riffle_clumpy
0,20,22,2,44,0.455,22,0.5,4,3,0.571,1,2,24,20,13,19,12,0.295,0.432,0.273,18.107,32,riffle_clumpy
0,16,24,2,42,0.381,18,0.429,2,2,0.5,0,1,24,18,12,21,9,0.286,0.5,0.214,18.101,33,riffle_clumpy
0,23,20,0,43,0.535,23,0.535,5,1,0.833,0,3,24,19,13,15,15,0.302,0.349,0.349,18.11,34,riffle_clumpy
0,16,26,5,47,0.34,21,0.447,3,1,0.75,1,2,33,14,9,13,25,0.191,0.277,0.532,18.108,35,riffle_clumpy
0,15,26,4,45,0.333,19,0.422,3,3,0.5,3,3,27,18,6,19,20,0.133,0.422,0.444,18.084,36,riffle_clumpy
0,19,25,3,47,0.404,22,0.468,2,2,0.5,1,4,29,18,8,17,22,0.17,0.362,0.468,18.09,37,riffle_clumpy
0,22,27,1,50,0.44,23,0.46,1,0,1.0,4,2,30,20,13,9,28,0.26,0.18,0.56,18.092,38,riffle_clumpy
0,16,31,2,49,0.327,18,0.367,3,4,0.429,3,3,29,20,5,22,22,0.102,0.449,0.449,18.084,39,riffle_clumpy
0,22,18,4,44,0.5,26,0.591,5,2,0.714,2,3,26,18,12,16,16,0.273,0.364,0.364,18.087,40,riffle_clumpy
0,19,26,3,48,0.396,22,0.458,1,4,0.2,1,4,29,19,12,17,19,0.25,0.354,0.396,18.099,41,riffle_clumpy
0,17,27,2,46,0.37,19,0.413,3,1,0.75,0,4,28,18,15,13,18,0.326,0.283,0.391,18.104,42,riffle_clumpy
0,23,24,0,47,0.489,23,0.489,3,4,0.429,3,2,28,19,13,16,18,0.277,0.34,0.383,18.101,43,riffle_clumpy
0,15,25,5,45,0.333,20,0.444,2,2,0.5,1,2,31,14,11,19,15,0.244,0.422,0.333,18.119,44,riffle_clumpy
0,20,20,4,44,0.455,24,0.545,7,2,0.778,2,1,24,20,11,15,18,0.25,0.341,0.409,18.105,45,riffle_clumpy
0,21,25,2,48,0.438,23,0.479,1,3,0.25,4,4,33,15,10,15,23,0.208,0.312,0.479,18.098,46,riffle_clumpy
0,20,27,2,49,0.408,22,0.449,1,3,0.25,4,2,27,22,13,16,20,0.265,0.327,0.408,18.111,47,riffle_clumpy
0,22,25,2,49,0.449,24,0.49,3,3,0.5,3,2,26,23,11,17,21,0.224,0.347,0.429,18.103,48,riffle_clumpy
0,23,25,4,52,0.442,27,0.519,2,2,0.5,3,4,31,21,17,15,20,0.327,0.288,0.385,18.098,49,riffle_clumpy
0,28,13,5,46,0.609,33,0.717,4,1,0.8,0,3,26,20,20,11,15,0.435,0.239,0.326,18.109,50,riffle_clumpy
0,30,17,0,47,0.638,30,0.638,3,2,0.6,2,3,19,28,21,11,15,0.447,0.234,0.319,18.084,51,riffle_clumpy
0,25,20,2,47,0.532,27,0.574,4,0,1.0,0,3,30,17,15,16,16,0.319,0.34,0.34,18.089,52,riffle_clumpy
0,28,18,2,48,0.583,30,0.625,4,3,0.571,3,1,34,14,20,9,19,0.417,0.188,0.396,18.087,53,riffle_clumpy
0,24,18,3,45,0.533,27,0.6,3,3,0.5,4,2,23,22,15,15,15,0.333,0.333,0.333,18.072,54,riffle_clumpy
0,19,24,2,45,0.422,21,0.467,1,3,0.25,2,1,27,18,12,20,13,0.267,0.444,0.289,18.074,55,riffle_clumpy
0,19,23,4,46,0.413,23,0.5,1,3,0.25,2,1,26,20,12,16,18,0.261,0.348,0.391,18.074,56,riffle_clumpy
0,16,25,5,46,0.348,21,0.457,2,0,1.0,4,2,29,17,6,22,18,0.13,0.478,0.391,18.073,57,riffle_clumpy
0,18,22,7,47,0.383,25,0.532,3,0,1.0,4,4,24,23,7,21,19,0.149,0.447,0.404,18.069,58,riffle_clumpy
0,20,22,4,46,0.435,24,0.522,3,4,0.429,3,2,21,25,11,21,14,0.239,0.457,0.304,18.067,59,riffle_clumpy
0,19,33,0,52,0.365,19,0.365,4,2,0.667,3,6,39,13,11,12,29,0.212,0.231,0.558,18.062,60,riffle_clumpy
0,21,18,7,46,0.457,28,0.609,2,1,0.667,2,3,29,17,14,15,17,0.304,0.326,0.37,18.062,61,riffle_clumpy
0,24,18,5,47,0.511,29,0.617,4,1,0.8,3,1,30,17,11,13,23,0.234,0.277,0.489,18.041,62,riffle_clumpy
0,17,27,4,48,0.354,21,0.438,1,2,0.333,1,2,29,19,10,19,19,0.208,0.396,0.396,18.047,63,riffle_clumpy
0,21,21,6,48,0.438,27,0.562,0,1,0.0,1,1,28,20,15,14,19,0.312,0.292,0.396,18.042,64,riffle_clumpy
0,17,25,6,48,0.354,23,0.479,2,0,1.0,3,2,28,20,10,23,15,0.208,0.479,0.312,18.044,65,riffle_clumpy
0,20,25,3,48,0.417,23,0.479,5,3,0.625,3,1,33,15,9,17,22,0.188,0.354,0.458,18.047,66,riffle_clumpy
0,16,25,4,45,0.356,20,0.444,3,4,0.429,4,1,26,19,8,21,16,0.178,0.467,0.356,18.041,67,riffle_clumpy
0,20,24,2,46,0.435,22,0.478,3,4,0.429,3,2,27,19,11,18,17,0.239,0.391,0.37,18.044,68,riffle_clumpy
0,18,27,3,48,0.375,21,0.438,3,3,0.5,2,1,29,19,9,18,21,0.188,0.375,0.438,18.039,69,riffle_clumpy
0,23,25,2,50,0.46,25,0.5,5,3,0.625,3,1,24,26,15,16,19,0.3,0.32,0.38,18.033,70,riffle_clumpy
0,16,29,2,47,0.34,18,0.383,4,5,0.444,3,1,26,21,8,18,21,0.17,0.383,0.447,18.029,71,riffle_clumpy
0,20,25,5,50,0.4,25,0.5,2,2,0.5,2,1,30,20,14,18,18,0.28,0.36,0.36,18.023,72,riffle_clumpy
0,21,23,3,47,0.447,24,0.511,3,0,1.0,2,2,27,20,12,18,17,0.255,0.383,0.362,18.022,73,riffle_clumpy
0,19,25,4,48,0.396,23,0.479,5,2,0.714,2,4,25,23,12,13,23,0.25,0.271,0.479,18.018,74,riffle_clumpy
0,25,20,1,46,0.543,26,0.565,2,0,1.0,3,0,27,19,18,13,15,0.391,0.283,0.326,18.018,75,riffle_clumpy
0,14,31,2,47,0.298,16,0.34,2,2,0.5,2,2,25,22,12,15,20,0.255,0.319,0.426,18.022,76,riffle_clumpy
0,16,26,4,46,0.348,20,0.435,3,0,1.0,1,1,26,20,10,19,17,0.217,0.413,0.37,18.02,77,riffle_clumpy
0,27,18,2,47,0.574,29,0.617,0,3,0.0,3,1,29,18,16,14,17,0.34,0.298,0.362,18.018,78,riffle_clumpy
0,22,21,2,45,0.489,24,0.533,2,0,1.0,3,4,28,17,15,11,19,0.333,0.244,0.422,18.007,79,riffle_clumpy
0,21,21,3,45,0.467,24,0.533,2,2,0.5,4,2,30,15,10,19,16,0.222,0.422,0.356,17.997,80,riffle_clumpy
0,16,31,2,49,0.327,18,0.367,5,2,0.714,3,6,35,14,4,18,27,0.082,0.367,0.551,17.997,81,riffle_clumpy
0,14,27,4,45,0.311,18,0.4,5,3,0.625,2,2,23,22,9,21,15,0.2,0.467,0.333,17.996,82,riffle_clumpy
0,17,28,2,47,0.362,19,0.404,2,2,0.5,2,2,31,16,5,20,22,0.106,0.426,0.468,18.004,83,riffle_clumpy
0,17,22,6,45,0.378,23,0.511,3,1,0.75,3,1,26,19,7,20,18,0.156,0.444,0.4,17.998,84,riffle_clumpy
0,23,19,3,45,0.511,26,0.578,5,3,0.625,1,1,32,13,14,12,19,0.311,0.267,0.422,18.002,85,riffle_clumpy
0,14,35,4,53,0.264,18,0.34,2,4,0.333,2,1,32,21,5,29,19,0.094,0.547,0.358,18.008,86,riffle_clumpy
0,17,29,1,47,0.362,18,0.383,1,3,0.25,2,2,25,22,12,17,18,0.255,0.362,0.383,18.006,87,riffle_clumpy
0,20,23,3,46,0.435,23,0.5,4,5,0.444,3,1,24,22,11,19,16,0.239,0.413,0.348,18.009,88,riffle_clumpy
0,23,20,2,45,0.511,25,0.556,5,1,0.833,4,2,24,21,15,17,13,0.333,0.378,0.289,18.007,89,riffle_clumpy
0,22,20,5,47,0.468,27,0.574,2,3,0.4,3,3,29,18,10,15,22,0.213,0.319,0.468,18.008,90,riffle_clumpy
0,21,17,7,45,0.467,28,0.622,3,2,0.6,4,1,25,20,12,16,17,0.267,0.356,0.378,18.008,91,riffle_clumpy
0,21,19,5,45,0.467,26,0.578,3,4,0.429,3,2,26,19,15,16,14,0.333,0.356,0.311,18.01,92,riffle_clumpy
0,19,23,5,47,0.404,24,0.511,1,4,0.2,2,2,28,19,11,16,20,0.234,0.34,0.426,18.012,93,riffle_clumpy
0,25,17,6,48,0.521,31,0.646,6,1,0.857,3,2,32,16,14,13,21,0.292,0.271,0.438,18.01,94,riffle_clumpy
0,20,25,3,48,0.417,23,0.479,5,1,0.833,1,1,33,15,11,16,21,0.229,0.333,0.438,18.011,95,riffle_clumpy
0,22,22,4,48,0.458,26,0.542,3,5,0.375,2,1,25,23,12,23,13,0.25,0.479,0.271,18.017,96,riffle_clumpy
0,21,22,3,46,0.457,24,0.522,4,4,0.5,5,1,28,18,8,18,20,0.174,0.391,0.435,18.088,1,riffle_clumpy
0,17,24,5,46,0.37,22,0.478,0,4,0.0,1,1,33,13,11,13,22,0.239,0.283,0.478,18.121,2,riffle_clumpy
0,21,22,2,45,0.467,23,0.511,3,1,0.75,2,2,27,18,9,19,17,0.2,0.422,0.378,18.301,3,riffle_clumpy
0,20,22,7,49,0.408,27,0.551,1,5,0.167,6,2,27,22,11,15,23,0.224,0.306,0.469,18.22,4,riffle_clumpy
0,19,21,5,45,0.422,24,0.533,1,1,0.5,0,3,27,18,15,15,15,0.333,0.333,0.333,18.191,5,riffle_clumpy
0,24,24,1,49,0.49,25,0.51,6,0,1.0,2,4,29,20,17,12,20,0.347,0.245,0.408,18.179,6,riffle_clumpy
0,22,25,1,48,0.458,23,0.479,3,1,0.75,0,1,30,18,15,17,16,0.312,0.354,0.333,18.274,7,riffle_clumpy
0,20,23,2,45,0.444,22,0.489,2,2,0.5,1,1,25,20,14,17,14,0.311,0.378,0.311,18.242,8,riffle_clumpy
0,18,23,4,45,0.4,22,0.489,0,3,0.0,1,2,23,22,12,16,17,0.267,0.356,0.378,18.267,9,riffle_clumpy
0,14,26,6,46,0.304,20,0.435,2,4,0.333,0,3,34,12,9,15,22,0.196,0.326,0.478,18.279,10,riffle_clumpy
0,20,27,4,51,0.392,24,0.471,3,3,0.5,3,0,31,20,11,17,23,0.216,0.333,0.451,18.306,11,riffle_clumpy
0,15,29,2,46,0.326,17,0.37,1,4,0.2,1,3,33,13,8,22,16,0.174,0.478,0.348,18.32,12,riffle_clumpy
0,18,25,2,45,0.4,20,0.444,3,4,0.429,1,1,27,18,14,22,9,0.311,0.489,0.2,18.339,13,riffle_clumpy
0,19,27,2,48,0.396,21,0.438,1,3,0.25,2,3,27,21,13,15,20,0.271,0.312,0.417,18.299,14,riffle_clumpy
0,18,25,5,48,0.375,23,0.479,2,2,0.5,3,2,35,13,10,15,23,0.208,0.312,0.479,18.291,15,riffle_clumpy
0,26,17,2,45,0.578,28,0.622,1,1,0.5,2,1,29,16,17,12,16,0.378,0.267,0.356,18.28,16,riffle_clumpy
0,21,24,3,48,0.438,24,0.5,1,2,0.333,1,0,28,20,11,17,20,0.229,0.354,0.417,18.232,17,riffle_clumpy
0,18,28,3,49,0.367,21,0.429,2,3,0.4,1,3,27,22,11,18,20,0.224,0.367,0.408,18.235,18,riffle_clumpy
0,18,26,2,46,0.391,20,0.435,2,4,0.333,5,2,29,17,10,14,22,0.217,0.304,0.478,18.22,19,riffle_clumpy
0,13,33,2,48,0.271,15,0.312,2,2,0.5,1,4,34,14,8,17,23,0.167,0.354,0.479,18.21,20,riffle_clumpy
0,20,27,3,50,0.4,23,0.46,4,2,0.667,3,2,32,18,12,13,25,0.24,0.26,0.5,18.176,21,riffle_clumpy
0,17,26,3,46,0.37,20,0.435,2,2,0.5,3,1,26,20,8,19,19,0.174,0.413,0.413,18.184,22,riffle_clumpy
0,20,27,0,47,0.426,20,0.426,1,3,0.25,1,3,30,17,13,16,18,0.277,0.34,0.383,18.185,23,riffle_clumpy
0,17,24,5,46,0.37,22,0.478,1,4,0.2,3,3,32,14,10,15,21,0.217,0.326,0.457,18.178,24,riffle_clumpy
0,13,29,7,49,0.265,20,0.408,1,1,0.5,0,3,34,15,7,17,25,0.143,0.347,0.51,18.181,25,riffle_clumpy
0,17,28,3,48,0.354,20,0.417,3,3,0.5,2,2,29,19,12,20,16,0.25,0.417,0.333,18.194,26,riffle_clumpy
0,19,21,6,46,0.413,25,0.543,2,0,1.0,1,1,30,16,9,18,19,0.196,0.391,0.413,18.179,27,riffle_clumpy
0,18,27,4,49,0.367,22,0.449,1,3,0.25,7,2,31,18,7,17,25,0.143,0.347,0.51,18.166,28,riffle_clumpy
0,25,22,4,51,0.49,29,0.569,1,1,0.5,3,2,31,20,15,13,23,0.294,0.255,0.451,18.152,29,riffle_clumpy
0,19,26,2,47,0.404,21,0.447,1,1,0.5,3,2,23,24,15,15,17,0.319,0.319,0.362,18.129,30,riffle_clumpy
0,20,23,1,44,0.455,21,0.477,2,1,0.667,3,0,21,23,13,17,14,0.295,0.386,0.318,18.126,31,riffle_clumpy
0,18,28,3,49,0.367,21,0.429,2,1,0.667,2,0,26,23,9,23,17,0.184,0.469,0.347,18.115,32,riffle_clumpy
0,26,22,4,52,0.5,30,0.577,2,6,0.25,3,4,39,13,16,13,23,0.308,0.25,0.442,18.122,33,riffle_clumpy
0,22,21,2,45,0.489,24,0.533,0,1,0.0,1,2,25,20,17,12,16,0.378,0.267,0.356,18.125,34,riffle_clumpy
0,20,25,2,47,0.426,22,0.468,5,3,0.625,3,0,28,19,10,18,19,0.213,0.383,0.404,18.109,35,riffle_clumpy
0,13,32,2,47,0.277,15,0.319,4,6,0.4,2,2,28,19,8,24,15,0.17,0.511,0.319,18.114,36,riffle_clumpy
0,20,22,5,47,0.426,25,0.532,2,2,0.5,2,1,28,19,12,22,13,0.255,0.468,0.277,18.124,37,riffle_clumpy
0,14,29,4,47,0.298,18,0.383,1,0,1.0,2,0,31,16,9,16,22,0.191,0.34,0.468,18.12,38,riffle_clumpy
0,16,25,8,49,0.327,24,0.49,4,1,0.8,1,4,34,15,9,16,24,0.184,0.327,0.49,18.132,39,riffle_clumpy
0,24,21,0,45,0.533,24,0.533,2,3,0.4,3,3,29,16,9,16,20,0.2,0.356,0.444,18.127,40,riffle_clumpy
0,19,20,6,45,0.422,25,0.556,4,3,0.571,4,1,23,22,10,16,19,0.222,0.356,0.422,18.126,41,riffle_clumpy
0,19,28,0,47,0.404,19,0.404,3,2,0.6,4,3,31,16,11,13,23,0.234,0.277,0.489,18.102,42,riffle_clumpy
0,17,22,6,45,0.378,23,0.511,2,3,0.4,1,1,27,18,8,16,21,0.178,0.356,0.467,18.105,43,riffle_clumpy
0,17,25,4,46,0.37,21,0.457,1,1,0.5,1,4,31,15,10,17,19,0.217,0.37,0.413,18.094,44,riffle_clumpy
0,23,22,2,47,0.489,25,0.532,3,5,0.375,2,1,30,17,14,14,19,0.298,0.298,0.404,18.1,45,riffle_clumpy
0,23,22,3,48,0.479,26,0.542,4,2,0.667,2,1,30,18,16,13,19,0.333,0.271,0.396,18.095,46,riffle_clumpy
0,20,23,2,45,0.444,22,0.489,3,3,0.5,1,1,22,23,15,13,17,0.333,0.289,0.378,18.085,47,riffle_clumpy
0,19,23,4,46,0.413,23,0.5,4,2,0.667,1,3,26,20,8,20,18,0.174,0.435,0.391,18.075,48,riffle_clumpy
0,25,19,4,48,0.521,29,0.604,2,1,0.667,7,2,34,14,13,12,23,0.271,0.25,0.479,18.047,49,riffle_clumpy
0,22,20,7,49,0.449,29,0.592,1,1,0.5,3,2,32,17,15,15,19,0.306,0.306,0.388,18.037,50,riffle_clumpy
0,16,24,5,45,0.356,21,0.467,4,1,0.8,2,1,26,19,10,18,17,0.222,0.4,0.378,18.038,51,riffle_clumpy
0,22,23,3,48,0.458,25,0.521,5,1,0.833,3,5,25,23,15,15,18,0.312,0.312,0.375,18.033,52,riffle_clumpy
0,16,26,5,47,0.34,21,0.447,4,2,0.667,4,0,32,15,8,18,21,0.17,0.383,0.447,18.026,53,riffle_clumpy
0,18,26,2,46,0.391,20,0.435,3,2,0.6,3,4,29,17,11,14,21,0.239,0.304,0.457,18.03,54,riffle_clumpy
0,23,21,0,44,0.523,23,0.523,7,3,0.7,1,2,21,23,15,14,15,0.341,0.318,0.341,18.034,55,riffle_clumpy
0,14,30,3,47,0.298,17,0.362,1,2,0.333,2,4,32,15,7,15,25,0.149,0.319,0.532,18.045,56,riffle_clumpy
0,21,26,2,49,0.429,23,0.469,2,1,0.667,1,2,27,22,14,21,14,0.286,0.429,0.286,18.049,57,riffle_clumpy
0,18,28,3,49,0.367,21,0.429,1,1,0.5,0,2,28,21,14,18,17,0.286,0.367,0.347,18.056,58,riffle_clumpy
0,20,27,2,49,0.408,22,0.449,1,4,0.2,4,5,34,15,13,16,20,0.265,0.327,0.408,18.062,59,riffle_clumpy
0,20,24,2,46,0.435,22,0.478,4,0,1.0,1,2,33,13,13,15,18,0.283,0.326,0.391,18.061,60,riffle_clumpy
0,16,26,3,45,0.356,19,0.422,2,2,0.5,0,0,31,14,9,21,15,0.2,0.467,0.333,18.07,61,riffle_clumpy
0,25,20,1,46,0.543,26,0.565,5,2,0.714,3,2,29,17,12,16,18,0.261,0.348,0.391,18.068,62,riffle_clumpy
0,22,24,1,47,0.468,23,0.489,1,1,0.5,2,0,25,22,16,16,15,0.34,0.34,0.319,18.071,63,riffle_clumpy
0,24,22,3,49,0.49,27,0.551,8,1,0.889,2,2,24,25,18,19,12,0.367,0.388,0.245,18.073,64,riffle_clumpy
0,24,18,2,44,0.545,26,0.591,3,2,0.6,3,1,30,14,15,11,18,0.341,0.25,0.409,18.07,65,riffle_clumpy
0,23,16,6,45,0.511,29,0.644,2,1,0.667,5,0,22,23,12,17,16,0.267,0.378,0.356,18.062,66,riffle_clumpy
0,23,18,5,46,0.5,28,0.609,4,2,0.667,1,1,27,19,16,15,15,0.348,0.326,0.326,18.066,67,riffle_clumpy
0,26,18,4,48,0.542,30,0.625,3,2,0.6,5,3,25,23,15,13,20,0.312,0.271,0.417,18.056,68,riffle_clumpy
0,24,21,3,48,0.5,27,0.562,3,1,0.75,2,3,38,10,15,12,21,0.312,0.25,0.438,18.055,69,riffle_clumpy
0,20,20,5,45,0.444,25,0.556,6,3,0.667,1,2,32,13,10,15,20,0.222,0.333,0.444,18.054,70,riffle_clumpy
0,21,20,5,46,0.457,26,0.565,1,3,0.25,1,4,29,17,16,15,15,0.348,0.326,0.326,18.056,71,riffle_clumpy
0,20,21,6,47,0.426,26,0.553,2,4,0.333,2,1,29,18,13,15,19,0.277,0.319,0.404,18.061,72,riffle_clumpy
0,19,26,2,47,0.404,21,0.447,4,1,0.8,1,1,32,15,9,16,22,0.191,0.34,0.468,18.061,73,riffle_clumpy
0,17,31,3,51,0.333,20,0.392,2,5,0.286,2,2,30,21,9,28,14,0.176,0.549,0.275,18.063,74,riffle_clumpy
0,20,23,5,48,0.417,25,0.521,4,3,0.571,0,2,30,18,10,18,20,0.208,0.375,0.417,18.065,75,riffle_clumpy
0,21,21,3,45,0.467,24,0.533,5,2,0.714,4,4,26,19,10,18,17,0.222,0.4,0.378,18.062,76,riffle_clumpy
0,21,24,2,47,0.447,23,0.489,2,0,1.0,4,0,27,20,10,19,18,0.213,0.404,0.383,18.059,77,riffle_clumpy
0,18,24,3,45,0.4,21,0.467,4,5,0.444,3,3,28,17,9,21,15,0.2,0.467,0.333,18.063,78,riffle_clumpy
0,19,24,3,46,0.413,22,0.478,4,4,0.5,0,3,23,23,16,14,16,0.348,0.304,0.348,18.069,79,riffle_clumpy
0,19,23,3,45,0.422,22,0.489,4,3,0.571,1,2,28,17,13,15,17,0.289,0.333,0.378,18.073,80,riffle_clumpy
0,20,26,2,48,0.417,22,0.458,2,4,0.333,5,5,32,16,10,15,23,0.208,0.312,0.479,18.066,81,riffle_clumpy
0,14,33,4,51,0.275,18,0.353,1,3,0.25,2,3,29,22,8,19,24,0.157,0.373,0.471,18.061,82,riffle_clumpy
0,27,17,3,47,0.574,30,0.638,5,1,0.833,3,2,30,17,9,19,19,0.191,0.404,0.404,18.058,83,riffle_clumpy
0,22,25,1,48,0.458,23,0.479,1,1,0.5,4,2,29,19,14,16,18,0.292,0.333,0.375,18.048,84,riffle_clumpy
0,23,19,5,47,0.489,28,0.596,3,2,0.6,2,1,26,21,16,16,15,0.34,0.34,0.319,18.05,85,riffle_clumpy
0,17,23,5,45,0.378,22,0.489,4,2,0.667,4,2,27,18,10,15,20,0.222,0.333,0.444,18.052,86,riffle_clumpy
0,18,24,5,47,0.383,23,0.489,2,1,0.667,1,2,32,15,8,21,18,0.17,0.447,0.383,18.058,87,riffle_clumpy
0,21,23,2,46,0.457,23,0.5,2,4,0.333,0,1,29,17,13,15,18,0.283,0.326,0.391,18.059,88,riffle_clumpy
0,19,26,4,49,0.388,23,0.469,2,3,0.4,1,3,28,21,11,18,20,0.224,0.367,0.408,18.063,89,riffle_clumpy
0,21,27,1,49,0.429,22,0.449,4,5,0.444,3,2,26,23,13,15,21,0.265,0.306,0.429,18.056,90,riffle_clumpy
0,17,25,2,44,0.386,19,0.432,2,3,0.4,0,4,30,14,14,14,16,0.318,0.318,0.364,18.058,91,riffle_clumpy
0,20,23,7,50,0.4,27,0.54,4,2,0.667,3,2,30,20,13,19,18,0.26,0.38,0.36,18.059,92,riffle_clumpy
0,16,30,2,48,0.333,18,0.375,6,2,0.75,0,3,31,17,10,17,21,0.208,0.354,0.438,18.063,93,riffle_clumpy
0,17,27,4,48,0.354,21,0.438,4,0,1.0,2,2,33,15,11,12,25,0.229,0.25,0.521,18.064,94,riffle_clumpy
0,20,22,4,46,0.435,24,0.522,9,1,0.9,0,1,28,18,17,15,14,0.37,0.326,0.304,18.071,95,riffle_clumpy
0,19,25,4,48,0.396,23,0.479,4,2,0.667,2,3,34,14,11,12,25,0.229,0.25,0.521,18.063,96,riffle_clumpy
0,22,19,3,44,0.5,25,0.568,6,1,0.857,1,3,29,15,13,11,20,0.295,0.25,0.455,18.481,1,riffle_clumpy
0,18,24,3,45,0.4,21,0.467,1,2,0.333,0,1,28,17,11,19,15,0.244,0.422,0.333,18.509,2,riffle_clumpy
0,16,25,5,46,0.348,21,0.457,3,5,0.375,2,2,26,20,9,18,19,0.196,0.391,0.413,18.341,3,riffle_clumpy
0,18,25,3,46,0.391,21,0.457,0,2,0.0,0,2,27,19,17,14,15,0.37,0.304,0.326,18.336,4,riffle_clumpy
0,20,22,3,45,0.444,23,0.511,3,4,0.429,2,1,27,18,9,19,17,0.2,0.422,0.378,18.376,5,riffle_clumpy
0,20,25,2,47,0.426,22,0.468,3,4,0.429,0,1,30,17,13,12,22,0.277,0.255,0.468,18.359,6,riffle_clumpy
0,20,24,5,49,0.408,25,0.51,4,3,0.571,1,3,29,20,11,15,23,0.224,0.306,0.469,18.31,7,riffle_clumpy
0,18,23,4,45,0.4,22,0.489,1,3,0.25,3,1,31,14,10,17,18,0.222,0.378,0.4,18.259,8,riffle_clumpy
0,18,26,3,47,0.383,21,0.447,3,4,0.429,2,4,28,19,14,11,22,0.298,0.234,0.468,18.213,9,riffle_clumpy
0,18,29,1,48,0.375,19,0.396,1,3,0.25,4,3,29,19,12,17,19,0.25,0.354,0.396,18.117,10,riffle_clumpy
0,24,20,3,47,0.511,27,0.574,1,3,0.25,2,2,31,16,15,12,20,0.319,0.255,0.426,18.103,11,riffle_clumpy
0,19,23,2,44,0.432,21,0.477,2,6,0.25,2,2,25,19,10,16,18,0.227,0.364,0.409,18.065,12,riffle_clumpy
0,18,25,4,47,0.383,22,0.468,4,1,0.8,2,2,34,13,11,17,19,0.234,0.362,0.404,18.07,13,riffle_clumpy
0,25,17,2,44,0.568,27,0.614,3,1,0.75,2,2,22,22,19,12,13,0.432,0.273,0.295,18.049,14,riffle_clumpy
0,18,27,4,49,0.367,22,0.449,1,2,0.333,2,1,37,12,10,14,25,0.204,0.286,0.51,18.066,15,riffle_clumpy
0,24,16,6,46,0.522,30,0.652,7,1,0.875,2,1,31,15,14,12,20,0.304,0.261,0.435,18.046,16,riffle_clumpy
0,28,17,2,47,0.596,30,0.638,8,2,0.8,4,0,27,20,18,15,14,0.383,0.319,0.298,18.017,17,riffle_clumpy
0,23,21,4,48,0.479,27,0.562,7,2,0.778,4,0,30,18,10,17,21,0.208,0.354,0.438,18.025,18,riffle_clumpy
0,22,24,0,46,0.478,22,0.478,2,4,0.333,1,1,29,17,18,15,13,0.391,0.326,0.283,18.011,19,riffle_clumpy
0,23,20,4,47,0.489,27,0.574,4,1,0.8,1,0,25,22,12,24,11,0.255,0.511,0.234,18.039,20,riffle_clumpy
0,20,23,2,45,0.444,22,0.489,4,2,0.667,2,3,23,22,15,16,14,0.333,0.356,0.311,18.027,21,riffle_clumpy
0,19,25,2,46,0.413,21,0.457,6,3,0.667,1,3,31,15,12,17,17,0.261,0.37,0.37,18.032,22,riffle_clumpy
0,21,23,3,47,0.447,24,0.511,4,2,0.667,0,1,26,21,16,17,14,0.34,0.362,0.298,18.034,23,riffle_clumpy
0,20,24,4,48,0.417,24,0.5,2,4,0.333,3,2,28,20,10,18,20,0.208,0.375,0.417,18.053,24,riffle_clumpy
0,20,23,4,47,0.426,24,0.511,5,2,0.714,2,3,26,21,11,13,23,0.234,0.277,0.489,18.047,25,riffle_clumpy
0,16,29,1,46,0.348,17,0.37,2,1,0.667,0,2,25,21,12,18,16,0.261,0.391,0.348,18.052,26,riffle_clumpy
0,22,22,2,46,0.478,24,0.522,2,5,0.286,2,1,28,18,14,15,17,0.304,0.326,0.37,18.056,27,riffle_clumpy
0,23,23,1,47,0.489,24,0.511,6,1,0.857,1,2,25,22,18,12,17,0.383,0.255,0.362,18.061,28,riffle_clumpy
0,18,21,6,45,0.4,24,0.533,2,4,0.333,3,1,23,22,11,17,17,0.244,0.378,0.378,18.053,29,riffle_clumpy
0,28,18,0,46,0.609,28,0.609,5,1,0.833,4,3,30,16,16,13,17,0.348,0.283,0.37,18.046,30,riffle_clumpy
0,18,24,2,44,0.409,20,0.455,2,2,0.5,1,3,28,16,11,13,20,0.25,0.295,0.455,18.055,31,riffle_clumpy
0,20,21,3,44,0.455,23,0.523,0,1,0.0,2,0,28,16,15,12,17,0.341,0.273,0.386,18.064,32,riffle_clumpy
0,21,22,4,47,0.447,25,0.532,4,2,0.667,2,3,28,19,10,17,20,0.213,0.362,0.426,18.062,33,riffle_clumpy
0,22,19,5,46,0.478,27,0.587,1,1,0.5,1,0,26,20,12,19,15,0.261,0.413,0.326,18.056,34,riffle_clumpy
0,16,27,5,48,0.333,21,0.438,3,4,0.429,5,2,33,15,5,18,25,0.104,0.375,0.521,18.065,35,riffle_clumpy
0,21,21,2,44,0.477,23,0.523,2,3,0.4,1,0,27,17,13,15,16,0.295,0.341,0.364,18.081,36,riffle_clumpy
0,19,24,5,48,0.396,24,0.5,3,0,1.0,2,2,34,14,7,17,24,0.146,0.354,0.5,18.082,37,riffle_clumpy
0,19,21,4,44,0.432,23,0.523,5,2,0.714,0,2,31,13,14,13,17,0.318,0.295,0.386,18.093,38,riffle_clumpy
0,23,22,2,47,0.489,25,0.532,5,1,0.833,2,1,30,17,13,16,18,0.277,0.34,0.383,18.098,39,riffle_clumpy
0,25,23,2,50,0.5,27,0.54,3,1,0.75,3,4,31,19,15,17,18,0.3,0.34,0.36,18.096,40,riffle_clumpy
0,19,21,7,47,0.404,26,0.553,1,3,0.25,3,2,30,17,14,12,21,0.298,0.255,0.447,18.098,41,riffle_clumpy
0,26,20,2,48,0.542,28,0.583,4,3,0.571,3,3,32,16,15,12,21,0.312,0.25,0.438,18.105,42,riffle_clumpy
0,29,14,3,46,0.63,32,0.696,7,1,0.875,1,1,22,24,21,16,9,0.457,0.348,0.196,18.112,43,riffle_clumpy
0,19,30,3,52,0.365,22,0.423,2,7,0.222,1,2,28,24,11,24,17,0.212,0.462,0.327,18.128,44,riffle_clumpy
0,19,31,3,53,0.358,22,0.415,1,5,0.167,4,4,31,22,11,20,22,0.208,0.377,0.415,18.117,45,riffle_clumpy
0,19,26,2,47,0.404,21,0.447,2,1,0.667,3,2,35,12,10,12,25,0.213,0.255,0.532,18.118,46,riffle_clumpy
0,19,24,3,46,0.413,22,0.478,6,4,0.6,1,2,28,18,11,15,20,0.239,0.326,0.435,18.12,47,riffle_clumpy
0,15,30,1,46,0.326,16,0.348,2,1,0.667,3,5,32,14,8,16,22,0.174,0.348,0.478,18.116,48,riffle_clumpy
0,18,29,3,50,0.36,21,0.42,4,1,0.8,3,4,33,17,10,21,19,0.2,0.42,0.38,18.118,49,riffle_clumpy
0,19,25,4,48,0.396,23,0.479,0,1,0.0,4,7,34,14,9,14,25,0.188,0.292,0.521,18.112,50,riffle_clumpy
0,20,25,2,47,0.426,22,0.468,6,1,0.857,2,6,26,21,16,14,17,0.34,0.298,0.362,18.106,51,riffle_clumpy
0,19,27,0,46,0.413,19,0.413,3,1,0.75,3,2,32,14,9,18,19,0.196,0.391,0.413,18.102,52,riffle_clumpy
0,23,23,0,46,0.5,23,0.5,2,3,0.4,3,1,23,23,14,16,16,0.304,0.348,0.348,18.103,53,riffle_clumpy
0,21,22,3,46,0.457,24,0.522,3,3,0.5,4,1,26,20,12,18,16,0.261,0.391,0.348,18.1,54,riffle_clumpy
0,24,18,3,45,0.533,27,0.6,4,1,0.8,1,2,30,15,14,14,17,0.311,0.311,0.378,18.093,55,riffle_clumpy
0,20,26,2,48,0.417,22,0.458,1,3,0.25,3,1,27,21,14,17,17,0.292,0.354,0.354,18.09,56,riffle_clumpy
0,21,19,5,45,0.467,26,0.578,4,1,0.8,2,3,28,17,12,18,15,0.267,0.4,0.333,18.094,57,riffle_clumpy
0,17,26,3,46,0.37,20,0.435,4,3,0.571,2,1,27,19,10,20,16,0.217,0.435,0.348,18.103,58,riffle_clumpy
0,18,23,5,46,0.391,23,0.5,2,4,0.333,2,3,33,13,7,19,20,0.152,0.413,0.435,18.103,59,riffle_clumpy
0,20,28,1,49,0.408,21,0.429,4,2,0.667,2,0,27,22,14,17,18,0.286,0.347,0.367,18.097,60,riffle_clumpy
0,23,20,2,45,0.511,25,0.556,4,1,0.8,2,1,24,21,18,13,14,0.4,0.289,0.311,18.097,61,riffle_clumpy
0,20,25,2,47,0.426,22,0.468,3,4,0.429,3,3,26,21,13,15,19,0.277,0.319,0.404,18.091,62,riffle_clumpy
0,21,21,5,47,0.447,26,0.553,2,3,0.4,4,2,33,14,13,16,18,0.277,0.34,0.383,18.081,63,riffle_clumpy
0,23,23,2,48,0.479,25,0.521,4,3,0.571,3,3,31,17,13,13,22,0.271,0.271,0.458,18.073,64,riffle_clumpy
0,19,30,4,53,0.358,23,0.434,3,5,0.375,4,1,34,19,6,21,26,0.113,0.396,0.491,18.075,65,riffle_clumpy
0,22,22,3,47,0.468,25,0.532,8,3,0.727,2,3,30,17,12,16,19,0.255,0.34,0.404,18.081,66,riffle_clumpy
0,17,26,3,46,0.37,20,0.435,3,7,0.3,1,4,30,16,12,15,19,0.261,0.326,0.413,18.092,67,riffle_clumpy
0,18,26,3,47,0.383,21,0.447,2,1,0.667,1,2,30,17,15,12,20,0.319,0.255,0.426,18.089,68,riffle_clumpy
0,21,23,5,49,0.429,26,0.531,3,2,0.6,1,3,32,17,15,11,23,0.306,0.224,0.469,18.099,69,riffle_clumpy
0,22,23,5,50,0.44,27,0.54,0,2,0.0,3,2,27,23,12,15,23,0.24,0.3,0.46,18.093,70,riffle_clumpy
0,21,23,5,49,0.429,26,0.531,0,3,0.0,3,1,31,18,12,24,13,0.245,0.49,0.265,18.092,71,riffle_clumpy
0,13,31,2,46,0.283,15,0.326,2,2,0.5,1,2,29,17,8,16,22,0.174,0.348,0.478,18.094,72,riffle_clumpy
0,13,31,3,47,0.277,16,0.34,4,2,0.667,1,3,32,15,6,18,23,0.128,0.383,0.489,18.099,73,riffle_clumpy
0,26,17,6,49,0.531,32,0.653,3,2,0.6,4,1,36,13,12,12,25,0.245,0.245,0.51,18.091,74,riffle_clumpy
0,25,21,3,49,0.51,28,0.571,4,3,0.571,2,2,29,20,16,13,20,0.327,0.265,0.408,18.091,75,riffle_clumpy
0,27,14,4,45,0.6,31,0.689,1,1,0.5,2,1,24,21,21,14,10,0.467,0.311,0.222,18.086,76,riffle_clumpy
0,17,30,2,49,0.347,19,0.388,4,4,0.5,2,3,29,20,8,23,18,0.163,0.469,0.367,18.091,77,riffle_clumpy
0,17,26,6,49,0.347,23,0.469,0,4,0.0,1,1,27,22,9,25,15,0.184,0.51,0.306,18.091,78,riffle_clumpy
0,25,18,4,47,0.532,29,0.617,6,2,0.75,0,1,27,20,9,19,19,0.191,0.404,0.404,18.088,79,riffle_clumpy
0,21,25,2,48,0.438,23,0.479,4,3,0.571,1,1,28,20,12,17,19,0.25,0.354,0.396,18.09,80,riffle_clumpy
0,20,28,0,48,0.417,20,0.417,3,0,1.0,2,1,28,20,12,16,20,0.25,0.333,0.417,18.083,81,riffle_clumpy
0,17,27,4,48,0.354,21,0.438,7,1,0.875,1,5,25,23,14,13,21,0.292,0.271,0.438,18.081,82,riffle_clumpy
0,11,34,3,48,0.229,14,0.292,3,1,0.75,1,4,36,12,4,16,28,0.083,0.333,0.583,18.087,83,riffle_clumpy
0,13,27,7,47,0.277,20,0.426,4,6,0.4,0,1,29,18,9,22,16,0.191,0.468,0.34,18.091,84,riffle_clumpy
0,24,20,3,47,0.511,27,0.574,2,1,0.667,3,2,32,15,16,11,20,0.34,0.234,0.426,18.092,85,riffle_clumpy
0,22,21,3,46,0.478,25,0.543,4,1,0.8,3,2,27,19,13,16,17,0.283,0.348,0.37,18.087,86,riffle_clumpy
0,14,29,7,50,0.28,21,0.42,4,4,0.5,1,0,36,14,9,18,23,0.18,0.36,0.46,18.088,87,riffle_clumpy
0,21,22,4,47,0.447,25,0.532,3,4,0.429,5,2,27,20,11,18,18,0.234,0.383,0.383,18.084,88,riffle_clumpy
0,21,22,6,49,0.429,27,0.551,7,2,0.778,1,5,31,18,13,20,16,0.265,0.408,0.327,18.089,89,riffle_clumpy
0,16,26,6,48,0.333,22,0.458,2,0,1.0,5,3,31,17,8,17,23,0.167,0.354,0.479,18.091,90,riffle_clumpy
0,22,21,1,44,0.5,23,0.523,3,3,0.5,1,0,24,20,16,10,18,0.364,0.227,0.409,18.083,91,riffle_clumpy
0,20,25,0,45,0.444,20,0.444,2,3,0.4,1,3,30,15,15,13,17,0.333,0.289,0.378,18.082,92,riffle_clumpy
0,21,23,4,48,0.438,25,0.521,2,1,0.667,2,1,28,20,11,20,17,0.229,0.417,0.354,18.084,93,riffle_clumpy
0,21,23,2,46,0.457,23,0.5,2,3,0.4,3,1,29,17,12,16,18,0.261,0.348,0.391,18.084,94,riffle_clumpy
0,23,20,4,47,0.489,27,0.574,5,1,0.833,2,1,27,20,17,18,12,0.362,0.383,0.255,18.086,95,riffle_clumpy
0,23,19,3,45,0.511,26,0.578,5,3,0.625,3,2,28,17,14,14,17,0.311,0.311,0.378,18.085,96,riffle_clumpy
0,24,18,2,44,0.545,26,0.591,4,2,0.667,3,2,26,18,9,18,17,0.205,0.409,0.386,17.967,1,riffle_clumpy
0,27,16,2,45,0.6,29,0.644,6,3,0.667,3,0,27,18,16,12,17,0.356,0.267,0.378,18.211,2,riffle_clumpy
0,23,19,2,44,0.523,25,0.568,4,0,1.0,1,4,22,22,16,16,12,0.364,0.364,0.273,18.189,3,riffle_clumpy
0,20,22,5,47,0.426,25,0.532,3,1,0.75,2,5,31,16,12,18,17,0.255,0.383,0.362,18.184,4,riffle_clumpy
0,16,30,2,48,0.333,18,0.375,3,3,0.5,2,2,28,20,9,19,20,0.188,0.396,0.417,18.15,5,riffle_clumpy
0,22,20,2,44,0.5,24,0.545,1,1,0.5,1,1,20,24,13,18,13,0.295,0.409,0.295,18.218,6,riffle_clumpy
0,21,23,3,47,0.447,24,0.511,2,1,0.667,1,2,33,14,12,15,20,0.255,0.319,0.426,18.303,7,riffle_clumpy
0,20,21,5,46,0.435,25,0.543,2,2,0.5,1,2,30,16,14,19,13,0.304,0.413,0.283,18.302,8,riffle_clumpy
0,17,24,5,46,0.37,22,0.478,2,3,0.4,2,4,32,14,10,13,23,0.217,0.283,0.5,18.238,9,riffle_clumpy
0,21,24,1,46,0.457,22,0.478,3,0,1.0,3,3,27,19,11,14,21,0.239,0.304,0.457,18.141,10,riffle_clumpy
0,14,31,5,50,0.28,19,0.38,3,1,0.75,3,3,29,21,6,16,28,0.12,0.32,0.56,18.141,11,riffle_clumpy
0,25,20,3,48,0.521,28,0.583,2,2,0.5,4,1,27,21,19,18,11,0.396,0.375,0.229,18.14,12,riffle_clumpy
0,14,30,2,46,0.304,16,0.348,1,5,0.167,2,4,30,16,8,15,23,0.174,0.326,0.5,18.065,13,riffle_clumpy
0,23,22,2,47,0.489,25,0.532,2,4,0.333,2,2,28,19,15,13,19,0.319,0.277,0.404,18.039,14,riffle_clumpy
0,22,19,4,45,0.489,26,0.578,2,2,0.5,1,1,27,18,16,14,15,0.356,0.311,0.333,18.064,15,riffle_clumpy
0,30,16,4,50,0.6,34,0.68,6,1,0.857,2,1,23,27,20,18,12,0.4,0.36,0.24,18.042,16,riffle_clumpy
0,19,23,4,46,0.413,23,0.5,1,1,0.5,1,1,30,16,14,20,12,0.304,0.435,0.261,18.042,17,riffle_clumpy
0,19,26,3,48,0.396,22,0.458,4,0,1.0,1,3,32,16,12,12,24,0.25,0.25,0.5,18.091,18,riffle_clumpy
0,22,23,1,46,0.478,23,0.5,3,1,0.75,0,4,25,21,15,12,19,0.326,0.261,0.413,18.075,19,riffle_clumpy
0,15,26,4,45,0.333,19,0.422,4,0,1.0,1,2,33,12,10,15,20,0.222,0.333,0.444,18.081,20,riffle_clumpy
0,25,15,6,46,0.543,31,0.674,7,1,0.875,2,2,26,20,14,15,17,0.304,0.326,0.37,18.063,21,riffle_clumpy
0,20,23,5,48,0.417,25,0.521,4,3,0.571,2,2,29,19,10,17,21,0.208,0.354,0.438,18.065,22,riffle_clumpy
0,25,23,2,50,0.5,27,0.54,3,2,0.6,7,1,24,26,13,13,24,0.26,0.26,0.48,18.03,23,riffle_clumpy
0,20,24,5,49,0.408,25,0.51,2,3,0.4,3,4,36,13,12,17,20,0.245,0.347,0.408,18.048,24,riffle_clumpy
0,23,25,2,50,0.46,25,0.5,6,3,0.667,4,1,32,18,13,12,25,0.26,0.24,0.5,18.046,25,riffle_clumpy
0,21,24,0,45,0.467,21,0.467,1,6,0.143,2,2,25,20,12,17,16,0.267,0.378,0.356,18.059,26,riffle_clumpy
0,22,23,3,48,0.458,25,0.521,1,1,0.5,4,3,30,18,12,13,23,0.25,0.271,0.479,18.019,27,riffle_clumpy
0,19,23,4,46,0.413,23,0.5,2,2,0.5,3,4,30,16,11,16,19,0.239,0.348,0.413,18.019,28,riffle_clumpy
0,27,21,1,49,0.551,28,0.571,2,0,1.0,1,4,28,21,17,16,16,0.347,0.327,0.327,18.022,29,riffle_clumpy
0,21,23,3,47,0.447,24,0.511,4,2,0.667,3,3,27,20,12,16,19,0.255,0.34,0.404,18.011,30,riffle_clumpy
0,23,22,1,46,0.5,24,0.522,2,1,0.667,1,4,30,16,16,10,20,0.348,0.217,0.435,18.027,31,riffle_clumpy
0,19,27,2,48,0.396,21,0.438,3,5,0.375,0,3,25,23,9,23,16,0.188,0.479,0.333,18.029,32,riffle_clumpy
0,20,23,4,47,0.426,24,0.511,3,5,0.375,0,3,28,19,16,13,18,0.34,0.277,0.383,18.032,33,riffle_clumpy
0,16,29,4,49,0.327,20,0.408,2,2,0.5,2,4,25,24,12,16,21,0.245,0.327,0.429,18.048,34,riffle_clumpy
0,19,24,3,46,0.413,22,0.478,4,1,0.8,1,1,33,13,16,12,18,0.348,0.261,0.391,18.076,35,riffle_clumpy
0,26,14,8,48,0.542,34,0.708,3,2,0.6,5,1,33,15,16,14,18,0.333,0.292,0.375,18.074,36,riffle_clumpy
0,19,28,3,50,0.38,22,0.44,4,1,0.8,3,4,28,22,6,24,20,0.12,0.48,0.4,18.058,37,riffle_clumpy
0,23,21,4,48,0.479,27,0.562,3,2,0.6,3,0,27,21,10,20,18,0.208,0.417,0.375,18.067,38,riffle_clumpy
0,17,22,9,48,0.354,26,0.542,4,1,0.8,1,1,28,20,12,20,16,0.25,0.417,0.333,18.073,39,riffle_clumpy
0,22,24,2,48,0.458,24,0.5,3,1,0.75,2,1,30,18,13,15,20,0.271,0.312,0.417,18.074,40,riffle_clumpy
0,21,25,2,48,0.438,23,0.479,1,0,1.0,2,4,31,17,14,12,22,0.292,0.25,0.458,18.068,41,riffle_clumpy
0,17,26,7,50,0.34,24,0.48,3,4,0.429,3,4,24,26,10,18,22,0.2,0.36,0.44,18.072,42,riffle_clumpy
0,26,16,6,48,0.542,32,0.667,4,2,0.667,8,0,26,22,11,18,19,0.229,0.375,0.396,18.038,43,riffle_clumpy
0,20,27,1,48,0.417,21,0.438,3,1,0.75,3,1,24,24,12,16,20,0.25,0.333,0.417,18.029,44,riffle_clumpy
0,18,24,5,47,0.383,23,0.489,3,3,0.5,2,2,30,17,10,17,20,0.213,0.362,0.426,18.04,45,riffle_clumpy
0,16,27,4,47,0.34,20,0.426,3,3,0.5,1,3,30,17,10,19,18,0.213,0.404,0.383,18.039,46,riffle_clumpy
0,19,23,5,47,0.404,24,0.511,5,0,1.0,1,5,27,20,11,19,17,0.234,0.404,0.362,18.045,47,riffle_clumpy
0,16,28,4,48,0.333,20,0.417,5,0,1.0,1,0,33,15,10,17,21,0.208,0.354,0.438,18.049,48,riffle_clumpy
0,14,27,7,48,0.292,21,0.438,2,3,0.4,1,3,30,18,7,17,24,0.146,0.354,0.5,18.034,49,riffle_clumpy
0,21,22,2,45,0.467,23,0.511,6,3,0.667,2,2,28,17,16,11,18,0.356,0.244,0.4,18.023,50,riffle_clumpy
0,20,19,7,46,0.435,27,0.587,5,0,1.0,3,1,28,18,11,18,17,0.239,0.391,0.37,18.029,51,riffle_clumpy
0,20,21,5,46,0.435,25,0.543,2,4,0.333,1,1,31,15,14,14,18,0.304,0.304,0.391,18.014,52,riffle_clumpy
0,20,24,3,47,0.426,23,0.489,4,2,0.667,3,2,19,28,9,19,19,0.191,0.404,0.404,18.011,53,riffle_clumpy
0,22,22,4,48,0.458,26,0.542,1,0,1.0,1,1,30,18,15,14,19,0.312,0.292,0.396,17.999,54,riffle_clumpy
0,19,25,4,48,0.396,23,0.479,5,2,0.714,3,3,34,14,12,14,22,0.25,0.292,0.458,17.997,55,riffle_clumpy
0,19,21,4,44,0.432,23,0.523,7,3,0.7,3,2,26,18,13,14,17,0.295,0.318,0.386,18.009,56,riffle_clumpy
0,21,22,3,46,0.457,24,0.522,1,2,0.333,1,3,26,20,19,10,17,0.413,0.217,0.37,18.019,57,riffle_clumpy
0,23,21,4,48,0.479,27,0.562,3,1,0.75,3,1,22,26,14,20,14,0.292,0.417,0.292,18.021,58,riffle_clumpy
0,15,24,7,46,0.326,22,0.478,1,3,0.25,5,0,27,19,5,23,18,0.109,0.5,0.391,18.02,59,riffle_clumpy
0,26,16,4,46,0.565,30,0.652,3,2,0.6,0,3,30,16,19,13,14,0.413,0.283,0.304,18.02,60,riffle_clumpy
0,23,22,5,50,0.46,28,0.56,8,3,0.727,1,1,24,26,18,13,19,0.36,0.26,0.38,18.02,61,riffle_clumpy
0,17,23,7,47,0.362,24,0.511,4,3,0.571,3,6,32,15,11,12,24,0.234,0.255,0.511,18.026,62,riffle_clumpy
0,19,23,3,45,0.422,22,0.489,2,2,0.5,1,1,22,23,13,18,14,0.289,0.4,0.311,18.023,63,riffle_clumpy
0,27,18,2,47,0.574,29,0.617,4,0,1.0,4,2,29,18,19,11,17,0.404,0.234,0.362,18.009,64,riffle_clumpy
0,19,26,1,46,0.413,20,0.435,3,3,0.5,3,1,22,24,9,19,18,0.196,0.413,0.391,18.013,65,riffle_clumpy
0,21,27,2,50,0.42,23,0.46,4,1,0.8,3,4,31,19,6,21,23,0.12,0.42,0.46,18.012,66,riffle_clumpy
0,19,22,6,47,0.404,25,0.532,4,2,0.667,2,5,29,18,13,13,21,0.277,0.277,0.447,18.017,67,riffle_clumpy
0,17,27,2,46,0.37,19,0.413,3,3,0.5,2,2,34,12,10,12,24,0.217,0.261,0.522,18.018,68,riffle_clumpy
0,18,27,2,47,0.383,20,0.426,1,4,0.2,3,2,24,23,10,16,21,0.213,0.34,0.447,18.011,69,riffle_clumpy
0,25,23,2,50,0.5,27,0.54,5,2,0.714,4,2,25,25,14,18,18,0.28,0.36,0.36,18.018,70,riffle_clumpy
0,19,25,4,48,0.396,23,0.479,1,5,0.167,3,0,27,21,10,19,19,0.208,0.396,0.396,18.002,71,riffle_clumpy
0,19,22,5,46,0.413,24,0.522,2,3,0.4,2,3,29,17,10,18,18,0.217,0.391,0.391,18.004,72,riffle_clumpy
0,24,23,2,49,0.49,26,0.531,3,3,0.5,2,1,26,23,15,20,14,0.306,0.408,0.286,18.008,73,riffle_clumpy
0,22,21,2,45,0.489,24,0.533,4,3,0.571,2,1,23,22,14,15,16,0.311,0.333,0.356,18.012,74,riffle_clumpy
0,25,18,3,46,0.543,28,0.609,3,0,1.0,3,1,28,18,15,13,18,0.326,0.283,0.391,18.009,75,riffle_clumpy
0,20,23,4,47,0.426,24,0.511,4,1,0.8,2,2,27,20,9,22,16,0.191,0.468,0.34,18.006,76,riffle_clumpy
0,15,31,2,48,0.312,17,0.354,0,4,0.0,2,0,28,20,8,23,17,0.167,0.479,0.354,18.012,77,riffle_clumpy
0,23,22,2,47,0.489,25,0.532,2,2,0.5,2,2,28,19,11,22,14,0.234,0.468,0.298,18.015,78,riffle_clumpy
0,23,14,7,44,0.523,30,0.682,5,1,0.833,2,2,22,22,12,18,14,0.273,0.409,0.318,18.014,79,riffle_clumpy
0,14,31,2,47,0.298,16,0.34,2,2,0.5,0,1,27,20,7,23,17,0.149,0.489,0.362,18.022,80,riffle_clumpy
0,21,24,0,45,0.467,21,0.467,3,0,1.0,0,0,29,16,14,12,19,0.311,0.267,0.422,18.026,81,riffle_clumpy
0,26,19,2,47,0.553,28,0.596,5,1,0.833,2,2,31,16,10,18,19,0.213,0.383,0.404,18.029,82,riffle_clumpy
0,16,29,5,50,0.32,21,0.42,0,1,0.0,3,1,32,18,9,20,21,0.18,0.4,0.42,18.035,83,riffle_clumpy
0,17,26,1,44,0.386,18,0.409,6,4,0.6,1,0,26,18,8,22,14,0.182,0.5,0.318,18.038,84,riffle_clumpy
0,22,25,1,48,0.458,23,0.479,3,1,0.75,3,2,29,19,15,14,19,0.312,0.292,0.396,18.038,85,riffle_clumpy
0,16,29,1,46,0.348,17,0.37,4,2,0.667,1,4,30,16,10,16,20,0.217,0.348,0.435,18.039,86,riffle_clumpy
0,25,20,1,46,0.543,26,0.565,5,4,0.556,3,2,32,14,14,12,20,0.304,0.261,0.435,18.035,87,riffle_clumpy
0,27,16,2,45,0.6,29,0.644,1,0,1.0,1,2,25,20,18,13,14,0.4,0.289,0.311,18.035,88,riffle_clumpy
0,27,21,1,49,0.551,28,0.571,1,1,0.5,2,2,32,17,14,11,24,0.286,0.224,0.49,18.035,89,riffle_clumpy
0,19,24,3,46,0.413,22,0.478,3,1,0.75,3,2,23,23,12,17,17,0.261,0.37,0.37,18.035,90,riffle_clumpy
0,20,21,4,45,0.444,24,0.533,3,1,0.75,1,3,22,23,11,18,16,0.244,0.4,0.356,18.04,91,riffle_clumpy
0,14,29,3,46,0.304,17,0.37,3,2,0.6,2,1,32,14,9,19,18,0.196,0.413,0.391,18.032,92,riffle_clumpy
0,22,25,1,48,0.458,23,0.479,1,2,0.333,7,2,27,21,12,17,19,0.25,0.354,0.396,18.026,93,riffle_clumpy
0,20,24,2,46,0.435,22,0.478,1,2,0.333,5,2,26,20,13,23,10,0.283,0.5,0.217,18.022,94,riffle_clumpy
0,17,28,4,49,0.347,21,0.429,0,4,0.0,3,2,31,18,8,16,25,0.163,0.327,0.51,18.026,95,riffle_clumpy
0,23,18,4,45,0.511,27,0.6,4,3,0.571,4,4,29,16,16,11,18,0.356,0.244,0.4,18.028,96,riffle_clumpy
0,17,24,6,47,0.362,23,0.489,5,3,0.625,0,2,29,18,11,15,21,0.234,0.319,0.447,18.441,1,riffle_clumpy
0,19,22,5,46,0.413,24,0.522,2,4,0.333,4,0,30,16,8,14,24,0.174,0.304,0.522,18.333,2,riffle_clumpy
0,21,22,2,45,0.467,23,0.511,2,0,1.0,1,3,29,16,11,14,20,0.244,0.311,0.444,18.206,3,riffle_clumpy
0,22,21,4,47,0.468,26,0.553,5,3,0.625,3,3,35,12,14,9,24,0.298,0.191,0.511,17.992,4,riffle_clumpy
0,21,23,2,46,0.457,23,0.5,5,2,0.714,0,6,28,18,17,9,20,0.37,0.196,0.435,17.986,5,riffle_clumpy
0,19,27,1,47,0.404,20,0.426,5,4,0.556,3,2,27,20,7,18,22,0.149,0.383,0.468,18.033,6,riffle_clumpy
0,22,21,5,48,0.458,27,0.562,5,2,0.714,4,2,29,19,12,14,22,0.25,0.292,0.458,18.079,7,riffle_clumpy
0,22,23,2,47,0.468,24,0.511,3,2,0.6,6,1,32,15,8,15,24,0.17,0.319,0.511,18.115,8,riffle_clumpy
0,18,25,3,46,0.391,21,0.457,2,4,0.333,0,0,24,22,11,17,18,0.239,0.37,0.391,18.113,9,riffle_clumpy
0,16,27,6,49,0.327,22,0.449,0,5,0.0,4,1,29,20,4,24,21,0.082,0.49,0.429,18.113,10,riffle_clumpy
0,17,28,3,48,0.354,20,0.417,2,2,0.5,2,3,32,16,12,19,17,0.25,0.396,0.354,18.104,11,riffle_clumpy
0,21,24,2,47,0.447,23,0.489,3,0,1.0,2,3,29,18,15,12,20,0.319,0.255,0.426,18.094,12,riffle_clumpy
0,20,23,6,49,0.408,26,0.531,1,4,0.2,2,3,33,16,12,16,21,0.245,0.327,0.429,18.065,13,riffle_clumpy
0,18,24,4,46,0.391,22,0.478,1,1,0.5,0,4,31,15,12,16,18,0.261,0.348,0.391,18.056,14,riffle_clumpy
0,25,22,1,48,0.521,26,0.542,5,2,0.714,1,4,33,15,14,12,22,0.292,0.25,0.458,18.075,15,riffle_clumpy
0,26,22,3,51,0.51,29,0.569,3,3,0.5,5,3,29,22,15,16,20,0.294,0.314,0.392,18.068,16,riffle_clumpy
0,23,21,5,49,0.469,28,0.571,4,2,0.667,2,1,32,17,8,25,16,0.163,0.51,0.327,18.076,17,riffle_clumpy
0,17,26,4,47,0.362,21,0.447,1,1,0.5,2,1,38,9,8,15,24,0.17,0.319,0.511,18.104,18,riffle_clumpy
0,21,21,2,44,0.477,23,0.523,4,3,0.571,2,1,23,21,12,11,21,0.273,0.25,0.477,18.078,19,riffle_clumpy
0,22,23,2,47,0.468,24,0.511,3,2,0.6,2,2,24,23,16,15,16,0.34,0.319,0.34,18.076,20,riffle_clumpy
0,21,26,2,49,0.429,23,0.469,2,1,0.667,1,2,36,13,13,17,19,0.265,0.347,0.388,18.095,21,riffle_clumpy
0,16,29,1,46,0.348,17,0.37,2,2,0.5,3,3,26,20,9,18,19,0.196,0.391,0.413,18.071,22,riffle_clumpy
0,17,27,2,46,0.37,19,0.413,3,2,0.6,0,3,28,18,12,14,20,0.261,0.304,0.435,18.084,23,riffle_clumpy
0,19,23,4,46,0.413,23,0.5,2,3,0.4,2,1,32,14,13,12,21,0.283,0.261,0.457,18.068,24,riffle_clumpy
0,18,27,2,47,0.383,20,0.426,3,3,0.5,0,1,28,19,13,20,14,0.277,0.426,0.298,18.069,25,riffle_clumpy
0,28,16,1,45,0.622,29,0.644,3,2,0.6,2,2,29,16,18,9,18,0.4,0.2,0.4,18.034,26,riffle_clumpy
0,20,20,6,46,0.435,26,0.565,4,3,0.571,1,1,30,16,15,17,14,0.326,0.37,0.304,18.026,27,riffle_clumpy
0,25,21,2,48,0.521,27,0.562,4,1,0.8,3,1,31,17,14,13,21,0.292,0.271,0.438,18.021,28,riffle_clumpy
0,21,24,2,47,0.447,23,0.489,6,1,0.857,2,1,28,19,17,16,14,0.362,0.34,0.298,18.015,29,riffle_clumpy
0,18,26,3,47,0.383,21,0.447,1,1,0.5,3,2,34,13,11,14,22,0.234,0.298,0.468,18.019,30,riffle_clumpy
0,20,22,4,46,0.435,24,0.522,3,2,0.6,2,2,31,15,14,12,20,0.304,0.261,0.435,18.009,31,riffle_clumpy
0,23,22,3,48,0.479,26,0.542,4,6,0.4,3,0,26,22,14,17,17,0.292,0.354,0.354,17.997,32,riffle_clumpy
0,18,25,2,45,0.4,20,0.444,6,2,0.75,0,2,19,26,17,16,12,0.378,0.356,0.267,18.006,33,riffle_clumpy
0,21,24,3,48,0.438,24,0.5,4,2,0.667,2,5,28,20,11,16,21,0.229,0.333,0.438,18.0,34,riffle_clumpy
0,21,22,5,48,0.438,26,0.542,1,1,0.5,4,2,31,17,10,14,24,0.208,0.292,0.5,18.005,35,riffle_clumpy
0,17,27,2,46,0.37,19,0.413,0,3,0.0,5,3,25,21,7,23,16,0.152,0.5,0.348,17.997,36,riffle_clumpy
0,22,21,3,46,0.478,25,0.543,4,2,0.667,3,3,26,20,13,16,17,0.283,0.348,0.37,18.004,37,riffle_clumpy
0,23,23,1,47,0.489,24,0.511,6,0,1.0,1,1,30,17,17,14,16,0.362,0.298,0.34,18.003,38,riffle_clumpy
0,21,23,0,44,0.477,21,0.477,3,2,0.6,2,3,27,17,16,17,11,0.364,0.386,0.25,18.014,39,riffle_clumpy
0,18,22,9,49,0.367,27,0.551,4,0,1.0,2,1,34,15,13,18,18,0.265,0.367,0.367,18.028,40,riffle_clumpy
0,23,23,4,50,0.46,27,0.54,4,3,0.571,5,2,28,22,13,19,18,0.26,0.38,0.36,18.022,41,riffle_clumpy
0,18,23,3,44,0.409,21,0.477,6,4,0.6,1,2,29,15,12,16,16,0.273,0.364,0.364,18.032,42,riffle_clumpy
0,23,22,1,46,0.5,24,0.522,3,2,0.6,2,2,31,15,14,13,19,0.304,0.283,0.413,18.026,43,riffle_clumpy
0,16,26,5,47,0.34,21,0.447,0,3,0.0,2,1,34,13,8,19,20,0.17,0.404,0.426,18.036,44,riffle_clumpy
0,22,22,4,48,0.458,26,0.542,0,2,0.0,3,1,30,18,10,18,20,0.208,0.375,0.417,18.022,45,riffle_clumpy
0,18,28,2,48,0.375,20,0.417,1,5,0.167,1,2,30,18,15,11,22,0.312,0.229,0.458,18.029,46,riffle_clumpy
0,13,31,3,47,0.277,16,0.34,2,1,0.667,3,2,33,14,6,15,26,0.128,0.319,0.553,18.009,47,riffle_clumpy
0,21,19,5,45,0.467,26,0.578,4,6,0.4,5,3,28,17,13,15,17,0.289,0.333,0.378,18.017,48,riffle_clumpy
0,20,22,3,45,0.444,23,0.511,5,5,0.5,2,2,29,16,13,11,21,0.289,0.244,0.467,18.03,49,riffle_clumpy
0,19,23,5,47,0.404,24,0.511,2,3,0.4,0,1,29,18,16,17,14,0.34,0.362,0.298,18.04,50,riffle_clumpy
0,22,24,3,49,0.449,25,0.51,2,0,1.0,4,4,30,19,15,13,21,0.306,0.265,0.429,18.041,51,riffle_clumpy
0,24,19,2,45,0.533,26,0.578,3,1,0.75,2,2,26,19,12,19,14,0.267,0.422,0.311,18.041,52,riffle_clumpy
0,18,26,3,47,0.383,21,0.447,4,0,1.0,2,4,34,13,9,15,23,0.191,0.319,0.489,18.039,53,riffle_clumpy
0,20,21,4,45,0.444,24,0.533,3,2,0.6,1,4,29,16,15,10,20,0.333,0.222,0.444,18.037,54,riffle_clumpy
0,18,25,3,46,0.391,21,0.457,3,0,1.0,1,0,28,18,12,15,19,0.261,0.326,0.413,18.03,55,riffle_clumpy
0,19,30,1,50,0.38,20,0.4,2,2,0.5,2,4,31,19,11,14,25,0.22,0.28,0.5,18.029,56,riffle_clumpy
0,14,27,5,46,0.304,19,0.413,2,2,0.5,2,2,32,14,10,15,21,0.217,0.326,0.457,18.038,57,riffle_clumpy
0,18,28,4,50,0.36,22,0.44,1,1,0.5,1,1,28,22,13,20,17,0.26,0.4,0.34,18.047,58,riffle_clumpy
0,23,24,0,47,0.489,23,0.489,3,3,0.5,4,0,26,21,14,14,19,0.298,0.298,0.404,18.052,59,riffle_clumpy
0,17,28,3,48,0.354,20,0.417,3,2,0.6,1,2,33,15,11,14,23,0.229,0.292,0.479,18.055,60,riffle_clumpy
0,18,19,10,47,0.383,28,0.596,2,2,0.5,1,1,31,16,9,17,21,0.191,0.362,0.447,18.057,61,riffle_clumpy
0,19,22,5,46,0.413,24,0.522,1,2,0.333,1,2,34,12,11,16,19,0.239,0.348,0.413,18.062,62,riffle_clumpy
0,20,23,4,47,0.426,24,0.511,2,0,1.0,1,1,27,20,15,21,11,0.319,0.447,0.234,18.065,63,riffle_clumpy
0,14,28,5,47,0.298,19,0.404,1,1,0.5,2,2,29,18,11,17,19,0.234,0.362,0.404,18.06,64,riffle_clumpy
0,23,18,4,45,0.511,27,0.6,3,2,0.6,3,1,28,17,12,16,17,0.267,0.356,0.378,18.055,65,riffle_clumpy
0,19,23,4,46,0.413,23,0.5,5,2,0.714,2,5,27,19,9,19,18,0.196,0.413,0.391,18.052,66,riffle_clumpy
0,19,26,2,47,0.404,21,0.447,1,1,0.5,5,2,31,16,9,17,21,0.191,0.362,0.447,18.045,67,riffle_clumpy
0,21,25,3,49,0.429,24,0.49,8,3,0.727,2,4,35,14,8,13,28,0.163,0.265,0.571,18.045,68,riffle_clumpy
0,26,16,3,45,0.578,29,0.644,5,1,0.833,2,2,29,16,12,15,18,0.267,0.333,0.4,18.046,69,riffle_clumpy
0,24,23,1,48,0.5,25,0.521,2,6,0.25,4,1,29,19,14,20,14,0.292,0.417,0.292,18.043,70,riffle_clumpy
0,21,24,0,45,0.467,21,0.467,2,1,0.667,2,1,25,20,12,18,15,0.267,0.4,0.333,18.046,71,riffle_clumpy
0,17,27,3,47,0.362,20,0.426,4,4,0.5,2,5,27,20,14,17,16,0.298,0.362,0.34,18.044,72,riffle_clumpy
0,18,26,3,47,0.383,21,0.447,0,4,0.0,1,2,28,19,11,18,18,0.234,0.383,0.383,18.049,73,riffle_clumpy
0,22,20,3,45,0.489,25,0.556,7,1,0.875,0,3,27,18,12,16,17,0.267,0.356,0.378,18.052,74,riffle_clumpy
0,18,25,3,46,0.391,21,0.457,2,1,0.667,1,2,21,25,12,19,15,0.261,0.413,0.326,18.062,75,riffle_clumpy
0,21,19,6,46,0.457,27,0.587,2,2,0.5,4,3,27,19,12,16,18,0.261,0.348,0.391,18.065,76,riffle_clumpy
0,18,27,2,47,0.383,20,0.426,3,2,0.6,1,5,31,16,9,16,22,0.191,0.34,0.468,18.063,77,riffle_clumpy
0,20,26,3,49,0.408,23,0.469,4,1,0.8,2,1,36,13,8,20,21,0.163,0.408,0.429,18.063,78,riffle_clumpy
0,19,23,6,48,0.396,25,0.521,2,1,0.667,0,2,29,19,13,16,19,0.271,0.333,0.396,18.069,79,riffle_clumpy
0,18,25,2,45,0.4,20,0.444,1,2,0.333,3,0,26,19,11,14,20,0.244,0.311,0.444,18.066,80,riffle_clumpy
0,20,26,3,49,0.408,23,0.469,4,3,0.571,3,2,31,18,10,15,24,0.204,0.306,0.49,18.061,81,riffle_clumpy
0,17,25,4,46,0.37,21,0.457,4,2,0.667,2,0,27,19,8,20,18,0.174,0.435,0.391,18.064,82,riffle_clumpy
0,20,20,6,46,0.435,26,0.565,3,0,1.0,2,2,29,17,13,15,18,0.283,0.326,0.391,18.062,83,riffle_clumpy
0,25,17,5,47,0.532,30,0.638,6,1,0.857,0,1,27,20,17,14,16,0.362,0.298,0.34,18.058,84,riffle_clumpy
0,21,24,2,47,0.447,23,0.489,3,3,0.5,3,1,35,12,10,14,23,0.213,0.298,0.489,18.056,85,riffle_clumpy
0,17,29,3,49,0.347,20,0.408,4,0,1.0,0,3,28,21,13,19,17,0.265,0.388,0.347,18.07,86,riffle_clumpy
0,23,21,4,48,0.479,27,0.562,2,1,0.667,3,5,31,17,12,17,19,0.25,0.354,0.396,18.069,87,riffle_clumpy
0,17,29,1,47,0.362,18,0.383,1,3,0.25,4,0,32,15,8,18,21,0.17,0.383,0.447,18.065,88,riffle_clumpy
0,20,19,7,46,0.435,27,0.587,2,1,0.667,2,2,26,20,13,17,16,0.283,0.37,0.348,18.071,89,riffle_clumpy
0,17,24,6,47,0.362,23,0.489,3,3,0.5,0,0,32,15,7,16,24,0.149,0.34,0.511,18.076,90,riffle_clumpy
0,20,24,5,49,0.408,25,0.51,0,0,0,2,1,32,17,13,17,19,0.265,0.347,0.388,18.075,91,riffle_clumpy
0,19,25,5,49,0.388,24,0.49,1,3,0.25,1,1,27,22,13,15,21,0.265,0.306,0.429,18.079,92,riffle_clumpy
0,22,19,6,47,0.468,28,0.596,5,1,0.833,1,0,33,14,14,20,13,0.298,0.426,0.277,18.083,93,riffle_clumpy
0,24,22,4,50,0.48,28,0.56,1,3,0.25,0,1,27,23,20,15,15,0.4,0.3,0.3,18.089,94,riffle_clumpy
0,19,29,2,50,0.38,21,0.42,4,2,0.667,0,3,27,23,16,20,14,0.32,0.4,0.28,18.094,95,riffle_clumpy
0,15,30,2,47,0.319,17,0.362,0,4,0.0,0,3,30,17,14,15,18,0.298,0.319,0.383,18.098,96,riffle_clumpy
0,21,19,6,46,0.457,27,0.587,2,2,0.5,3,3,29,17,12,13,21,0.261,0.283,0.457,17.893,1,riffle_clumpy
0,24,19,5,48,0.5,29,0.604,5,2,0.714,4,1,32,16,11,14,23,0.229,0.292,0.479,17.541,2,riffle_clumpy
0,18,29,0,47,0.383,18,0.383,3,6,0.333,3,3,28,19,13,16,18,0.277,0.34,0.383,17.218,3,riffle_clumpy
0,17,29,3,49,0.347,20,0.408,4,2,0.667,3,3,27,22,9,20,20,0.184,0.408,0.408,17.342,4,riffle_clumpy
0,18,24,4,46,0.391,22,0.478,2,2,0.5,2,1,31,15,12,17,17,0.261,0.37,0.37,17.536,5,riffle_clumpy
0,20,26,2,48,0.417,22,0.458,6,1,0.857,3,2,27,21,13,13,22,0.271,0.271,0.458,17.68,6,riffle_clumpy
0,24,20,1,45,0.533,25,0.556,5,3,0.625,3,0,30,15,17,13,15,0.378,0.289,0.333,17.718,7,riffle_clumpy
0,20,25,3,48,0.417,23,0.479,8,1,0.889,3,3,30,18,11,12,25,0.229,0.25,0.521,17.807,8,riffle_clumpy
0,21,25,2,48,0.438,23,0.479,2,1,0.667,2,1,33,15,12,17,19,0.25,0.354,0.396,17.883,9,riffle_clumpy
0,22,20,2,44,0.5,24,0.545,2,1,0.667,4,0,29,15,13,13,18,0.295,0.295,0.409,17.87,10,riffle_clumpy
0,15,27,4,46,0.326,19,0.413,2,1,0.667,2,4,28,18,7,19,20,0.152,0.413,0.435,17.911,11,riffle_clumpy
0,14,26,6,46,0.304,20,0.435,3,3,0.5,2,3,27,19,9,18,19,0.196,0.391,0.413,17.932,12,riffle_clumpy
0,19,25,2,46,0.413,21,0.457,3,2,0.6,2,3,29,17,13,12,21,0.283,0.261,0.457,17.9,13,riffle_clumpy
0,17,24,5,46,0.37,22,0.478,2,2,0.5,2,2,22,24,11,21,14,0.239,0.457,0.304,17.941,14,riffle_clumpy
0,16,21,7,44,0.364,23,0.523,3,1,0.75,1,0,26,18,11,20,13,0.25,0.455,0.295,17.966,15,riffle_clumpy
0,22,19,4,45,0.489,26,0.578,5,2,0.714,0,0,26,19,12,17,16,0.267,0.378,0.356,17.979,16,riffle_clumpy
0,21,24,1,46,0.457,22,0.478,0,1,0.0,3,1,25,21,14,15,17,0.304,0.326,0.37,18.008,17,riffle_clumpy
0,25,19,1,45,0.556,26,0.578,6,0,1.0,4,2,27,18,13,13,19,0.289,0.289,0.422,17.927,18,riffle_clumpy
0,17,28,3,48,0.354,20,0.417,1,4,0.2,3,3,30,18,10,14,24,0.208,0.292,0.5,17.886,19,riffle_clumpy
0,23,26,2,51,0.451,25,0.49,2,1,0.667,6,2,36,15,13,15,23,0.255,0.294,0.451,17.887,20,riffle_clumpy
0,24,25,0,49,0.49,24,0.49,4,1,0.8,4,1,28,21,14,16,19,0.286,0.327,0.388,17.887,21,riffle_clumpy
0,21,25,2,48,0.438,23,0.479,1,2,0.333,2,1,29,19,12,16,20,0.25,0.333,0.417,17.872,22,riffle_clumpy
0,14,30,3,47,0.298,17,0.362,1,3,0.25,1,5,32,15,9,15,23,0.191,0.319,0.489,17.895,23,riffle_clumpy
0,25,17,6,48,0.521,31,0.646,5,5,0.5,2,1,29,19,17,20,11,0.354,0.417,0.229,17.919,24,riffle_clumpy
0,18,27,2,47,0.383,20,0.426,2,3,0.4,1,2,31,16,10,19,18,0.213,0.404,0.383,17.934,25,riffle_clumpy
0,23,21,1,45,0.511,24,0.533,6,3,0.667,2,1,25,20,14,14,17,0.311,0.311,0.378,17.92,26,riffle_clumpy
0,18,29,1,48,0.375,19,0.396,5,1,0.833,3,5,30,18,10,18,20,0.208,0.375,0.417,17.913,27,riffle_clumpy
0,23,18,4,45,0.511,27,0.6,4,3,0.571,2,0,27,18,13,12,20,0.289,0.267,0.444,17.936,28,riffle_clumpy
0,25,16,5,46,0.543,30,0.652,2,1,0.667,3,2,34,12,17,11,18,0.37,0.239,0.391,17.934,29,riffle_clumpy
0,18,23,4,45,0.4,22,0.489,3,3,0.5,2,4,25,20,9,19,17,0.2,0.422,0.378,17.932,30,riffle_clumpy
0,15,31,1,47,0.319,16,0.34,0,1,0.0,2,4,31,16,8,20,19,0.17,0.426,0.404,17.946,31,riffle_clumpy
0,23,22,2,47,0.489,25,0.532,2,0,1.0,1,3,29,18,12,16,19,0.255,0.34,0.404,17.949,32,riffle_clumpy
0,23,19,4,46,0.5,27,0.587,3,1,0.75,1,4,26,20,10,17,19,0.217,0.37,0.413,17.955,33,riffle_clumpy
0,18,23,5,46,0.391,23,0.5,3,4,0.429,1,1,28,18,13,20,13,0.283,0.435,0.283,17.961,34,riffle_clumpy
0,21,21,2,44,0.477,23,0.523,4,1,0.8,3,0,27,17,16,11,17,0.364,0.25,0.386,17.952,35,riffle_clumpy
0,24,22,2,48,0.5,26,0.542,2,3,0.4,5,1,28,20,16,12,20,0.333,0.25,0.417,17.943,36,riffle_clumpy
0,26,19,3,48,0.542,29,0.604,4,3,0.571,4,2,28,20,16,16,16,0.333,0.333,0.333,17.946,37,riffle_clumpy
0,25,22,3,50,0.5,28,0.56,2,4,0.333,4,1,29,21,9,17,24,0.18,0.34,0.48,17.938,38,riffle_clumpy
0,18,25,3,46,0.391,21,0.457,2,3,0.4,2,2,30,16,10,17,19,0.217,0.37,0.413,17.929,39,riffle_clumpy
0,26,23,2,51,0.51,28,0.549,5,3,0.625,1,3,35,16,17,15,19,0.333,0.294,0.373,17.938,40,riffle_clumpy
0,21,21,3,45,0.467,24,0.533,5,0,1.0,1,3,27,18,17,14,14,0.378,0.311,0.311,17.952,41,riffle_clumpy
0,17,28,1,46,0.37,18,0.391,1,4,0.2,2,5,31,15,8,19,19,0.174,0.413,0.413,17.958,42,riffle_clumpy
0,21,23,2,46,0.457,23,0.5,2,0,1.0,3,2,27,19,12,15,19,0.261,0.326,0.413,17.953,43,riffle_clumpy
0,26,19,0,45,0.578,26,0.578,3,0,1.0,1,1,23,22,14,16,15,0.311,0.356,0.333,17.962,44,riffle_clumpy
0,27,13,6,46,0.587,33,0.717,5,0,1.0,2,2,23,23,16,15,15,0.348,0.326,0.326,17.969,45,riffle_clumpy
0,17,25,4,46,0.37,21,0.457,0,2,0.0,3,1,27,19,9,16,21,0.196,0.348,0.457,17.975,46,riffle_clumpy
0,23,20,2,45,0.511,25,0.556,3,1,0.75,2,2,22,23,14,18,13,0.311,0.4,0.289,17.984,47,riffle_clumpy
0,26,18,6,50,0.52,32,0.64,3,3,0.5,3,2,26,24,16,15,19,0.32,0.3,0.38,17.988,48,riffle_clumpy
0,21,22,6,49,0.429,27,0.551,6,1,0.857,3,0,34,15,13,16,20,0.265,0.327,0.408,18.001,49,riffle_clumpy
0,18,24,5,47,0.383,23,0.489,2,0,1.0,2,1,25,22,12,15,20,0.255,0.319,0.426,18.006,50,riffle_clumpy
0,27,17,1,45,0.6,28,0.622,8,1,0.889,1,1,20,25,23,13,9,0.511,0.289,0.2,18.011,51,riffle_clumpy
0,21,28,4,53,0.396,25,0.472,6,3,0.667,2,1,28,25,13,25,15,0.245,0.472,0.283,18.012,52,riffle_clumpy
0,16,29,3,48,0.333,19,0.396,2,1,0.667,3,5,31,17,10,17,21,0.208,0.354,0.438,18.009,53,riffle_clumpy
0,19,25,5,49,0.388,24,0.49,6,2,0.75,1,3,30,19,12,17,20,0.245,0.347,0.408,18.019,54,riffle_clumpy
0,20,21,3,44,0.455,23,0.523,3,0,1.0,2,1,25,19,11,19,14,0.25,0.432,0.318,18.026,55,riffle_clumpy
0,21,27,2,50,0.42,23,0.46,4,1,0.8,2,2,31,19,9,21,20,0.18,0.42,0.4,18.035,56,riffle_clumpy
0,17,29,1,47,0.362,18,0.383,3,1,0.75,4,5,31,16,11,13,23,0.234,0.277,0.489,18.025,57,riffle_clumpy
0,17,23,6,46,0.37,23,0.5,2,2,0.5,2,2,33,13,10,16,20,0.217,0.348,0.435,18.018,58,riffle_clumpy
0,21,19,6,46,0.457,27,0.587,4,2,0.667,2,1,31,15,12,16,18,0.261,0.348,0.391,18.01,59,riffle_clumpy
0,18,24,4,46,0.391,22,0.478,2,3,0.4,2,1,29,17,8,20,18,0.174,0.435,0.391,18.008,60,riffle_clumpy
0,20,25,1,46,0.435,21,0.457,3,2,0.6,0,1,23,23,17,12,17,0.37,0.261,0.37,18.005,61,riffle_clumpy
0,15,25,5,45,0.333,20,0.444,5,3,0.625,1,3,28,17,10,12,23,0.222,0.267,0.511,18.012,62,riffle_clumpy
0,22,26,1,49,0.449,23,0.469,2,4,0.333,2,3,32,17,10,16,23,0.204,0.327,0.469,18.0,63,riffle_clumpy
0,22,23,4,49,0.449,26,0.531,4,2,0.667,2,3,31,18,16,15,18,0.327,0.306,0.367,18.004,64,riffle_clumpy
0,20,22,4,46,0.435,24,0.522,2,2,0.5,0,2,24,22,16,18,12,0.348,0.391,0.261,18.012,65,riffle_clumpy
0,17,29,3,49,0.347,20,0.408,0,7,0.0,1,5,32,17,10,20,19,0.204,0.408,0.388,18.012,66,riffle_clumpy
0,21,19,5,45,0.467,26,0.578,6,2,0.75,2,6,27,18,14,14,17,0.311,0.311,0.378,18.013,67,riffle_clumpy
0,24,23,3,50,0.48,27,0.54,5,2,0.714,2,2,27,23,19,14,17,0.38,0.28,0.34,18.011,68,riffle_clumpy
0,24,25,1,50,0.48,25,0.5,3,1,0.75,2,1,27,23,14,15,21,0.28,0.3,0.42,18.013,69,riffle_clumpy
0,21,23,3,47,0.447,24,0.511,1,0,1.0,2,3,30,17,13,16,18,0.277,0.34,0.383,18.015,70,riffle_clumpy
0,17,28,3,48,0.354,20,0.417,2,2,0.5,1,3,27,21,11,15,22,0.229,0.312,0.458,18.014,71,riffle_clumpy
0,21,23,5,49,0.429,26,0.531,3,2,0.6,3,1,28,21,12,15,22,0.245,0.306,0.449,18.015,72,riffle_clumpy
0,27,20,2,49,0.551,29,0.592,5,3,0.625,5,1,33,16,17,13,19,0.347,0.265,0.388,18.01,73,riffle_clumpy
0,21,21,2,44,0.477,23,0.523,2,2,0.5,1,3,27,17,14,16,14,0.318,0.364,0.318,18.014,74,riffle_clumpy
0,17,22,5,44,0.386,22,0.5,2,1,0.667,3,1,31,13,10,16,18,0.227,0.364,0.409,18.023,75,riffle_clumpy
0,19,25,2,46,0.413,21,0.457,1,4,0.2,1,4,29,17,13,13,20,0.283,0.283,0.435,18.027,76,riffle_clumpy
0,18,28,1,47,0.383,19,0.404,3,2,0.6,0,1,31,16,12,15,20,0.255,0.319,0.426,18.037,77,riffle_clumpy
0,22,21,3,46,0.478,25,0.543,7,3,0.7,3,2,26,20,8,16,22,0.174,0.348,0.478,18.038,78,riffle_clumpy
0,17,26,5,48,0.354,22,0.458,5,2,0.714,1,4,29,19,11,15,22,0.229,0.312,0.458,18.043,79,riffle_clumpy
0,21,24,2,47,0.447,23,0.489,1,4,0.2,3,4,27,20,11,17,19,0.234,0.362,0.404,18.039,80,riffle_clumpy
0,20,22,5,47,0.426,25,0.532,3,1,0.75,3,3,33,14,15,12,20,0.319,0.255,0.426,18.044,81,riffle_clumpy
0,21,22,2,45,0.467,23,0.511,7,2,0.778,2,0,27,18,11,14,20,0.244,0.311,0.444,18.045,82,riffle_clumpy
0,19,25,2,46,0.413,21,0.457,1,2,0.333,1,3,30,16,12,12,22,0.261,0.261,0.478,18.045,83,riffle_clumpy
0,19,23,8,50,0.38,27,0.54,2,4,0.333,3,0,30,20,9,18,23,0.18,0.36,0.46,18.042,84,riffle_clumpy
0,18,23,5,46,0.391,23,0.5,1,2,0.333,2,2,30,16,12,14,20,0.261,0.304,0.435,18.04,85,riffle_clumpy
0,26,17,4,47,0.553,30,0.638,5,2,0.714,4,2,27,20,16,11,20,0.34,0.234,0.426,18.038,86,riffle_clumpy
0,21,24,2,47,0.447,23,0.489,2,1,0.667,2,3,28,19,13,13,21,0.277,0.277,0.447,18.041,87,riffle_clumpy
0,21,26,1,48,0.438,22,0.458,1,4,0.2,2,1,28,20,10,23,15,0.208,0.479,0.312,18.047,88,riffle_clumpy
0,21,25,1,47,0.447,22,0.468,4,2,0.667,3,3,33,14,11,13,23,0.234,0.277,0.489,18.049,89,riffle_clumpy
0,20,26,4,50,0.4,24,0.48,2,0,1.0,2,0,30,20,10,23,17,0.2,0.46,0.34,18.044,90,riffle_clumpy
0,17,23,6,46,0.37,23,0.5,3,4,0.429,5,1,32,14,8,17,21,0.174,0.37,0.457,18.034,91,riffle_clumpy
0,22,23,1,46,0.478,23,0.5,4,4,0.5,2,3,29,17,14,13,19,0.304,0.283,0.413,18.034,92,riffle_clumpy
0,21,24,6,51,0.412,27,0.529,1,3,0.25,0,1,34,17,15,11,25,0.294,0.216,0.49,18.043,93,riffle_clumpy
0,18,27,0,45,0.4,18,0.4,3,2,0.6,2,0,22,23,10,15,20,0.222,0.333,0.444,18.039,94,riffle_clumpy
0,23,23,4,50,0.46,27,0.54,6,3,0.667,2,1,28,22,15,21,14,0.3,0.42,0.28,18.035,95,riffle_clumpy
0,20,22,6,48,0.417,26,0.542,2,3,0.4,4,1,31,17,9,14,25,0.188,0.292,0.521,18.032,96,riffle_clumpy
0,16,26,6,48,0.333,22,0.458,1,3,0.25,3,4,30,18,8,15,25,0.167,0.312,0.521,18.029,1,riffle_clumpy
0,26,17,3,46,0.565,29,0.63,5,0,1.0,3,1,28,18,14,16,16,0.304,0.348,0.348,18.094,2,riffle_clumpy
0,16,26,4,46,0.348,20,0.435,2,4,0.333,0,3,29,17,11,14,21,0.239,0.304,0.457,18.118,3,riffle_clumpy
0,19,24,2,45,0.422,21,0.467,2,2,0.5,3,3,34,11,13,13,19,0.289,0.289,0.422,18.217,4,riffle_clumpy
0,26,17,2,45,0.578,28,0.622,2,4,0.333,2,0,27,18,14,13,18,0.311,0.289,0.4,18.087,5,riffle_clumpy
0,18,26,3,47,0.383,21,0.447,2,2,0.5,0,3,33,14,10,17,20,0.213,0.362,0.426,18.104,6,riffle_clumpy
0,15,30,2,47,0.319,17,0.362,3,1,0.75,0,3,30,17,9,14,24,0.191,0.298,0.511,18.176,7,riffle_clumpy
0,20,23,4,47,0.426,24,0.511,4,2,0.667,0,5,31,16,13,12,22,0.277,0.255,0.468,18.202,8,riffle_clumpy
0,14,28,4,46,0.304,18,0.391,2,4,0.333,2,0,27,19,10,19,17,0.217,0.413,0.37,18.201,9,riffle_clumpy
0,18,24,6,48,0.375,24,0.5,2,1,0.667,2,3,31,17,9,18,21,0.188,0.375,0.438,18.138,10,riffle_clumpy
0,16,25,4,45,0.356,20,0.444,3,2,0.6,0,2,30,15,10,17,18,0.222,0.378,0.4,18.168,11,riffle_clumpy
0,23,19,1,43,0.535,24,0.558,2,2,0.5,1,0,17,26,18,16,9,0.419,0.372,0.209,18.185,12,riffle_clumpy
0,21,24,4,49,0.429,25,0.51,4,1,0.8,5,1,28,21,11,21,17,0.224,0.429,0.347,18.136,13,riffle_clumpy
0,22,22,5,49,0.449,27,0.551,6,2,0.75,4,4,32,17,16,12,21,0.327,0.245,0.429,18.124,14,riffle_clumpy
0,24,19,2,45,0.533,26,0.578,5,3,0.625,2,2,26,19,18,13,14,0.4,0.289,0.311,18.134,15,riffle_clumpy
0,21,26,3,50,0.42,24,0.48,3,1,0.75,2,2,32,18,13,15,22,0.26,0.3,0.44,18.13,16,riffle_clumpy
0,19,24,4,47,0.404,23,0.489,1,2,0.333,2,4,33,14,16,10,21,0.34,0.213,0.447,18.081,17,riffle_clumpy
0,19,24,3,46,0.413,22,0.478,3,4,0.429,2,0,30,16,8,19,19,0.174,0.413,0.413,18.047,18,riffle_clumpy
0,14,24,7,45,0.311,21,0.467,4,5,0.444,2,0,26,19,8,21,16,0.178,0.467,0.356,18.039,19,riffle_clumpy
0,15,34,1,50,0.3,16,0.32,1,6,0.143,2,5,31,19,10,18,22,0.2,0.36,0.44,18.044,20,riffle_clumpy
0,21,21,5,47,0.447,26,0.553,4,4,0.5,4,1,31,16,11,17,19,0.234,0.362,0.404,18.043,21,riffle_clumpy
0,21,23,3,47,0.447,24,0.511,1,1,0.5,3,4,34,13,12,11,24,0.255,0.234,0.511,18.015,22,riffle_clumpy
0,21,17,6,44,0.477,27,0.614,2,3,0.4,1,2,26,18,15,14,15,0.341,0.318,0.341,17.984,23,riffle_clumpy
0,17,26,5,48,0.354,22,0.458,2,2,0.5,1,0,31,17,12,18,18,0.25,0.375,0.375,18.018,24,riffle_clumpy
0,26,21,2,49,0.531,28,0.571,3,3,0.5,5,1,34,15,16,15,18,0.327,0.306,0.367,18.026,25,riffle_clumpy
0,20,22,3,45,0.444,23,0.511,3,4,0.429,0,4,29,16,15,15,15,0.333,0.333,0.333,18.031,26,riffle_clumpy
0,21,24,0,45,0.467,21,0.467,3,1,0.75,1,2,22,23,14,18,13,0.311,0.4,0.289,18.038,27,riffle_clumpy
0,23,23,3,49,0.469,26,0.531,2,1,0.667,0,2,34,15,17,13,19,0.347,0.265,0.388,18.057,28,riffle_clumpy
0,24,21,2,47,0.511,26,0.553,3,3,0.5,2,7,33,14,12,11,24,0.255,0.234,0.511,18.061,29,riffle_clumpy
0,18,21,5,44,0.409,23,0.523,2,1,0.667,2,2,30,14,12,15,17,0.273,0.341,0.386,18.064,30,riffle_clumpy
0,18,25,3,46,0.391,21,0.457,4,0,1.0,1,2,29,17,13,16,17,0.283,0.348,0.37,18.084,31,riffle_clumpy
0,17,27,4,48,0.354,21,0.438,2,2,0.5,2,2,31,17,9,19,20,0.188,0.396,0.417,18.089,32,riffle_clumpy
0,17,25,2,44,0.386,19,0.432,3,2,0.6,0,2,29,15,11,15,18,0.25,0.341,0.409,18.096,33,riffle_clumpy
0,16,28,2,46,0.348,18,0.391,4,3,0.571,1,4,33,13,10,14,22,0.217,0.304,0.478,18.115,34,riffle_clumpy
0,22,20,4,46,0.478,26,0.565,4,1,0.8,4,1,25,21,16,14,16,0.348,0.304,0.348,18.119,35,riffle_clumpy
0,15,29,1,45,0.333,16,0.356,4,2,0.667,0,3,32,13,9,17,19,0.2,0.378,0.422,18.107,36,riffle_clumpy
0,24,19,4,47,0.511,28,0.596,0,2,0.0,4,1,25,22,17,16,14,0.362,0.34,0.298,18.095,37,riffle_clumpy
0,25,19,3,47,0.532,28,0.596,2,2,0.5,1,2,28,19,16,14,17,0.34,0.298,0.362,18.09,38,riffle_clumpy
0,17,29,0,46,0.37,17,0.37,1,3,0.25,2,4,23,23,10,18,18,0.217,0.391,0.391,18.088,39,riffle_clumpy
0,20,22,3,45,0.444,23,0.511,3,3,0.5,3,1,29,16,10,19,16,0.222,0.422,0.356,18.078,40,riffle_clumpy
0,19,20,7,46,0.413,26,0.565,2,0,1.0,2,2,27,19,9,17,20,0.196,0.37,0.435,18.077,41,riffle_clumpy
0,20,23,4,47,0.426,24,0.511,3,5,0.375,0,0,24,23,17,17,13,0.362,0.362,0.277,18.081,42,riffle_clumpy
0,19,30,3,52,0.365,22,0.423,2,3,0.4,1,3,33,19,13,23,16,0.25,0.442,0.308,18.095,43,riffle_clumpy
0,20,24,4,48,0.417,24,0.5,2,3,0.4,1,4,27,21,15,15,18,0.312,0.312,0.375,18.101,44,riffle_clumpy
0,17,26,4,47,0.362,21,0.447,2,3,0.4,2,4,37,10,8,14,25,0.17,0.298,0.532,18.082,45,riffle_clumpy
0,16,24,6,46,0.348,22,0.478,1,1,0.5,3,2,26,20,11,16,19,0.239,0.348,0.413,18.073,46,riffle_clumpy
0,25,22,2,49,0.51,27,0.551,8,2,0.8,0,2,26,23,13,20,16,0.265,0.408,0.327,18.078,47,riffle_clumpy
0,16,27,4,47,0.34,20,0.426,2,4,0.333,2,2,28,19,7,15,25,0.149,0.319,0.532,18.07,48,riffle_clumpy
0,20,26,1,47,0.426,21,0.447,0,2,0.0,1,2,30,17,17,11,19,0.362,0.234,0.404,18.051,49,riffle_clumpy
0,19,22,4,45,0.422,23,0.511,2,5,0.286,1,2,27,18,14,16,15,0.311,0.356,0.333,18.068,50,riffle_clumpy
0,16,26,4,46,0.348,20,0.435,2,3,0.4,2,5,25,21,5,19,22,0.109,0.413,0.478,18.063,51,riffle_clumpy
0,15,26,5,46,0.326,20,0.435,4,5,0.444,2,4,25,21,12,16,18,0.261,0.348,0.391,18.058,52,riffle_clumpy
0,15,30,4,49,0.306,19,0.388,2,3,0.4,3,3,31,18,7,22,20,0.143,0.449,0.408,18.058,53,riffle_clumpy
0,19,21,4,44,0.432,23,0.523,4,0,1.0,2,3,24,20,13,16,15,0.295,0.364,0.341,18.057,54,riffle_clumpy
0,20,24,5,49,0.408,25,0.51,6,0,1.0,2,2,31,18,16,13,20,0.327,0.265,0.408,18.056,55,riffle_clumpy
0,24,22,2,48,0.5,26,0.542,2,2,0.5,1,3,29,19,18,11,19,0.375,0.229,0.396,18.059,56,riffle_clumpy
0,18,25,3,46,0.391,21,0.457,3,5,0.375,2,4,34,12,12,10,24,0.261,0.217,0.522,18.052,57,riffle_clumpy
0,15,26,5,46,0.326,20,0.435,3,1,0.75,2,3,31,15,11,12,23,0.239,0.261,0.5,18.054,58,riffle_clumpy
0,20,23,2,45,0.444,22,0.489,1,4,0.2,0,4,26,19,10,17,18,0.222,0.378,0.4,18.062,59,riffle_clumpy
0,22,21,4,47,0.468,26,0.553,1,2,0.333,1,4,24,23,14,20,13,0.298,0.426,0.277,18.061,60,riffle_clumpy
0,21,22,5,48,0.438,26,0.542,3,0,1.0,3,6,38,10,10,11,27,0.208,0.229,0.562,18.065,61,riffle_clumpy
0,17,26,4,47,0.362,21,0.447,1,4,0.2,4,2,22,25,11,22,14,0.234,0.468,0.298,18.069,62,riffle_clumpy
0,18,24,5,47,0.383,23,0.489,2,0,1.0,2,2,31,16,11,17,19,0.234,0.362,0.404,18.074,63,riffle_clumpy
0,25,20,1,46,0.543,26,0.565,6,2,0.75,3,2,31,15,19,11,16,0.413,0.239,0.348,18.079,64,riffle_clumpy
0,29,17,1,47,0.617,30,0.638,5,1,0.833,0,2,27,20,24,4,19,0.511,0.085,0.404,18.075,65,riffle_clumpy
0,18,25,4,47,0.383,22,0.468,2,5,0.286,3,2,33,14,13,13,21,0.277,0.277,0.447,18.077,66,riffle_clumpy
0,22,21,2,45,0.489,24,0.533,3,1,0.75,0,0,29,16,16,11,18,0.356,0.244,0.4,18.082,67,riffle_clumpy
0,19,25,2,46,0.413,21,0.457,2,0,1.0,2,2,26,20,12,20,14,0.261,0.435,0.304,18.086,68,riffle_clumpy
0,17,25,5,47,0.362,22,0.468,1,1,0.5,0,2,24,23,6,25,16,0.128,0.532,0.34,18.091,69,riffle_clumpy
0,23,26,1,50,0.46,24,0.48,4,4,0.5,3,5,31,19,12,18,20,0.24,0.36,0.4,18.095,70,riffle_clumpy
0,22,26,2,50,0.44,24,0.48,1,2,0.333,2,2,30,20,13,19,18,0.26,0.38,0.36,18.095,71,riffle_clumpy
0,16,25,5,46,0.348,21,0.457,3,4,0.429,5,1,26,20,8,16,22,0.174,0.348,0.478,18.1,72,riffle_clumpy
0,24,21,3,48,0.5,27,0.562,1,3,0.25,2,2,25,23,13,15,20,0.271,0.312,0.417,18.096,73,riffle_clumpy
0,17,27,4,48,0.354,21,0.438,3,6,0.333,3,3,24,24,14,17,17,0.292,0.354,0.354,18.092,74,riffle_clumpy
0,14,25,5,44,0.318,19,0.432,1,1,0.5,0,0,25,19,9,20,15,0.205,0.455,0.341,18.096,75,riffle_clumpy
0,20,26,3,49,0.408,23,0.469,3,6,0.333,1,3,31,18,9,20,20,0.184,0.408,0.408,18.095,76,riffle_clumpy
0,18,25,3,46,0.391,21,0.457,3,3,0.5,3,2,29,17,10,14,22,0.217,0.304,0.478,18.094,77,riffle_clumpy
0,16,29,3,48,0.333,19,0.396,1,1,0.5,1,2,30,18,9,17,22,0.188,0.354,0.458,18.093,78,riffle_clumpy
0,22,23,2,47,0.468,24,0.511,2,0,1.0,1,2,29,18,17,14,16,0.362,0.298,0.34,18.088,79,riffle_clumpy
0,24,22,5,51,0.471,29,0.569,3,4,0.429,2,0,31,20,11,20,20,0.216,0.392,0.392,18.089,80,riffle_clumpy
0,19,25,3,47,0.404,22,0.468,3,0,1.0,2,1,30,17,12,16,19,0.255,0.34,0.404,18.093,81,riffle_clumpy
0,16,26,4,46,0.348,20,0.435,0,2,0.0,3,2,33,13,8,23,15,0.174,0.5,0.326,18.098,82,riffle_clumpy
0,21,20,5,46,0.457,26,0.565,4,0,1.0,3,0,27,19,14,10,22,0.304,0.217,0.478,18.086,83,riffle_clumpy
0,20,23,1,44,0.455,21,0.477,1,3,0.25,0,1,29,15,14,17,13,0.318,0.386,0.295,18.088,84,riffle_clumpy
0,25,21,2,48,0.521,27,0.562,5,3,0.625,3,2,29,19,13,11,24,0.271,0.229,0.5,18.087,85,riffle_clumpy
0,17,32,0,49,0.347,17,0.347,1,5,0.167,2,2,28,21,11,18,20,0.224,0.367,0.408,18.091,86,riffle_clumpy
0,20,23,5,48,0.417,25,0.521,0,0,0,2,2,34,14,12,15,21,0.25,0.312,0.438,18.093,87,riffle_clumpy
0,21,26,4,51,0.412,25,0.49,3,4,0.429,2,1,27,24,14,21,16,0.275,0.412,0.314,18.092,88,riffle_clumpy
0,23,22,4,49,0.469,27,0.551,1,1,0.5,1,3,31,18,18,14,17,0.367,0.286,0.347,18.097,89,riffle_clumpy
0,16,25,5,46,0.348,21,0.457,2,2,0.5,1,2,28,18,8,18,20,0.174,0.391,0.435,18.103,90,riffle_clumpy
0,15,30,2,47,0.319,17,0.362,4,4,0.5,2,2,27,20,9,20,18,0.191,0.426,0.383,18.1,91,riffle_clumpy
0,20,24,3,47,0.426,23,0.489,2,1,0.667,2,0,31,16,15,13,19,0.319,0.277,0.404,18.096,92,riffle_clumpy
0,26,20,2,48,0.542,28,0.583,3,2,0.6,5,3,32,16,12,13,23,0.25,0.271,0.479,18.078,93,riffle_clumpy
0,21,22,3,46,0.457,24,0.522,3,4,0.429,3,1,24,22,14,18,14,0.304,0.391,0.304,18.076,94,riffle_clumpy
0,25,19,3,47,0.532,28,0.596,4,1,0.8,1,0,23,24,14,14,19,0.298,0.298,0.404,18.071,95,riffle_clumpy
0,20,23,1,44,0.455,21,0.477,3,2,0.6,1,3,20,24,14,18,12,0.318,0.409,0.273,18.068,96,riffle_clumpy
